year,week,propertyState,num_policies_bought,num_policies_term,num_policies_net
2009,0,AK,6,0,6
2009,0,AL,153,2,151
2009,0,AR,52,0,52
2009,0,AZ,129,0,129
2009,0,CA,2903,12,2891
2009,0,CO,53,0,53
2009,0,CT,123,0,123
2009,0,DC,7,0,7
2009,0,DE,341,0,341
2009,0,FL,16893,13,16880
2009,0,GA,306,1,305
2009,0,GU,1,0,1
2009,0,HI,634,0,634
2009,0,IA,45,0,45
2009,0,ID,18,0,18
2009,0,IL,142,1,141
2009,0,IN,86,0,86
2009,0,KS,31,1,30
2009,0,KY,75,0,75
2009,0,LA,1526,8,1518
2009,0,MA,228,0,228
2009,0,MD,359,25,334
2009,0,ME,35,0,35
2009,0,MI,53,0,53
2009,0,MN,38,0,38
2009,0,MO,76,0,76
2009,0,MS,326,0,326
2009,0,MT,15,0,15
2009,0,NC,756,2,754
2009,0,ND,9,0,9
2009,0,NE,39,1,38
2009,0,NH,22,0,22
2009,0,NJ,1330,2,1328
2009,0,NM,35,0,35
2009,0,NV,88,0,88
2009,0,NY,749,6,743
2009,0,OH,132,0,132
2009,0,OK,45,2,43
2009,0,OR,234,0,234
2009,0,PA,302,2,300
2009,0,PR,106,0,106
2009,0,RI,41,0,41
2009,0,SC,885,2,883
2009,0,SD,21,0,21
2009,0,TN,116,0,116
2009,0,TX,3796,21,3775
2009,0,UT,21,0,21
2009,0,VA,471,1,470
2009,0,VI,4,0,4
2009,0,VT,9,0,9
2009,0,WA,283,2,281
2009,0,WI,39,0,39
2009,0,WV,80,0,80
2009,0,WY,4,0,4
2009,1,AK,17,0,17
2009,1,AL,431,3,428
2009,1,AR,84,0,84
2009,1,AZ,242,1,241
2009,1,CA,5292,39,5253
2009,1,CO,149,3,146
2009,1,CT,425,1,424
2009,1,DC,12,0,12
2009,1,DE,249,1,248
2009,1,FL,22351,102,22249
2009,1,GA,760,5,755
2009,1,HI,753,32,721
2009,1,IA,101,0,101
2009,1,ID,60,2,58
2009,1,IL,576,2,574
2009,1,IN,157,1,156
2009,1,KS,74,0,74
2009,1,KY,144,0,144
2009,1,LA,4247,28,4219
2009,1,MA,430,3,427
2009,1,MD,622,3,619
2009,1,ME,104,0,104
2009,1,MI,159,4,155
2009,1,MN,67,0,67
2009,1,MO,186,5,181
2009,1,MS,882,1,881
2009,1,MT,27,0,27
2009,1,NC,1307,8,1299
2009,1,ND,22,0,22
2009,1,NE,56,0,56
2009,1,NH,55,1,54
2009,1,NJ,1845,18,1827
2009,1,NM,70,1,69
2009,1,NV,151,1,150
2009,1,NY,1735,11,1724
2009,1,OH,268,2,266
2009,1,OK,100,1,99
2009,1,OR,502,3,499
2009,1,PA,606,2,604
2009,1,PR,125,0,125
2009,1,RI,178,1,177
2009,1,SC,1736,7,1729
2009,1,SD,35,0,35
2009,1,TN,236,3,233
2009,1,TX,5333,54,5279
2009,1,UT,56,0,56
2009,1,VA,869,7,862
2009,1,VI,12,0,12
2009,1,VT,33,0,33
2009,1,WA,628,6,622
2009,1,WI,118,2,116
2009,1,WV,145,0,145
2009,1,WY,25,0,25
2009,2,AK,28,1,27
2009,2,AL,400,3,397
2009,2,AR,104,1,103
2009,2,AZ,230,4,226
2009,2,CA,3938,34,3904
2009,2,CO,180,1,179
2009,2,CT,418,41,377
2009,2,DC,10,0,10
2009,2,DE,239,5,234
2009,2,FL,24414,200,24214
2009,2,GA,924,11,913
2009,2,GU,2,0,2
2009,2,HI,1220,2,1218
2009,2,IA,90,2,88
2009,2,ID,49,0,49
2009,2,IL,357,4,353
2009,2,IN,186,3,183
2009,2,KS,65,0,65
2009,2,KY,287,1,286
2009,2,LA,4935,141,4794
2009,2,MA,406,4,402
2009,2,MD,573,4,569
2009,2,ME,90,2,88
2009,2,MI,153,3,150
2009,2,MN,75,0,75
2009,2,MO,167,5,162
2009,2,MS,794,14,780
2009,2,MT,26,0,26
2009,2,NC,1527,11,1516
2009,2,ND,18,0,18
2009,2,NE,67,1,66
2009,2,NH,109,1,108
2009,2,NJ,2146,26,2120
2009,2,NM,78,0,78
2009,2,NV,129,3,126
2009,2,NY,2231,49,2182
2009,2,OH,407,16,391
2009,2,OK,97,0,97
2009,2,OR,355,8,347
2009,2,PA,743,7,736
2009,2,PR,114,0,114
2009,2,RI,270,2,268
2009,2,SC,2305,115,2190
2009,2,SD,34,0,34
2009,2,TN,217,4,213
2009,2,TX,5715,66,5649
2009,2,UT,28,0,28
2009,2,VA,897,12,885
2009,2,VI,7,0,7
2009,2,VT,27,1,26
2009,2,WA,698,14,684
2009,2,WI,91,1,90
2009,2,WV,165,2,163
2009,2,WY,10,0,10
2009,3,AK,35,0,35
2009,3,AL,500,5,495
2009,3,AR,93,2,91
2009,3,AZ,223,2,221
2009,3,CA,3468,38,3430
2009,3,CO,304,5,299
2009,3,CT,286,4,282
2009,3,DC,7,1,6
2009,3,DE,363,3,360
2009,3,FL,20409,799,19610
2009,3,GA,746,16,730
2009,3,GU,2,0,2
2009,3,HI,976,65,911
2009,3,IA,68,1,67
2009,3,ID,60,0,60
2009,3,IL,220,3,217
2009,3,IN,156,5,151
2009,3,KS,63,4,59
2009,3,KY,155,5,150
2009,3,LA,4265,73,4192
2009,3,MA,411,4,407
2009,3,MD,863,39,824
2009,3,ME,55,1,54
2009,3,MI,140,4,136
2009,3,MN,52,2,50
2009,3,MO,127,3,124
2009,3,MS,739,11,728
2009,3,MT,28,0,28
2009,3,NC,1441,20,1421
2009,3,ND,28,0,28
2009,3,NE,59,2,57
2009,3,NH,52,1,51
2009,3,NJ,1830,45,1785
2009,3,NM,59,2,57
2009,3,NV,108,1,107
2009,3,NY,2029,53,1976
2009,3,OH,207,4,203
2009,3,OK,93,3,90
2009,3,OR,350,5,345
2009,3,PA,695,8,687
2009,3,PR,124,0,124
2009,3,RI,95,5,90
2009,3,SC,1639,29,1610
2009,3,SD,23,0,23
2009,3,TN,159,4,155
2009,3,TX,4487,63,4424
2009,3,UT,34,1,33
2009,3,VA,765,18,747
2009,3,VI,23,0,23
2009,3,VT,25,1,24
2009,3,WA,470,18,452
2009,3,WI,66,0,66
2009,3,WV,148,0,148
2009,3,WY,17,0,17
2009,4,AK,16,1,15
2009,4,AL,402,10,392
2009,4,AR,206,10,196
2009,4,AZ,241,8,233
2009,4,CA,3695,55,3640
2009,4,CO,172,1,171
2009,4,CT,411,4,407
2009,4,DC,13,0,13
2009,4,DE,242,3,239
2009,4,FL,29111,384,28727
2009,4,GA,895,21,874
2009,4,GU,1,0,1
2009,4,HI,266,3,263
2009,4,IA,99,1,98
2009,4,ID,64,0,64
2009,4,IL,421,8,413
2009,4,IN,202,4,198
2009,4,KS,87,0,87
2009,4,KY,187,3,184
2009,4,LA,5883,108,5775
2009,4,MA,402,6,396
2009,4,MD,708,54,654
2009,4,ME,77,0,77
2009,4,MI,165,12,153
2009,4,MN,72,3,69
2009,4,MO,193,6,187
2009,4,MS,795,10,785
2009,4,MT,32,1,31
2009,4,NC,1384,23,1361
2009,4,ND,56,1,55
2009,4,NE,74,0,74
2009,4,NH,60,1,59
2009,4,NJ,2127,55,2072
2009,4,NM,91,4,87
2009,4,NV,171,1,170
2009,4,NY,1692,25,1667
2009,4,OH,268,1,267
2009,4,OK,97,1,96
2009,4,OR,454,8,446
2009,4,PA,791,8,783
2009,4,PR,527,0,527
2009,4,RI,98,1,97
2009,4,SC,2125,31,2094
2009,4,SD,32,0,32
2009,4,TN,224,3,221
2009,4,TX,6092,87,6005
2009,4,UT,45,10,35
2009,4,VA,1025,28,997
2009,4,VI,10,0,10
2009,4,VT,32,0,32
2009,4,WA,511,11,500
2009,4,WI,94,5,89
2009,4,WV,163,0,163
2009,4,WY,16,0,16
2009,5,AK,18,0,18
2009,5,AL,749,9,740
2009,5,AR,170,3,167
2009,5,AZ,241,4,237
2009,5,CA,4479,69,4410
2009,5,CO,143,3,140
2009,5,CT,282,7,275
2009,5,DC,10,0,10
2009,5,DE,177,6,171
2009,5,FL,23699,1101,22598
2009,5,GA,860,31,829
2009,5,HI,1678,2,1676
2009,5,IA,146,2,144
2009,5,ID,118,2,116
2009,5,IL,409,9,400
2009,5,IN,217,4,213
2009,5,KS,93,1,92
2009,5,KY,207,3,204
2009,5,LA,5502,162,5340
2009,5,MA,417,6,411
2009,5,MD,535,14,521
2009,5,ME,117,0,117
2009,5,MI,180,6,174
2009,5,MN,94,4,90
2009,5,MO,208,3,205
2009,5,MS,1086,7,1079
2009,5,MT,53,2,51
2009,5,NC,1376,48,1328
2009,5,ND,84,2,82
2009,5,NE,69,4,65
2009,5,NH,75,2,73
2009,5,NJ,2274,55,2219
2009,5,NM,88,2,86
2009,5,NV,196,0,196
2009,5,NY,1358,32,1326
2009,5,OH,348,9,339
2009,5,OK,123,3,120
2009,5,OR,501,8,493
2009,5,PA,1073,33,1040
2009,5,PR,149,0,149
2009,5,RI,105,0,105
2009,5,SC,1634,36,1598
2009,5,SD,46,2,44
2009,5,TN,257,6,251
2009,5,TX,6077,120,5957
2009,5,UT,42,2,40
2009,5,VA,832,35,797
2009,5,VI,12,0,12
2009,5,VT,30,1,29
2009,5,WA,635,19,616
2009,5,WI,103,1,102
2009,5,WV,238,4,234
2009,5,WY,18,2,16
2009,6,AK,21,2,19
2009,6,AL,1089,111,978
2009,6,AR,125,4,121
2009,6,AZ,311,10,301
2009,6,CA,4161,62,4099
2009,6,CO,136,7,129
2009,6,CT,283,11,272
2009,6,DC,11,1,10
2009,6,DE,255,10,245
2009,6,FL,23813,862,22951
2009,6,GA,893,32,861
2009,6,GU,1,0,1
2009,6,HI,851,2,849
2009,6,IA,112,3,109
2009,6,ID,132,2,130
2009,6,IL,383,16,367
2009,6,IN,259,8,251
2009,6,KS,79,2,77
2009,6,KY,217,7,210
2009,6,LA,5332,161,5171
2009,6,MA,447,9,438
2009,6,MD,488,8,480
2009,6,ME,92,9,83
2009,6,MI,175,3,172
2009,6,MN,108,1,107
2009,6,MO,173,5,168
2009,6,MS,967,36,931
2009,6,MT,42,0,42
2009,6,NC,1418,52,1366
2009,6,ND,123,1,122
2009,6,NE,58,4,54
2009,6,NH,78,2,76
2009,6,NJ,1834,73,1761
2009,6,NM,92,4,88
2009,6,NV,269,6,263
2009,6,NY,1512,48,1464
2009,6,OH,413,10,403
2009,6,OK,109,1,108
2009,6,OR,457,12,445
2009,6,PA,943,26,917
2009,6,PR,121,1,120
2009,6,RI,123,4,119
2009,6,SC,1847,61,1786
2009,6,SD,27,0,27
2009,6,TN,246,8,238
2009,6,TX,6140,164,5976
2009,6,UN,1,0,1
2009,6,UT,176,2,174
2009,6,VA,926,36,890
2009,6,VI,5,0,5
2009,6,VT,31,0,31
2009,6,WA,667,17,650
2009,6,WI,116,1,115
2009,6,WV,263,10,253
2009,6,WY,22,0,22
2009,7,AK,20,0,20
2009,7,AL,713,9,704
2009,7,AR,167,3,164
2009,7,AZ,250,7,243
2009,7,CA,3415,80,3335
2009,7,CO,165,8,157
2009,7,CT,288,13,275
2009,7,DC,21,1,20
2009,7,DE,218,9,209
2009,7,FL,24564,1004,23560
2009,7,GA,938,41,897
2009,7,HI,296,24,272
2009,7,IA,164,12,152
2009,7,ID,87,0,87
2009,7,IL,717,14,703
2009,7,IN,231,6,225
2009,7,KS,93,3,90
2009,7,KY,210,6,204
2009,7,LA,5751,230,5521
2009,7,MA,457,16,441
2009,7,MD,535,15,520
2009,7,ME,90,2,88
2009,7,MI,192,7,185
2009,7,MN,119,2,117
2009,7,MO,197,8,189
2009,7,MS,950,22,928
2009,7,MT,51,0,51
2009,7,NC,1487,57,1430
2009,7,ND,209,3,206
2009,7,NE,74,5,69
2009,7,NH,65,1,64
2009,7,NJ,1985,102,1883
2009,7,NM,97,3,94
2009,7,NV,214,3,211
2009,7,NY,1514,37,1477
2009,7,OH,416,11,405
2009,7,OK,132,8,124
2009,7,OR,335,17,318
2009,7,PA,1204,23,1181
2009,7,PR,123,0,123
2009,7,RI,101,4,97
2009,7,SC,2014,55,1959
2009,7,SD,39,0,39
2009,7,TN,239,6,233
2009,7,TX,6026,154,5872
2009,7,UT,54,2,52
2009,7,VA,1019,56,963
2009,7,VI,55,0,55
2009,7,VT,41,2,39
2009,7,WA,467,19,448
2009,7,WI,122,3,119
2009,7,WV,239,8,231
2009,7,WY,28,0,28
2009,8,AK,25,0,25
2009,8,AL,525,19,506
2009,8,AR,144,11,133
2009,8,AZ,311,7,304
2009,8,CA,3695,87,3608
2009,8,CO,181,8,173
2009,8,CT,321,9,312
2009,8,DC,14,0,14
2009,8,DE,256,13,243
2009,8,FL,30305,1225,29080
2009,8,GA,1218,67,1151
2009,8,GU,2,0,2
2009,8,HI,2157,328,1829
2009,8,IA,219,10,209
2009,8,ID,112,7,105
2009,8,IL,485,19,466
2009,8,IN,304,12,292
2009,8,KS,100,4,96
2009,8,KY,218,6,212
2009,8,LA,7702,239,7463
2009,8,MA,432,6,426
2009,8,MD,862,16,846
2009,8,ME,94,3,91
2009,8,MI,317,13,304
2009,8,MN,172,5,167
2009,8,MO,241,8,233
2009,8,MS,1163,25,1138
2009,8,MT,58,0,58
2009,8,NC,1939,78,1861
2009,8,ND,382,6,376
2009,8,NE,96,4,92
2009,8,NH,102,0,102
2009,8,NJ,2336,110,2226
2009,8,NM,134,2,132
2009,8,NV,220,8,212
2009,8,NY,1615,48,1567
2009,8,OH,409,15,394
2009,8,OK,131,5,126
2009,8,OR,418,17,401
2009,8,PA,1236,27,1209
2009,8,PR,145,0,145
2009,8,RI,378,10,368
2009,8,SC,2603,69,2534
2009,8,SD,48,2,46
2009,8,TN,390,13,377
2009,8,TX,8048,221,7827
2009,8,UT,72,4,68
2009,8,VA,1372,56,1316
2009,8,VI,11,0,11
2009,8,VT,31,1,30
2009,8,WA,595,27,568
2009,8,WI,118,5,113
2009,8,WV,281,8,273
2009,8,WY,21,0,21
2009,9,AK,32,5,27
2009,9,AL,512,29,483
2009,9,AR,155,6,149
2009,9,AZ,264,36,228
2009,9,CA,2875,149,2726
2009,9,CO,223,11,212
2009,9,CT,314,12,302
2009,9,DC,10,0,10
2009,9,DE,235,11,224
2009,9,FL,30410,2681,27729
2009,9,GA,1041,41,1000
2009,9,GU,4,1,3
2009,9,HI,979,463,516
2009,9,IA,211,15,196
2009,9,ID,190,7,183
2009,9,IL,522,15,507
2009,9,IN,288,16,272
2009,9,KS,118,7,111
2009,9,KY,189,5,184
2009,9,LA,6712,291,6421
2009,9,MA,412,18,394
2009,9,MD,768,16,752
2009,9,ME,115,3,112
2009,9,MI,211,4,207
2009,9,MN,251,2,249
2009,9,MO,220,12,208
2009,9,MS,1045,17,1028
2009,9,MT,49,0,49
2009,9,NC,1922,78,1844
2009,9,ND,643,3,640
2009,9,NE,90,3,87
2009,9,NH,67,2,65
2009,9,NJ,2156,123,2033
2009,9,NM,162,8,154
2009,9,NV,236,10,226
2009,9,NY,1628,88,1540
2009,9,OH,400,17,383
2009,9,OK,146,6,140
2009,9,OR,417,16,401
2009,9,PA,995,27,968
2009,9,PR,147,0,147
2009,9,RI,123,6,117
2009,9,SC,2367,83,2284
2009,9,SD,61,1,60
2009,9,TN,611,8,603
2009,9,TX,6837,233,6604
2009,9,UT,100,20,80
2009,9,VA,926,54,872
2009,9,VI,75,1,74
2009,9,VT,41,2,39
2009,9,WA,624,37,587
2009,9,WI,155,5,150
2009,9,WV,255,7,248
2009,9,WY,27,0,27
2009,10,AK,26,1,25
2009,10,AL,478,14,464
2009,10,AR,138,12,126
2009,10,AZ,258,9,249
2009,10,CA,2522,113,2409
2009,10,CO,203,5,198
2009,10,CT,268,15,253
2009,10,DC,16,1,15
2009,10,DE,239,10,229
2009,10,FL,25598,1274,24324
2009,10,GA,890,54,836
2009,10,HI,506,11,495
2009,10,IA,240,6,234
2009,10,ID,146,2,144
2009,10,IL,535,28,507
2009,10,IN,309,17,292
2009,10,KS,100,3,97
2009,10,KY,218,14,204
2009,10,LA,6179,293,5886
2009,10,MA,462,11,451
2009,10,MD,480,25,455
2009,10,ME,115,6,109
2009,10,MI,171,12,159
2009,10,MN,369,8,361
2009,10,MO,232,11,221
2009,10,MS,1161,26,1135
2009,10,MT,61,1,60
2009,10,NC,1572,71,1501
2009,10,ND,1058,5,1053
2009,10,NE,82,9,73
2009,10,NH,125,0,125
2009,10,NJ,1843,134,1709
2009,10,NM,118,7,111
2009,10,NV,253,7,246
2009,10,NY,1587,62,1525
2009,10,OH,417,8,409
2009,10,OK,136,5,131
2009,10,OR,342,13,329
2009,10,PA,899,21,878
2009,10,PR,250,3,247
2009,10,RI,112,6,106
2009,10,SC,2794,175,2619
2009,10,SD,42,2,40
2009,10,TN,458,9,449
2009,10,TX,6504,229,6275
2009,10,UT,69,1,68
2009,10,VA,1268,46,1222
2009,10,VI,19,0,19
2009,10,VT,52,2,50
2009,10,WA,573,24,549
2009,10,WI,184,47,137
2009,10,WV,224,7,217
2009,10,WY,22,1,21
2009,11,AK,19,0,19
2009,11,AL,653,119,534
2009,11,AR,119,8,111
2009,11,AZ,267,17,250
2009,11,CA,2325,93,2232
2009,11,CO,228,7,221
2009,11,CT,319,19,300
2009,11,DC,12,0,12
2009,11,DE,226,7,219
2009,11,FL,26098,1331,24767
2009,11,GA,987,64,923
2009,11,GU,1,0,1
2009,11,HI,593,152,441
2009,11,IA,189,13,176
2009,11,ID,128,1,127
2009,11,IL,458,23,435
2009,11,IN,288,10,278
2009,11,KS,120,8,112
2009,11,KY,202,7,195
2009,11,LA,6428,247,6181
2009,11,MA,579,18,561
2009,11,MD,972,25,947
2009,11,ME,104,2,102
2009,11,MI,206,4,202
2009,11,MN,324,7,317
2009,11,MO,230,10,220
2009,11,MS,1363,42,1321
2009,11,MT,63,3,60
2009,11,NC,1542,80,1462
2009,11,ND,1013,8,1005
2009,11,NE,82,2,80
2009,11,NH,73,2,71
2009,11,NJ,2246,173,2073
2009,11,NM,105,6,99
2009,11,NV,186,19,167
2009,11,NY,1557,207,1350
2009,11,OH,379,17,362
2009,11,OK,152,7,145
2009,11,OR,344,23,321
2009,11,PA,922,32,890
2009,11,PR,93,0,93
2009,11,RI,94,3,91
2009,11,SC,2472,86,2386
2009,11,SD,76,4,72
2009,11,TN,540,17,523
2009,11,TX,7057,205,6852
2009,11,UT,74,2,72
2009,11,VA,1033,54,979
2009,11,VI,38,0,38
2009,11,VT,41,4,37
2009,11,WA,503,29,474
2009,11,WI,197,10,187
2009,11,WV,209,10,199
2009,11,WY,31,0,31
2009,12,AK,28,0,28
2009,12,AL,796,112,684
2009,12,AR,166,5,161
2009,12,AZ,272,14,258
2009,12,CA,2936,105,2831
2009,12,CO,259,11,248
2009,12,CT,307,14,293
2009,12,DC,12,0,12
2009,12,DE,362,48,314
2009,12,FL,28759,1641,27118
2009,12,GA,1107,64,1043
2009,12,GU,1,0,1
2009,12,HI,441,6,435
2009,12,IA,207,11,196
2009,12,ID,155,4,151
2009,12,IL,571,31,540
2009,12,IN,267,16,251
2009,12,KS,145,13,132
2009,12,KY,273,14,259
2009,12,LA,7781,457,7324
2009,12,MA,599,183,416
2009,12,MD,825,41,784
2009,12,ME,112,3,109
2009,12,MI,227,14,213
2009,12,MN,352,9,343
2009,12,MO,300,10,290
2009,12,MS,1366,27,1339
2009,12,MT,58,2,56
2009,12,NC,1869,82,1787
2009,12,ND,925,11,914
2009,12,NE,89,6,83
2009,12,NH,93,4,89
2009,12,NJ,2081,164,1917
2009,12,NM,118,8,110
2009,12,NV,187,5,182
2009,12,NY,1564,61,1503
2009,12,OH,399,15,384
2009,12,OK,160,9,151
2009,12,OR,287,26,261
2009,12,PA,974,34,940
2009,12,PR,317,3,314
2009,12,RI,309,169,140
2009,12,SC,2531,146,2385
2009,12,SD,64,4,60
2009,12,TN,431,20,411
2009,12,TX,7999,289,7710
2009,12,UT,89,3,86
2009,12,VA,1729,74,1655
2009,12,VI,312,0,312
2009,12,VT,47,3,44
2009,12,WA,482,29,453
2009,12,WI,173,10,163
2009,12,WV,263,6,257
2009,12,WY,39,0,39
2009,13,AK,22,0,22
2009,13,AL,830,95,735
2009,13,AR,168,10,158
2009,13,AZ,301,32,269
2009,13,CA,2930,194,2736
2009,13,CO,294,8,286
2009,13,CT,356,15,341
2009,13,DC,15,4,11
2009,13,DE,265,23,242
2009,13,FL,39699,2906,36793
2009,13,GA,1328,101,1227
2009,13,GU,1,0,1
2009,13,HI,398,36,362
2009,13,IA,203,15,188
2009,13,ID,138,6,132
2009,13,IL,639,47,592
2009,13,IN,295,19,276
2009,13,KS,156,13,143
2009,13,KY,221,13,208
2009,13,LA,8130,400,7730
2009,13,MA,470,32,438
2009,13,MD,771,62,709
2009,13,ME,177,5,172
2009,13,MI,197,14,183
2009,13,MN,498,12,486
2009,13,MO,287,12,275
2009,13,MS,1382,41,1341
2009,13,MT,54,3,51
2009,13,NC,2237,94,2143
2009,13,ND,1474,31,1443
2009,13,NE,90,5,85
2009,13,NH,148,7,141
2009,13,NJ,2384,153,2231
2009,13,NM,121,13,108
2009,13,NV,171,10,161
2009,13,NY,1761,83,1678
2009,13,OH,404,33,371
2009,13,OK,177,8,169
2009,13,OR,372,28,344
2009,13,PA,984,50,934
2009,13,PR,233,1,232
2009,13,RI,122,9,113
2009,13,SC,3753,193,3560
2009,13,SD,65,4,61
2009,13,TN,450,15,435
2009,13,TX,8786,386,8400
2009,13,UT,75,4,71
2009,13,VA,1375,115,1260
2009,13,VI,7,0,7
2009,13,VT,42,2,40
2009,13,WA,659,43,616
2009,13,WI,232,15,217
2009,13,WV,291,9,282
2009,13,WY,42,0,42
2009,14,AK,26,2,24
2009,14,AL,613,30,583
2009,14,AR,171,11,160
2009,14,AZ,266,25,241
2009,14,CA,2242,117,2125
2009,14,CO,258,9,249
2009,14,CT,308,18,290
2009,14,DC,6,0,6
2009,14,DE,251,22,229
2009,14,FL,28059,1411,26648
2009,14,GA,977,63,914
2009,14,GU,4,0,4
2009,14,HI,571,14,557
2009,14,IA,247,14,233
2009,14,ID,103,5,98
2009,14,IL,513,19,494
2009,14,IN,286,15,271
2009,14,KS,137,2,135
2009,14,KY,216,30,186
2009,14,LA,7254,368,6886
2009,14,MA,434,19,415
2009,14,MD,680,136,544
2009,14,ME,175,6,169
2009,14,MI,172,10,162
2009,14,MN,662,13,649
2009,14,MO,298,15,283
2009,14,MS,1442,102,1340
2009,14,MT,48,2,46
2009,14,NC,1572,88,1484
2009,14,ND,1991,33,1958
2009,14,NE,84,9,75
2009,14,NH,121,2,119
2009,14,NJ,1992,148,1844
2009,14,NM,97,10,87
2009,14,NV,139,8,131
2009,14,NY,1730,75,1655
2009,14,OH,378,20,358
2009,14,OK,186,6,180
2009,14,OR,263,7,256
2009,14,PA,804,32,772
2009,14,PR,244,12,232
2009,14,RI,182,63,119
2009,14,SC,2308,103,2205
2009,14,SD,56,3,53
2009,14,TN,299,19,280
2009,14,TX,7642,315,7327
2009,14,UT,126,20,106
2009,14,VA,1113,87,1026
2009,14,VI,3,0,3
2009,14,VT,40,1,39
2009,14,WA,427,29,398
2009,14,WI,319,11,308
2009,14,WV,237,7,230
2009,14,WY,41,4,37
2009,15,AK,33,3,30
2009,15,AL,1109,23,1086
2009,15,AR,162,11,151
2009,15,AZ,266,12,254
2009,15,CA,2273,120,2153
2009,15,CO,261,9,252
2009,15,CT,334,14,320
2009,15,DC,11,1,10
2009,15,DE,274,21,253
2009,15,FL,34248,1736,32512
2009,15,GA,1144,78,1066
2009,15,GU,4,0,4
2009,15,HI,922,199,723
2009,15,IA,209,12,197
2009,15,ID,94,6,88
2009,15,IL,627,29,598
2009,15,IN,279,18,261
2009,15,KS,156,10,146
2009,15,KY,233,26,207
2009,15,LA,8281,404,7877
2009,15,MA,489,18,471
2009,15,MD,771,136,635
2009,15,ME,162,5,157
2009,15,MI,191,12,179
2009,15,MN,482,17,465
2009,15,MO,310,17,293
2009,15,MS,1449,37,1412
2009,15,MT,63,3,60
2009,15,NC,1931,107,1824
2009,15,ND,1535,46,1489
2009,15,NE,76,4,72
2009,15,NH,109,3,106
2009,15,NJ,2163,176,1987
2009,15,NM,109,12,97
2009,15,NV,142,1,141
2009,15,NY,1733,63,1670
2009,15,OH,397,20,377
2009,15,OK,198,15,183
2009,15,OR,326,19,307
2009,15,PA,742,39,703
2009,15,PR,106,2,104
2009,15,RI,133,5,128
2009,15,SC,2242,138,2104
2009,15,SD,61,2,59
2009,15,TN,314,17,297
2009,15,TX,8561,330,8231
2009,15,UT,93,22,71
2009,15,VA,1243,73,1170
2009,15,VI,73,60,13
2009,15,VT,40,0,40
2009,15,WA,471,28,443
2009,15,WI,232,8,224
2009,15,WV,206,14,192
2009,15,WY,64,2,62
2009,16,AK,39,1,38
2009,16,AL,659,36,623
2009,16,AR,160,12,148
2009,16,AZ,248,18,230
2009,16,CA,2232,113,2119
2009,16,CO,356,13,343
2009,16,CT,367,47,320
2009,16,DC,10,0,10
2009,16,DE,244,16,228
2009,16,FL,32309,2055,30254
2009,16,GA,1174,89,1085
2009,16,HI,576,12,564
2009,16,IA,184,17,167
2009,16,ID,110,8,102
2009,16,IL,672,27,645
2009,16,IN,285,22,263
2009,16,KS,172,5,167
2009,16,KY,231,13,218
2009,16,LA,8891,437,8454
2009,16,MA,433,16,417
2009,16,MD,766,55,711
2009,16,ME,138,5,133
2009,16,MI,174,15,159
2009,16,MN,167,10,157
2009,16,MO,331,12,319
2009,16,MS,1569,38,1531
2009,16,MT,67,2,65
2009,16,NC,1926,105,1821
2009,16,ND,217,13,204
2009,16,NE,104,8,96
2009,16,NH,95,5,90
2009,16,NJ,2381,179,2202
2009,16,NM,102,2,100
2009,16,NV,131,10,121
2009,16,NY,1813,96,1717
2009,16,OH,402,27,375
2009,16,OK,169,7,162
2009,16,OR,266,27,239
2009,16,PA,823,44,779
2009,16,PR,701,6,695
2009,16,RI,176,6,170
2009,16,SC,2719,134,2585
2009,16,SD,53,4,49
2009,16,TN,332,19,313
2009,16,TX,10049,449,9600
2009,16,UN,1,0,1
2009,16,UT,89,50,39
2009,16,VA,1202,87,1115
2009,16,VI,15,0,15
2009,16,VT,35,2,33
2009,16,WA,495,36,459
2009,16,WI,256,9,247
2009,16,WV,243,16,227
2009,16,WY,54,2,52
2009,17,AK,39,3,36
2009,17,AL,1038,49,989
2009,17,AR,189,9,180
2009,17,AZ,320,26,294
2009,17,CA,3026,123,2903
2009,17,CO,300,18,282
2009,17,CT,421,30,391
2009,17,DC,17,1,16
2009,17,DE,363,33,330
2009,17,FL,53531,4406,49125
2009,17,GA,1775,132,1643
2009,17,GU,1,0,1
2009,17,HI,2085,185,1900
2009,17,IA,194,9,185
2009,17,ID,184,6,178
2009,17,IL,662,33,629
2009,17,IN,279,26,253
2009,17,KS,247,14,233
2009,17,KY,257,19,238
2009,17,LA,12111,626,11485
2009,17,MA,714,25,689
2009,17,MD,828,83,745
2009,17,ME,162,5,157
2009,17,MI,224,12,212
2009,17,MN,154,11,143
2009,17,MO,437,37,400
2009,17,MS,1754,58,1696
2009,17,MT,74,3,71
2009,17,NC,2783,262,2521
2009,17,ND,115,11,104
2009,17,NE,91,8,83
2009,17,NH,108,9,99
2009,17,NJ,3123,211,2912
2009,17,NM,131,8,123
2009,17,NV,162,12,150
2009,17,NY,2024,108,1916
2009,17,OH,406,19,387
2009,17,OK,233,13,220
2009,17,OR,334,26,308
2009,17,PA,933,61,872
2009,17,PR,1038,5,1033
2009,17,RI,164,14,150
2009,17,SC,3790,250,3540
2009,17,SD,66,2,64
2009,17,TN,334,28,306
2009,17,TX,12995,584,12411
2009,17,UT,67,0,67
2009,17,VA,1887,150,1737
2009,17,VI,12,0,12
2009,17,VT,37,3,34
2009,17,WA,504,59,445
2009,17,WI,185,8,177
2009,17,WV,224,11,213
2009,17,WY,48,4,44
2009,18,AK,30,0,30
2009,18,AL,823,212,611
2009,18,AR,209,10,199
2009,18,AZ,213,21,192
2009,18,CA,2169,151,2018
2009,18,CO,340,19,321
2009,18,CT,298,19,279
2009,18,DC,14,0,14
2009,18,DE,282,22,260
2009,18,FL,30836,2506,28330
2009,18,GA,1096,86,1010
2009,18,HI,1272,16,1256
2009,18,IA,122,9,113
2009,18,ID,87,6,81
2009,18,IL,483,39,444
2009,18,IN,297,19,278
2009,18,KS,134,10,124
2009,18,KY,226,7,219
2009,18,LA,8503,459,8044
2009,18,MA,525,179,346
2009,18,MD,582,46,536
2009,18,ME,84,3,81
2009,18,MI,156,22,134
2009,18,MN,140,8,132
2009,18,MO,284,21,263
2009,18,MS,1558,67,1491
2009,18,MT,68,2,66
2009,18,NC,1688,123,1565
2009,18,ND,77,20,57
2009,18,NE,68,6,62
2009,18,NH,69,9,60
2009,18,NJ,2143,310,1833
2009,18,NM,109,6,103
2009,18,NV,118,3,115
2009,18,NY,1557,76,1481
2009,18,OH,331,20,311
2009,18,OK,186,7,179
2009,18,OR,539,31,508
2009,18,PA,755,62,693
2009,18,PR,128,5,123
2009,18,RI,108,7,101
2009,18,SC,2266,151,2115
2009,18,SD,50,1,49
2009,18,TN,316,18,298
2009,18,TX,9590,399,9191
2009,18,UN,4,0,4
2009,18,UT,155,5,150
2009,18,VA,1211,111,1100
2009,18,VI,8,0,8
2009,18,VT,34,3,31
2009,18,WA,454,51,403
2009,18,WI,165,14,151
2009,18,WV,210,21,189
2009,18,WY,44,2,42
2009,19,AK,43,3,40
2009,19,AL,906,89,817
2009,19,AR,165,7,158
2009,19,AZ,238,24,214
2009,19,CA,2149,130,2019
2009,19,CO,237,14,223
2009,19,CT,321,13,308
2009,19,DC,9,1,8
2009,19,DE,393,44,349
2009,19,FL,34992,2486,32506
2009,19,GA,1306,98,1208
2009,19,GU,1,0,1
2009,19,HI,717,103,614
2009,19,IA,133,11,122
2009,19,ID,96,2,94
2009,19,IL,535,27,508
2009,19,IN,190,15,175
2009,19,KS,154,8,146
2009,19,KY,259,33,226
2009,19,LA,8752,474,8278
2009,19,MA,413,38,375
2009,19,MD,755,73,682
2009,19,ME,108,6,102
2009,19,MI,169,11,158
2009,19,MN,90,8,82
2009,19,MO,275,22,253
2009,19,MS,1452,54,1398
2009,19,MT,71,5,66
2009,19,NC,2077,144,1933
2009,19,ND,51,13,38
2009,19,NE,64,9,55
2009,19,NH,81,10,71
2009,19,NJ,2412,225,2187
2009,19,NM,89,8,81
2009,19,NV,122,7,115
2009,19,NY,1989,138,1851
2009,19,OH,317,24,293
2009,19,OK,192,9,183
2009,19,OR,264,22,242
2009,19,PA,744,28,716
2009,19,PR,320,3,317
2009,19,RI,120,5,115
2009,19,SC,2876,158,2718
2009,19,SD,51,1,50
2009,19,TN,260,22,238
2009,19,TX,10469,442,10027
2009,19,UT,65,6,59
2009,19,VA,1430,88,1342
2009,19,VI,8,1,7
2009,19,VT,30,2,28
2009,19,WA,420,48,372
2009,19,WI,147,9,138
2009,19,WV,230,15,215
2009,19,WY,47,2,45
2009,20,AK,20,2,18
2009,20,AL,825,31,794
2009,20,AR,153,8,145
2009,20,AZ,239,25,214
2009,20,CA,2092,153,1939
2009,20,CO,362,14,348
2009,20,CT,319,20,299
2009,20,DC,12,1,11
2009,20,DE,273,28,245
2009,20,FL,33695,2290,31405
2009,20,GA,1235,99,1136
2009,20,GU,1,0,1
2009,20,HI,351,11,340
2009,20,IA,204,11,193
2009,20,ID,135,11,124
2009,20,IL,403,52,351
2009,20,IN,221,25,196
2009,20,KS,138,15,123
2009,20,KY,221,21,200
2009,20,LA,9408,529,8879
2009,20,MA,422,32,390
2009,20,MD,649,36,613
2009,20,ME,77,4,73
2009,20,MI,139,11,128
2009,20,MN,86,9,77
2009,20,MO,230,12,218
2009,20,MS,1655,61,1594
2009,20,MT,60,1,59
2009,20,NC,2122,157,1965
2009,20,ND,65,20,45
2009,20,NE,83,7,76
2009,20,NH,83,6,77
2009,20,NJ,2523,250,2273
2009,20,NM,116,8,108
2009,20,NV,129,7,122
2009,20,NY,1828,101,1727
2009,20,OH,326,16,310
2009,20,OK,165,8,157
2009,20,OR,332,26,306
2009,20,PA,852,30,822
2009,20,PR,424,2,422
2009,20,RI,136,10,126
2009,20,SC,2923,166,2757
2009,20,SD,93,5,88
2009,20,TN,237,24,213
2009,20,TX,12150,577,11573
2009,20,UT,53,3,50
2009,20,VA,1310,100,1210
2009,20,VI,15,1,14
2009,20,VT,36,7,29
2009,20,WA,380,31,349
2009,20,WI,139,10,129
2009,20,WV,183,15,168
2009,20,WY,40,2,38
2009,21,AK,33,2,31
2009,21,AL,1001,41,960
2009,21,AR,154,12,142
2009,21,AZ,281,27,254
2009,21,CA,2256,144,2112
2009,21,CO,237,15,222
2009,21,CT,399,18,381
2009,21,DC,13,2,11
2009,21,DE,293,22,271
2009,21,FL,39600,2650,36950
2009,21,GA,1487,114,1373
2009,21,GU,3,0,3
2009,21,HI,1917,1043,874
2009,21,IA,166,15,151
2009,21,ID,79,5,74
2009,21,IL,470,44,426
2009,21,IN,227,20,207
2009,21,KS,169,20,149
2009,21,KY,197,10,187
2009,21,LA,11401,635,10766
2009,21,MA,449,25,424
2009,21,MD,833,45,788
2009,21,ME,114,7,107
2009,21,MI,165,9,156
2009,21,MN,107,9,98
2009,21,MO,258,24,234
2009,21,MS,1973,70,1903
2009,21,MT,78,5,73
2009,21,NC,2307,148,2159
2009,21,ND,94,21,73
2009,21,NE,89,9,80
2009,21,NH,86,3,83
2009,21,NJ,3055,256,2799
2009,21,NM,97,7,90
2009,21,NV,156,13,143
2009,21,NY,2134,81,2053
2009,21,OH,336,24,312
2009,21,OK,176,8,168
2009,21,OR,234,27,207
2009,21,PA,752,47,705
2009,21,PR,346,0,346
2009,21,RI,192,12,180
2009,21,SC,3732,235,3497
2009,21,SD,40,3,37
2009,21,TN,310,31,279
2009,21,TX,15040,576,14464
2009,21,UT,90,3,87
2009,21,VA,1753,143,1610
2009,21,VI,11,2,9
2009,21,VT,18,2,16
2009,21,WA,439,49,390
2009,21,WI,131,13,118
2009,21,WV,184,9,175
2009,21,WY,35,8,27
2009,22,AK,34,3,31
2009,22,AL,1107,94,1013
2009,22,AR,183,25,158
2009,22,AZ,242,18,224
2009,22,CA,2360,176,2184
2009,22,CO,240,22,218
2009,22,CT,397,31,366
2009,22,DC,11,0,11
2009,22,DE,326,24,302
2009,22,FL,45611,4281,41330
2009,22,GA,1824,92,1732
2009,22,GU,1,0,1
2009,22,HI,871,132,739
2009,22,IA,143,19,124
2009,22,ID,76,9,67
2009,22,IL,374,37,337
2009,22,IN,249,29,220
2009,22,KS,184,22,162
2009,22,KY,207,15,192
2009,22,LA,13209,1391,11818
2009,22,MA,532,78,454
2009,22,MD,799,52,747
2009,22,ME,92,8,84
2009,22,MI,133,17,116
2009,22,MN,100,11,89
2009,22,MO,260,18,242
2009,22,MS,2235,70,2165
2009,22,MT,70,4,66
2009,22,NC,2551,175,2376
2009,22,ND,62,18,44
2009,22,NE,67,11,56
2009,22,NH,89,14,75
2009,22,NJ,3363,376,2987
2009,22,NM,108,6,102
2009,22,NV,140,6,134
2009,22,NY,2003,126,1877
2009,22,OH,353,33,320
2009,22,OK,224,15,209
2009,22,OR,346,31,315
2009,22,PA,745,62,683
2009,22,PR,256,1,255
2009,22,RI,216,24,192
2009,22,SC,3545,237,3308
2009,22,SD,43,2,41
2009,22,TN,290,23,267
2009,22,TX,15783,557,15226
2009,22,UT,96,5,91
2009,22,VA,2143,153,1990
2009,22,VI,13,1,12
2009,22,VT,31,1,30
2009,22,WA,368,51,317
2009,22,WI,127,18,109
2009,22,WV,195,16,179
2009,22,WY,42,5,37
2009,23,AK,32,4,28
2009,23,AL,938,64,874
2009,23,AR,160,20,140
2009,23,AZ,270,24,246
2009,23,CA,2318,132,2186
2009,23,CO,203,16,187
2009,23,CT,338,20,318
2009,23,DC,265,2,263
2009,23,DE,239,16,223
2009,23,FL,35009,2827,32182
2009,23,GA,1428,119,1309
2009,23,GU,1,0,1
2009,23,HI,588,179,409
2009,23,IA,166,18,148
2009,23,ID,60,5,55
2009,23,IL,440,37,403
2009,23,IN,198,16,182
2009,23,KS,170,8,162
2009,23,KY,255,20,235
2009,23,LA,10735,702,10033
2009,23,MA,510,18,492
2009,23,MD,664,65,599
2009,23,ME,115,11,104
2009,23,MI,141,17,124
2009,23,MN,96,5,91
2009,23,MO,300,17,283
2009,23,MS,1726,69,1657
2009,23,MT,64,4,60
2009,23,NC,2298,165,2133
2009,23,ND,62,23,39
2009,23,NE,94,11,83
2009,23,NH,69,8,61
2009,23,NJ,2280,257,2023
2009,23,NM,115,12,103
2009,23,NV,129,13,116
2009,23,NY,1855,99,1756
2009,23,OH,284,17,267
2009,23,OK,227,19,208
2009,23,OR,251,24,227
2009,23,PA,652,44,608
2009,23,PR,263,16,247
2009,23,RI,153,12,141
2009,23,SC,3226,207,3019
2009,23,SD,41,7,34
2009,23,TN,285,19,266
2009,23,TX,15738,593,15145
2009,23,UT,44,2,42
2009,23,VA,1651,164,1487
2009,23,VI,26,0,26
2009,23,VT,17,2,15
2009,23,WA,361,40,321
2009,23,WI,98,7,91
2009,23,WV,172,10,162
2009,23,WY,33,3,30
2009,24,AK,20,0,20
2009,24,AL,820,74,746
2009,24,AR,158,23,135
2009,24,AZ,283,28,255
2009,24,CA,2741,182,2559
2009,24,CO,404,15,389
2009,24,CT,420,29,391
2009,24,DC,14,1,13
2009,24,DE,342,21,321
2009,24,FL,45149,3079,42070
2009,24,GA,1688,116,1572
2009,24,HI,871,21,850
2009,24,IA,132,8,124
2009,24,ID,58,4,54
2009,24,IL,450,48,402
2009,24,IN,230,23,207
2009,24,KS,164,12,152
2009,24,KY,220,53,167
2009,24,LA,11683,703,10980
2009,24,MA,541,53,488
2009,24,MD,793,68,725
2009,24,ME,111,11,100
2009,24,MI,179,18,161
2009,24,MN,119,7,112
2009,24,MO,270,16,254
2009,24,MS,1938,208,1730
2009,24,MT,48,8,40
2009,24,NC,2884,197,2687
2009,24,ND,66,14,52
2009,24,NE,68,7,61
2009,24,NH,95,3,92
2009,24,NJ,2896,315,2581
2009,24,NM,127,11,116
2009,24,NV,108,10,98
2009,24,NY,2327,103,2224
2009,24,OH,316,49,267
2009,24,OK,217,9,208
2009,24,OR,257,29,228
2009,24,PA,784,57,727
2009,24,PR,167,2,165
2009,24,RI,226,11,215
2009,24,SC,3913,369,3544
2009,24,SD,45,4,41
2009,24,TN,275,23,252
2009,24,TX,18626,675,17951
2009,24,UT,42,1,41
2009,24,VA,2028,162,1866
2009,24,VI,101,0,101
2009,24,VT,43,2,41
2009,24,WA,442,54,388
2009,24,WI,159,7,152
2009,24,WV,232,13,219
2009,24,WY,29,3,26
2009,25,AK,23,3,20
2009,25,AL,991,82,909
2009,25,AR,127,14,113
2009,25,AZ,418,24,394
2009,25,CA,1927,138,1789
2009,25,CO,273,23,250
2009,25,CT,393,40,353
2009,25,DC,29,1,28
2009,25,DE,331,36,295
2009,25,FL,43950,3935,40015
2009,25,GA,1607,130,1477
2009,25,GU,1,1,0
2009,25,HI,745,14,731
2009,25,IA,113,6,107
2009,25,ID,77,13,64
2009,25,IL,363,26,337
2009,25,IN,198,18,180
2009,25,KS,154,13,141
2009,25,KY,190,25,165
2009,25,LA,11600,725,10875
2009,25,MA,494,38,456
2009,25,MD,923,78,845
2009,25,ME,117,7,110
2009,25,MI,155,13,142
2009,25,MN,88,9,79
2009,25,MO,212,16,196
2009,25,MS,1751,58,1693
2009,25,MT,114,2,112
2009,25,NC,2495,193,2302
2009,25,ND,48,13,35
2009,25,NE,68,10,58
2009,25,NH,65,4,61
2009,25,NJ,3205,340,2865
2009,25,NM,135,19,116
2009,25,NV,131,12,119
2009,25,NY,3504,104,3400
2009,25,OH,304,25,279
2009,25,OK,173,17,156
2009,25,OR,237,17,220
2009,25,PA,880,82,798
2009,25,PR,237,6,231
2009,25,RI,219,11,208
2009,25,SC,3678,322,3356
2009,25,SD,47,4,43
2009,25,TN,252,24,228
2009,25,TX,20304,838,19466
2009,25,UT,47,12,35
2009,25,VA,2138,171,1967
2009,25,VI,9,1,8
2009,25,VT,32,3,29
2009,25,WA,329,53,276
2009,25,WI,131,19,112
2009,25,WV,198,27,171
2009,25,WY,22,4,18
2009,26,AK,36,4,32
2009,26,AL,1074,64,1010
2009,26,AR,155,16,139
2009,26,AZ,309,25,284
2009,26,CA,2314,195,2119
2009,26,CO,279,22,257
2009,26,CT,530,51,479
2009,26,DC,21,1,20
2009,26,DE,426,33,393
2009,26,FL,52898,4409,48489
2009,26,GA,2401,160,2241
2009,26,HI,1344,223,1121
2009,26,IA,185,27,158
2009,26,ID,60,12,48
2009,26,IL,533,41,492
2009,26,IN,249,33,216
2009,26,KS,185,17,168
2009,26,KY,226,31,195
2009,26,LA,15760,1066,14694
2009,26,MA,769,48,721
2009,26,MD,1616,99,1517
2009,26,ME,125,10,115
2009,26,MI,139,14,125
2009,26,MN,108,16,92
2009,26,MO,254,25,229
2009,26,MS,2096,103,1993
2009,26,MT,37,1,36
2009,26,NC,3236,218,3018
2009,26,ND,50,22,28
2009,26,NE,105,10,95
2009,26,NH,120,11,109
2009,26,NJ,3009,316,2693
2009,26,NM,150,12,138
2009,26,NV,135,11,124
2009,26,NY,2673,204,2469
2009,26,OH,374,31,343
2009,26,OK,203,20,183
2009,26,OR,280,30,250
2009,26,PA,866,77,789
2009,26,PR,579,3,576
2009,26,RI,240,19,221
2009,26,SC,5446,371,5075
2009,26,SD,43,4,39
2009,26,TN,266,24,242
2009,26,TX,27415,1256,26159
2009,26,UN,1,0,1
2009,26,UT,53,11,42
2009,26,VA,2761,251,2510
2009,26,VI,18,1,17
2009,26,VT,33,5,28
2009,26,WA,384,52,332
2009,26,WI,130,11,119
2009,26,WV,263,18,245
2009,26,WY,27,2,25
2009,27,AK,26,6,20
2009,27,AL,1055,66,989
2009,27,AR,129,17,112
2009,27,AZ,289,28,261
2009,27,CA,2054,151,1903
2009,27,CO,214,18,196
2009,27,CT,429,60,369
2009,27,DC,22,2,20
2009,27,DE,369,81,288
2009,27,FL,42383,2513,39870
2009,27,GA,1936,150,1786
2009,27,HI,317,133,184
2009,27,IA,193,21,172
2009,27,ID,48,8,40
2009,27,IL,408,40,368
2009,27,IN,305,23,282
2009,27,KS,139,18,121
2009,27,KY,217,16,201
2009,27,LA,12317,826,11491
2009,27,MA,586,62,524
2009,27,MD,834,95,739
2009,27,ME,113,16,97
2009,27,MI,121,9,112
2009,27,MN,111,12,99
2009,27,MO,269,30,239
2009,27,MS,1479,87,1392
2009,27,MT,33,1,32
2009,27,NC,2728,309,2419
2009,27,ND,42,16,26
2009,27,NE,76,14,62
2009,27,NH,88,7,81
2009,27,NJ,2296,273,2023
2009,27,NM,128,16,112
2009,27,NV,106,8,98
2009,27,NY,2310,130,2180
2009,27,OH,349,40,309
2009,27,OK,163,14,149
2009,27,OR,351,27,324
2009,27,PA,684,58,626
2009,27,PR,290,2,288
2009,27,RI,202,14,188
2009,27,SC,3597,250,3347
2009,27,SD,62,5,57
2009,27,TN,234,22,212
2009,27,TX,24789,863,23926
2009,27,UT,46,2,44
2009,27,VA,2251,216,2035
2009,27,VI,16,1,15
2009,27,VT,17,3,14
2009,27,WA,350,40,310
2009,27,WI,143,11,132
2009,27,WV,217,18,199
2009,27,WY,54,5,49
2009,28,AK,23,2,21
2009,28,AL,815,65,750
2009,28,AR,161,19,142
2009,28,AZ,286,31,255
2009,28,CA,2667,168,2499
2009,28,CO,248,37,211
2009,28,CT,470,34,436
2009,28,DC,18,4,14
2009,28,DE,352,35,317
2009,28,FL,43297,4429,38868
2009,28,GA,2036,170,1866
2009,28,HI,1087,794,293
2009,28,IA,195,20,175
2009,28,ID,49,7,42
2009,28,IL,475,39,436
2009,28,IN,458,20,438
2009,28,KS,184,13,171
2009,28,KY,243,29,214
2009,28,LA,12285,971,11314
2009,28,MA,645,47,598
2009,28,MD,895,121,774
2009,28,ME,126,7,119
2009,28,MI,221,20,201
2009,28,MN,128,14,114
2009,28,MO,316,19,297
2009,28,MS,1437,91,1346
2009,28,MT,33,3,30
2009,28,NC,3255,251,3004
2009,28,ND,61,25,36
2009,28,NE,121,8,113
2009,28,NH,156,6,150
2009,28,NJ,3553,296,3257
2009,28,NM,134,19,115
2009,28,NV,163,15,148
2009,28,NY,2756,117,2639
2009,28,OH,408,36,372
2009,28,OK,194,12,182
2009,28,OR,278,34,244
2009,28,PA,781,60,721
2009,28,PR,362,6,356
2009,28,RI,259,13,246
2009,28,SC,4606,512,4094
2009,28,SD,36,6,30
2009,28,TN,306,29,277
2009,28,TX,27575,1026,26549
2009,28,UN,1,0,1
2009,28,UT,54,2,52
2009,28,VA,2525,238,2287
2009,28,VI,15,2,13
2009,28,VT,45,2,43
2009,28,WA,392,60,332
2009,28,WI,252,23,229
2009,28,WV,273,21,252
2009,28,WY,26,6,20
2009,29,AK,35,4,31
2009,29,AL,1054,178,876
2009,29,AR,156,10,146
2009,29,AZ,370,33,337
2009,29,CA,1897,176,1721
2009,29,CO,227,21,206
2009,29,CT,439,33,406
2009,29,DC,17,1,16
2009,29,DE,351,25,326
2009,29,FL,40218,3666,36552
2009,29,GA,1788,148,1640
2009,29,HI,1144,104,1040
2009,29,IA,209,19,190
2009,29,ID,54,8,46
2009,29,IL,480,36,444
2009,29,IN,370,18,352
2009,29,KS,182,5,177
2009,29,KY,253,24,229
2009,29,LA,10866,879,9987
2009,29,MA,711,46,665
2009,29,MD,1256,371,885
2009,29,ME,108,9,99
2009,29,MI,203,14,189
2009,29,MN,110,10,100
2009,29,MO,293,29,264
2009,29,MS,1266,99,1167
2009,29,MT,39,0,39
2009,29,NC,2651,236,2415
2009,29,ND,56,16,40
2009,29,NE,85,8,77
2009,29,NH,111,4,107
2009,29,NJ,2481,374,2107
2009,29,NM,125,18,107
2009,29,NV,155,10,145
2009,29,NY,2424,148,2276
2009,29,OH,375,19,356
2009,29,OK,189,15,174
2009,29,OR,270,24,246
2009,29,PA,955,145,810
2009,29,PR,827,4,823
2009,29,RI,245,9,236
2009,29,SC,3642,471,3171
2009,29,SD,44,5,39
2009,29,TN,316,22,294
2009,29,TX,24570,1183,23387
2009,29,UT,40,3,37
2009,29,VA,2416,232,2184
2009,29,VI,35,1,34
2009,29,VT,39,2,37
2009,29,WA,434,60,374
2009,29,WI,210,11,199
2009,29,WV,239,27,212
2009,29,WY,33,0,33
2009,30,AK,29,1,28
2009,30,AL,1384,209,1175
2009,30,AR,166,30,136
2009,30,AZ,389,33,356
2009,30,CA,2431,195,2236
2009,30,CO,261,30,231
2009,30,CT,546,36,510
2009,30,DC,25,3,22
2009,30,DE,496,62,434
2009,30,FL,51265,5102,46163
2009,30,GA,2225,197,2028
2009,30,GU,1,0,1
2009,30,HI,1217,436,781
2009,30,IA,217,21,196
2009,30,ID,58,4,54
2009,30,IL,632,59,573
2009,30,IN,392,31,361
2009,30,KS,259,18,241
2009,30,KY,258,29,229
2009,30,LA,12679,996,11683
2009,30,MA,954,164,790
2009,30,MD,1245,101,1144
2009,30,ME,116,21,95
2009,30,MI,174,21,153
2009,30,MN,116,15,101
2009,30,MO,361,27,334
2009,30,MS,1378,116,1262
2009,30,MT,48,8,40
2009,30,NC,3143,257,2886
2009,30,ND,55,21,34
2009,30,NE,112,18,94
2009,30,NH,118,13,105
2009,30,NJ,3375,388,2987
2009,30,NM,189,26,163
2009,30,NV,180,22,158
2009,30,NY,2597,146,2451
2009,30,OH,468,36,432
2009,30,OK,266,19,247
2009,30,OR,352,37,315
2009,30,PA,1107,85,1022
2009,30,PR,236,2,234
2009,30,RI,317,20,297
2009,30,SC,4717,441,4276
2009,30,SD,46,5,41
2009,30,TN,338,34,304
2009,30,TX,24527,1957,22570
2009,30,UN,1,0,1
2009,30,UT,68,3,65
2009,30,VA,3051,250,2801
2009,30,VI,31,0,31
2009,30,VT,37,1,36
2009,30,WA,490,91,399
2009,30,WI,197,17,180
2009,30,WV,260,18,242
2009,30,WY,33,2,31
2009,31,AK,27,3,24
2009,31,AL,722,56,666
2009,31,AR,133,5,128
2009,31,AZ,406,33,373
2009,31,CA,1865,156,1709
2009,31,CO,191,20,171
2009,31,CT,442,68,374
2009,31,DC,264,2,262
2009,31,DE,311,22,289
2009,31,FL,31285,2888,28397
2009,31,GA,1787,151,1636
2009,31,GU,1,1,0
2009,31,HI,1015,175,840
2009,31,IA,176,19,157
2009,31,ID,50,6,44
2009,31,IL,445,78,367
2009,31,IN,311,48,263
2009,31,KS,143,23,120
2009,31,KY,218,38,180
2009,31,LA,8827,829,7998
2009,31,MA,611,35,576
2009,31,MD,707,65,642
2009,31,ME,107,11,96
2009,31,MI,127,11,116
2009,31,MN,77,7,70
2009,31,MO,252,30,222
2009,31,MS,1091,93,998
2009,31,MT,32,4,28
2009,31,NC,2529,212,2317
2009,31,ND,35,18,17
2009,31,NE,68,10,58
2009,31,NH,65,6,59
2009,31,NJ,3041,1040,2001
2009,31,NM,128,11,117
2009,31,NV,145,12,133
2009,31,NY,2106,277,1829
2009,31,OH,316,17,299
2009,31,OK,218,31,187
2009,31,OR,248,27,221
2009,31,PA,853,76,777
2009,31,PR,10413,6,10407
2009,31,RI,260,19,241
2009,31,SC,3239,355,2884
2009,31,SD,38,7,31
2009,31,TN,255,29,226
2009,31,TX,17634,1116,16518
2009,31,UT,44,3,41
2009,31,VA,2065,208,1857
2009,31,VI,17,1,16
2009,31,VT,25,0,25
2009,31,WA,356,54,302
2009,31,WI,126,15,111
2009,31,WV,174,15,159
2009,31,WY,32,4,28
2009,32,AK,25,7,18
2009,32,AL,817,62,755
2009,32,AR,173,21,152
2009,32,AZ,379,41,338
2009,32,CA,1924,195,1729
2009,32,CO,206,21,185
2009,32,CT,479,34,445
2009,32,DC,18,0,18
2009,32,DE,407,31,376
2009,32,FL,38548,3513,35035
2009,32,GA,2183,256,1927
2009,32,HI,579,80,499
2009,32,IA,154,19,135
2009,32,ID,47,7,40
2009,32,IL,402,41,361
2009,32,IN,322,31,291
2009,32,KS,159,10,149
2009,32,KY,205,27,178
2009,32,LA,10272,800,9472
2009,32,MA,688,62,626
2009,32,MD,856,111,745
2009,32,ME,130,8,122
2009,32,MI,156,19,137
2009,32,MN,108,12,96
2009,32,MO,223,25,198
2009,32,MS,1213,108,1105
2009,32,MT,28,5,23
2009,32,NC,3029,245,2784
2009,32,ND,77,22,55
2009,32,NE,84,9,75
2009,32,NH,73,9,64
2009,32,NJ,3452,287,3165
2009,32,NM,179,22,157
2009,32,NV,173,18,155
2009,32,NY,2664,215,2449
2009,32,OH,370,27,343
2009,32,OK,215,19,196
2009,32,OR,294,38,256
2009,32,PA,948,66,882
2009,32,PR,177,3,174
2009,32,RI,295,19,276
2009,32,SC,3957,253,3704
2009,32,SD,85,10,75
2009,32,TN,299,32,267
2009,32,TX,18911,950,17961
2009,32,UT,25,3,22
2009,32,VA,2525,234,2291
2009,32,VI,44,21,23
2009,32,VT,37,1,36
2009,32,WA,446,38,408
2009,32,WI,203,20,183
2009,32,WV,227,11,216
2009,32,WY,20,3,17
2009,33,AK,29,6,23
2009,33,AL,787,69,718
2009,33,AR,164,19,145
2009,33,AZ,369,42,327
2009,33,CA,1951,211,1740
2009,33,CO,200,20,180
2009,33,CT,516,31,485
2009,33,DC,14,0,14
2009,33,DE,323,26,297
2009,33,FL,36500,4071,32429
2009,33,GA,1844,170,1674
2009,33,GU,2,0,2
2009,33,HI,1447,886,561
2009,33,IA,194,21,173
2009,33,ID,48,9,39
2009,33,IL,565,33,532
2009,33,IN,295,24,271
2009,33,KS,133,13,120
2009,33,KY,199,22,177
2009,33,LA,9309,1013,8296
2009,33,MA,736,83,653
2009,33,MD,866,84,782
2009,33,ME,109,13,96
2009,33,MI,166,20,146
2009,33,MN,85,5,80
2009,33,MO,208,26,182
2009,33,MS,1379,104,1275
2009,33,MT,31,2,29
2009,33,NC,2784,261,2523
2009,33,ND,44,9,35
2009,33,NE,75,9,66
2009,33,NH,80,8,72
2009,33,NJ,2598,278,2320
2009,33,NM,150,20,130
2009,33,NV,163,12,151
2009,33,NY,2886,171,2715
2009,33,OH,386,30,356
2009,33,OK,176,13,163
2009,33,OR,254,27,227
2009,33,PA,1194,78,1116
2009,33,PR,201,5,196
2009,33,RI,315,30,285
2009,33,SC,3515,337,3178
2009,33,SD,96,4,92
2009,33,TN,260,26,234
2009,33,TX,18140,944,17196
2009,33,UT,44,7,37
2009,33,VA,2199,254,1945
2009,33,VI,36,1,35
2009,33,VT,29,3,26
2009,33,WA,422,59,363
2009,33,WI,174,31,143
2009,33,WV,232,20,212
2009,33,WY,23,2,21
2009,34,AK,43,4,39
2009,34,AL,1034,94,940
2009,34,AR,162,23,139
2009,34,AZ,447,39,408
2009,34,CA,2282,204,2078
2009,34,CO,213,27,186
2009,34,CT,452,44,408
2009,34,DC,86,2,84
2009,34,DE,366,50,316
2009,34,FL,39589,4341,35248
2009,34,GA,1926,188,1738
2009,34,GU,3,0,3
2009,34,HI,2736,464,2272
2009,34,IA,186,21,165
2009,34,ID,55,7,48
2009,34,IL,410,64,346
2009,34,IN,288,34,254
2009,34,KS,145,23,122
2009,34,KY,201,31,170
2009,34,LA,10216,932,9284
2009,34,MA,877,69,808
2009,34,MD,902,83,819
2009,34,ME,121,10,111
2009,34,MI,153,21,132
2009,34,MN,91,8,83
2009,34,MO,215,32,183
2009,34,MS,1323,96,1227
2009,34,MT,29,5,24
2009,34,NC,2894,274,2620
2009,34,ND,51,14,37
2009,34,NE,98,10,88
2009,34,NH,83,7,76
2009,34,NJ,3017,359,2658
2009,34,NM,167,18,149
2009,34,NV,171,16,155
2009,34,NY,3682,718,2964
2009,34,OH,425,42,383
2009,34,OK,165,13,152
2009,34,OR,359,33,326
2009,34,PA,921,78,843
2009,34,PR,198,5,193
2009,34,RI,337,25,312
2009,34,SC,3924,536,3388
2009,34,SD,138,5,133
2009,34,TN,299,45,254
2009,34,TX,16776,982,15794
2009,34,UT,30,4,26
2009,34,VA,3200,266,2934
2009,34,VI,37,12,25
2009,34,VT,33,4,29
2009,34,WA,626,66,560
2009,34,WI,161,13,148
2009,34,WV,237,15,222
2009,34,WY,27,2,25
2009,35,AK,44,11,33
2009,35,AL,942,118,824
2009,35,AR,140,24,116
2009,35,AZ,357,46,311
2009,35,CA,2359,251,2108
2009,35,CO,371,53,318
2009,35,CT,512,44,468
2009,35,DC,16,1,15
2009,35,DE,382,32,350
2009,35,FL,38226,4172,34054
2009,35,GA,2056,211,1845
2009,35,HI,1695,504,1191
2009,35,IA,175,22,153
2009,35,ID,48,14,34
2009,35,IL,378,43,335
2009,35,IN,280,36,244
2009,35,KS,123,11,112
2009,35,KY,212,35,177
2009,35,LA,10153,1147,9006
2009,35,MA,846,85,761
2009,35,MD,1062,236,826
2009,35,ME,131,17,114
2009,35,MI,140,18,122
2009,35,MN,90,17,73
2009,35,MO,237,29,208
2009,35,MS,1451,114,1337
2009,35,MT,28,3,25
2009,35,NC,2929,274,2655
2009,35,ND,56,24,32
2009,35,NE,107,23,84
2009,35,NH,152,7,145
2009,35,NJ,3367,368,2999
2009,35,NM,179,21,158
2009,35,NV,161,22,139
2009,35,NY,3341,447,2894
2009,35,OH,433,29,404
2009,35,OK,180,12,168
2009,35,OR,663,49,614
2009,35,PA,958,108,850
2009,35,PR,270,3,267
2009,35,RI,287,21,266
2009,35,SC,3572,459,3113
2009,35,SD,159,8,151
2009,35,TN,331,35,296
2009,35,TX,16475,1329,15146
2009,35,UT,44,6,38
2009,35,VA,2496,256,2240
2009,35,VI,13,0,13
2009,35,VT,23,2,21
2009,35,WA,519,76,443
2009,35,WI,144,14,130
2009,35,WV,256,18,238
2009,35,WY,31,3,28
2009,36,AK,27,5,22
2009,36,AL,727,73,654
2009,36,AR,147,16,131
2009,36,AZ,290,31,259
2009,36,CA,2008,225,1783
2009,36,CO,246,17,229
2009,36,CT,377,29,348
2009,36,DC,19,3,16
2009,36,DE,429,64,365
2009,36,FL,31570,4146,27424
2009,36,GA,1560,231,1329
2009,36,HI,1242,612,630
2009,36,IA,142,18,124
2009,36,ID,43,5,38
2009,36,IL,321,44,277
2009,36,IN,256,32,224
2009,36,KS,121,15,106
2009,36,KY,230,28,202
2009,36,LA,7658,786,6872
2009,36,MA,634,69,565
2009,36,MD,673,65,608
2009,36,ME,111,16,95
2009,36,MI,146,22,124
2009,36,MN,89,13,76
2009,36,MO,235,30,205
2009,36,MS,1111,108,1003
2009,36,MT,36,3,33
2009,36,NC,2410,237,2173
2009,36,ND,37,14,23
2009,36,NE,58,5,53
2009,36,NH,99,12,87
2009,36,NJ,2857,285,2572
2009,36,NM,171,16,155
2009,36,NV,137,12,125
2009,36,NY,3272,318,2954
2009,36,OH,399,36,363
2009,36,OK,154,12,142
2009,36,OR,258,32,226
2009,36,PA,893,110,783
2009,36,PR,309,2,307
2009,36,RI,251,16,235
2009,36,SC,3068,370,2698
2009,36,SD,63,12,51
2009,36,TN,393,43,350
2009,36,TX,13092,927,12165
2009,36,UT,90,12,78
2009,36,VA,2100,237,1863
2009,36,VI,16,1,15
2009,36,VT,27,4,23
2009,36,WA,480,51,429
2009,36,WI,115,10,105
2009,36,WV,268,26,242
2009,36,WY,25,0,25
2009,37,AK,25,4,21
2009,37,AL,883,77,806
2009,37,AR,131,15,116
2009,37,AZ,358,44,314
2009,37,CA,2457,231,2226
2009,37,CO,243,26,217
2009,37,CT,541,38,503
2009,37,DC,36,2,34
2009,37,DE,362,39,323
2009,37,FL,34926,4998,29928
2009,37,GA,1659,165,1494
2009,37,GU,4,0,4
2009,37,HI,1282,805,477
2009,37,IA,157,23,134
2009,37,ID,64,17,47
2009,37,IL,374,45,329
2009,37,IN,290,28,262
2009,37,KS,163,14,149
2009,37,KY,217,27,190
2009,37,LA,8256,942,7314
2009,37,MA,814,79,735
2009,37,MD,799,77,722
2009,37,ME,138,9,129
2009,37,MI,178,31,147
2009,37,MN,87,15,72
2009,37,MO,224,34,190
2009,37,MS,1190,93,1097
2009,37,MT,30,2,28
2009,37,NC,2478,288,2190
2009,37,ND,45,13,32
2009,37,NE,78,12,66
2009,37,NH,131,8,123
2009,37,NJ,3215,486,2729
2009,37,NM,189,24,165
2009,37,NV,121,12,109
2009,37,NY,3207,167,3040
2009,37,OH,401,49,352
2009,37,OK,179,17,162
2009,37,OR,367,38,329
2009,37,PA,907,82,825
2009,37,PR,480,71,409
2009,37,RI,266,28,238
2009,37,SC,3249,369,2880
2009,37,SD,83,8,75
2009,37,TN,283,21,262
2009,37,TX,14493,989,13504
2009,37,UT,49,1,48
2009,37,VA,2018,247,1771
2009,37,VI,20,0,20
2009,37,VT,39,5,34
2009,37,WA,894,66,828
2009,37,WI,142,13,129
2009,37,WV,243,23,220
2009,37,WY,17,2,15
2009,38,AK,44,8,36
2009,38,AL,908,116,792
2009,38,AR,173,17,156
2009,38,AZ,446,60,386
2009,38,CA,2465,232,2233
2009,38,CO,205,25,180
2009,38,CT,523,39,484
2009,38,DC,23,2,21
2009,38,DE,406,33,373
2009,38,FL,36581,5072,31509
2009,38,GA,1776,278,1498
2009,38,GU,4,1,3
2009,38,HI,1433,759,674
2009,38,IA,310,24,286
2009,38,ID,60,13,47
2009,38,IL,424,36,388
2009,38,IN,283,32,251
2009,38,KS,163,16,147
2009,38,KY,223,30,193
2009,38,LA,8190,905,7285
2009,38,MA,723,71,652
2009,38,MD,951,216,735
2009,38,ME,129,9,120
2009,38,MI,330,23,307
2009,38,MN,120,11,109
2009,38,MO,200,27,173
2009,38,MS,1140,95,1045
2009,38,MT,41,7,34
2009,38,NC,2418,250,2168
2009,38,ND,54,8,46
2009,38,NE,73,14,59
2009,38,NH,154,8,146
2009,38,NJ,3538,770,2768
2009,38,NM,160,19,141
2009,38,NV,198,18,180
2009,38,NY,3707,343,3364
2009,38,OH,449,35,414
2009,38,OK,214,19,195
2009,38,OR,463,39,424
2009,38,PA,922,87,835
2009,38,PR,343,1,342
2009,38,RI,397,71,326
2009,38,SC,3497,367,3130
2009,38,SD,73,9,64
2009,38,TN,337,38,299
2009,38,TX,13634,1061,12573
2009,38,UN,4,4,0
2009,38,UT,49,1,48
2009,38,VA,2135,214,1921
2009,38,VI,20,1,19
2009,38,VT,37,1,36
2009,38,WA,801,67,734
2009,38,WI,154,13,141
2009,38,WV,249,34,215
2009,38,WY,26,5,21
2009,39,AK,51,10,41
2009,39,AL,1107,86,1021
2009,39,AR,186,36,150
2009,39,AZ,398,63,335
2009,39,CA,3192,473,2719
2009,39,CO,216,30,186
2009,39,CT,572,56,516
2009,39,DC,23,3,20
2009,39,DE,428,42,386
2009,39,FL,45851,6391,39460
2009,39,GA,2143,274,1869
2009,39,GU,1,0,1
2009,39,HI,2005,618,1387
2009,39,IA,158,32,126
2009,39,ID,47,8,39
2009,39,IL,451,53,398
2009,39,IN,327,34,293
2009,39,KS,139,24,115
2009,39,KY,293,43,250
2009,39,LA,9825,2022,7803
2009,39,MA,847,113,734
2009,39,MD,1277,102,1175
2009,39,ME,168,27,141
2009,39,MI,176,20,156
2009,39,MN,137,17,120
2009,39,MO,279,38,241
2009,39,MS,1680,597,1083
2009,39,MT,36,3,33
2009,39,NC,3084,344,2740
2009,39,ND,50,19,31
2009,39,NE,92,9,83
2009,39,NH,113,11,102
2009,39,NJ,3689,644,3045
2009,39,NM,163,31,132
2009,39,NV,169,17,152
2009,39,NY,3931,230,3701
2009,39,OH,483,39,444
2009,39,OK,223,20,203
2009,39,OR,362,47,315
2009,39,PA,957,92,865
2009,39,PR,799,11,788
2009,39,RI,244,19,225
2009,39,SC,5025,776,4249
2009,39,SD,56,5,51
2009,39,TN,358,52,306
2009,39,TX,14852,1763,13089
2009,39,UT,181,137,44
2009,39,VA,2907,280,2627
2009,39,VI,18,4,14
2009,39,VT,33,4,29
2009,39,WA,1356,92,1264
2009,39,WI,156,19,137
2009,39,WV,245,24,221
2009,39,WY,20,1,19
2009,40,AK,27,3,24
2009,40,AL,740,76,664
2009,40,AR,130,13,117
2009,40,AZ,307,44,263
2009,40,CA,3020,229,2791
2009,40,CO,151,23,128
2009,40,CT,401,39,362
2009,40,DC,24,1,23
2009,40,DE,388,31,357
2009,40,FL,30778,4186,26592
2009,40,GA,1591,177,1414
2009,40,GU,1,1,0
2009,40,HI,866,626,240
2009,40,IA,117,21,96
2009,40,ID,50,4,46
2009,40,IL,440,39,401
2009,40,IN,258,28,230
2009,40,KS,101,16,85
2009,40,KY,215,38,177
2009,40,LA,6170,738,5432
2009,40,MA,779,67,712
2009,40,MD,902,125,777
2009,40,ME,129,18,111
2009,40,MI,133,23,110
2009,40,MN,109,15,94
2009,40,MO,217,27,190
2009,40,MS,960,95,865
2009,40,MT,22,3,19
2009,40,NC,2304,274,2030
2009,40,ND,46,16,30
2009,40,NE,71,16,55
2009,40,NH,85,9,76
2009,40,NJ,2456,337,2119
2009,40,NM,138,17,121
2009,40,NV,152,18,134
2009,40,NY,3567,191,3376
2009,40,OH,389,48,341
2009,40,OK,221,29,192
2009,40,OR,363,46,317
2009,40,PA,977,99,878
2009,40,PR,162,10,152
2009,40,RI,201,26,175
2009,40,SC,2878,406,2472
2009,40,SD,45,10,35
2009,40,TN,274,34,240
2009,40,TX,11237,865,10372
2009,40,UN,1,0,1
2009,40,UT,54,4,50
2009,40,VA,2008,223,1785
2009,40,VI,12,0,12
2009,40,VT,31,5,26
2009,40,WA,1244,77,1167
2009,40,WI,313,13,300
2009,40,WV,264,21,243
2009,40,WY,29,3,26
2009,41,AK,27,2,25
2009,41,AL,591,58,533
2009,41,AR,163,18,145
2009,41,AZ,383,63,320
2009,41,CA,3746,392,3354
2009,41,CO,183,28,155
2009,41,CT,497,32,465
2009,41,DC,16,0,16
2009,41,DE,400,42,358
2009,41,FL,31143,4770,26373
2009,41,GA,1488,206,1282
2009,41,GU,1,0,1
2009,41,HI,259,70,189
2009,41,IA,130,23,107
2009,41,ID,82,8,74
2009,41,IL,438,53,385
2009,41,IN,277,30,247
2009,41,KS,129,22,107
2009,41,KY,202,31,171
2009,41,LA,6776,791,5985
2009,41,MA,929,180,749
2009,41,MD,888,78,810
2009,41,ME,197,9,188
2009,41,MI,161,18,143
2009,41,MN,114,11,103
2009,41,MO,262,65,197
2009,41,MS,955,141,814
2009,41,MT,25,3,22
2009,41,NC,2304,301,2003
2009,41,ND,78,39,39
2009,41,NE,62,6,56
2009,41,NH,85,6,79
2009,41,NJ,2834,371,2463
2009,41,NM,137,18,119
2009,41,NV,166,16,150
2009,41,NY,2699,235,2464
2009,41,OH,387,33,354
2009,41,OK,195,22,173
2009,41,OR,458,37,421
2009,41,PA,905,82,823
2009,41,PR,360,3,357
2009,41,RI,243,18,225
2009,41,SC,2747,279,2468
2009,41,SD,30,7,23
2009,41,TN,328,23,305
2009,41,TX,10706,1052,9654
2009,41,UT,49,6,43
2009,41,VA,2145,256,1889
2009,41,VI,14,1,13
2009,41,VT,29,3,26
2009,41,WA,2203,116,2087
2009,41,WI,144,21,123
2009,41,WV,208,16,192
2009,41,WY,21,2,19
2009,42,AK,29,6,23
2009,42,AL,590,65,525
2009,42,AR,192,30,162
2009,42,AZ,531,96,435
2009,42,CA,4252,412,3840
2009,42,CO,194,29,165
2009,42,CT,427,33,394
2009,42,DC,25,1,24
2009,42,DE,338,29,309
2009,42,FL,30105,4609,25496
2009,42,GA,2642,237,2405
2009,42,GU,4,1,3
2009,42,HI,591,175,416
2009,42,IA,197,28,169
2009,42,ID,76,6,70
2009,42,IL,444,53,391
2009,42,IN,321,37,284
2009,42,KS,147,16,131
2009,42,KY,224,22,202
2009,42,LA,6621,923,5698
2009,42,MA,696,91,605
2009,42,MD,811,87,724
2009,42,ME,122,16,106
2009,42,MI,184,24,160
2009,42,MN,95,15,80
2009,42,MO,223,34,189
2009,42,MS,989,80,909
2009,42,MT,29,5,24
2009,42,NC,1982,291,1691
2009,42,ND,40,20,20
2009,42,NE,84,11,73
2009,42,NH,71,12,59
2009,42,NJ,2858,371,2487
2009,42,NM,139,30,109
2009,42,NV,467,12,455
2009,42,NY,2586,185,2401
2009,42,OH,409,42,367
2009,42,OK,231,18,213
2009,42,OR,434,43,391
2009,42,PA,948,180,768
2009,42,PR,293,4,289
2009,42,RI,191,20,171
2009,42,SC,2689,355,2334
2009,42,SD,51,7,44
2009,42,TN,351,45,306
2009,42,TX,12147,978,11169
2009,42,UT,51,8,43
2009,42,VA,2207,255,1952
2009,42,VI,11,1,10
2009,42,VT,40,5,35
2009,42,WA,2235,140,2095
2009,42,WI,139,34,105
2009,42,WV,216,17,199
2009,42,WY,20,2,18
2009,43,AK,28,4,24
2009,43,AL,782,75,707
2009,43,AR,156,23,133
2009,43,AZ,656,62,594
2009,43,CA,4638,311,4327
2009,43,CO,193,23,170
2009,43,CT,542,51,491
2009,43,DC,19,1,18
2009,43,DE,531,47,484
2009,43,FL,35860,4884,30976
2009,43,GA,2490,256,2234
2009,43,HI,1553,672,881
2009,43,IA,134,22,112
2009,43,ID,64,10,54
2009,43,IL,472,55,417
2009,43,IN,318,32,286
2009,43,KS,133,17,116
2009,43,KY,251,32,219
2009,43,LA,7895,1017,6878
2009,43,MA,781,182,599
2009,43,MD,885,81,804
2009,43,ME,119,15,104
2009,43,MI,257,25,232
2009,43,MN,110,26,84
2009,43,MO,266,27,239
2009,43,MS,1051,114,937
2009,43,MT,44,3,41
2009,43,NC,2193,315,1878
2009,43,ND,42,19,23
2009,43,NE,78,13,65
2009,43,NH,81,7,74
2009,43,NJ,3037,617,2420
2009,43,NM,135,23,112
2009,43,NV,167,19,148
2009,43,NY,2373,241,2132
2009,43,OH,426,50,376
2009,43,OK,249,21,228
2009,43,OR,451,47,404
2009,43,PA,1018,117,901
2009,43,PR,159,4,155
2009,43,RI,233,18,215
2009,43,SC,3269,513,2756
2009,43,SD,60,9,51
2009,43,TN,364,48,316
2009,43,TX,12964,1146,11818
2009,43,UT,45,1,44
2009,43,VA,1946,290,1656
2009,43,VI,19,1,18
2009,43,VT,36,2,34
2009,43,WA,2676,131,2545
2009,43,WI,156,29,127
2009,43,WV,201,26,175
2009,43,WY,34,8,26
2009,44,AK,25,8,17
2009,44,AL,804,62,742
2009,44,AR,144,22,122
2009,44,AZ,326,57,269
2009,44,CA,4883,433,4450
2009,44,CO,176,23,153
2009,44,CT,446,117,329
2009,44,DC,19,1,18
2009,44,DE,316,33,283
2009,44,FL,29292,4636,24656
2009,44,GA,2224,540,1684
2009,44,HI,1063,36,1027
2009,44,IA,122,17,105
2009,44,ID,76,27,49
2009,44,IL,427,69,358
2009,44,IN,328,41,287
2009,44,KS,120,27,93
2009,44,KY,231,50,181
2009,44,LA,6183,1242,4941
2009,44,MA,656,88,568
2009,44,MD,689,79,610
2009,44,ME,114,17,97
2009,44,MI,142,25,117
2009,44,MN,103,18,85
2009,44,MO,241,35,206
2009,44,MS,947,114,833
2009,44,MT,40,7,33
2009,44,NC,1797,262,1535
2009,44,ND,79,23,56
2009,44,NE,61,9,52
2009,44,NH,137,7,130
2009,44,NJ,2839,587,2252
2009,44,NM,226,130,96
2009,44,NV,193,12,181
2009,44,NY,2544,279,2265
2009,44,OH,341,43,298
2009,44,OK,208,17,191
2009,44,OR,506,63,443
2009,44,PA,1038,299,739
2009,44,PR,407,55,352
2009,44,RI,179,23,156
2009,44,SC,2454,337,2117
2009,44,SD,39,9,30
2009,44,TN,296,30,266
2009,44,TX,9668,897,8771
2009,44,UT,44,2,42
2009,44,VA,1459,220,1239
2009,44,VI,11,1,10
2009,44,VT,36,6,30
2009,44,WA,2410,125,2285
2009,44,WI,127,21,106
2009,44,WV,234,29,205
2009,44,WY,28,6,22
2009,45,AK,18,3,15
2009,45,AL,736,65,671
2009,45,AR,226,26,200
2009,45,AZ,270,50,220
2009,45,CA,5935,327,5608
2009,45,CO,199,29,170
2009,45,CT,438,37,401
2009,45,DC,17,0,17
2009,45,DE,260,31,229
2009,45,FL,24313,4677,19636
2009,45,GA,1637,223,1414
2009,45,GU,1,0,1
2009,45,HI,738,404,334
2009,45,IA,103,19,84
2009,45,ID,77,10,67
2009,45,IL,340,42,298
2009,45,IN,261,41,220
2009,45,KS,116,12,104
2009,45,KY,206,26,180
2009,45,LA,5154,824,4330
2009,45,MA,568,107,461
2009,45,MD,857,283,574
2009,45,ME,134,21,113
2009,45,MI,216,95,121
2009,45,MN,83,15,68
2009,45,MO,261,35,226
2009,45,MS,1003,90,913
2009,45,MT,25,0,25
2009,45,NC,1980,416,1564
2009,45,ND,34,5,29
2009,45,NE,58,14,44
2009,45,NH,85,15,70
2009,45,NJ,3057,716,2341
2009,45,NM,96,21,75
2009,45,NV,153,24,129
2009,45,NY,2180,230,1950
2009,45,OH,357,45,312
2009,45,OK,162,21,141
2009,45,OR,456,41,415
2009,45,PA,811,101,710
2009,45,PR,145,1,144
2009,45,RI,158,16,142
2009,45,SC,2242,306,1936
2009,45,SD,42,9,33
2009,45,TN,271,34,237
2009,45,TX,7945,910,7035
2009,45,UT,52,20,32
2009,45,VA,1517,259,1258
2009,45,VI,11,0,11
2009,45,VT,30,1,29
2009,45,WA,2212,126,2086
2009,45,WI,109,18,91
2009,45,WV,188,16,172
2009,45,WY,20,3,17
2009,46,AK,26,7,19
2009,46,AL,504,82,422
2009,46,AR,156,26,130
2009,46,AZ,316,42,274
2009,46,CA,5316,671,4645
2009,46,CO,238,29,209
2009,46,CT,429,53,376
2009,46,DC,17,2,15
2009,46,DE,302,30,272
2009,46,FL,27204,3941,23263
2009,46,GA,1537,241,1296
2009,46,GU,1,0,1
2009,46,HI,1099,775,324
2009,46,IA,100,19,81
2009,46,ID,47,9,38
2009,46,IL,438,61,377
2009,46,IN,279,36,243
2009,46,KS,123,18,105
2009,46,KY,220,28,192
2009,46,LA,6084,894,5190
2009,46,MA,655,121,534
2009,46,MD,977,170,807
2009,46,ME,134,10,124
2009,46,MI,148,23,125
2009,46,MN,79,12,67
2009,46,MO,286,42,244
2009,46,MS,1189,92,1097
2009,46,MT,29,5,24
2009,46,NC,1981,367,1614
2009,46,ND,41,18,23
2009,46,NE,66,6,60
2009,46,NH,66,16,50
2009,46,NJ,3129,633,2496
2009,46,NM,129,26,103
2009,46,NV,169,23,146
2009,46,NY,2205,268,1937
2009,46,OH,413,52,361
2009,46,OK,186,28,158
2009,46,OR,525,63,462
2009,46,PA,832,100,732
2009,46,PR,941,8,933
2009,46,RI,175,22,153
2009,46,SC,2694,360,2334
2009,46,SD,32,6,26
2009,46,TN,288,34,254
2009,46,TX,8966,1031,7935
2009,46,UT,54,8,46
2009,46,VA,1732,399,1333
2009,46,VI,19,0,19
2009,46,VT,46,6,40
2009,46,WA,2084,142,1942
2009,46,WI,131,20,111
2009,46,WV,231,28,203
2009,46,WY,23,5,18
2009,47,AK,32,6,26
2009,47,AL,435,75,360
2009,47,AR,136,20,116
2009,47,AZ,283,44,239
2009,47,CA,4212,355,3857
2009,47,CO,116,16,100
2009,47,CT,641,96,545
2009,47,DC,12,0,12
2009,47,DE,308,83,225
2009,47,FL,22311,3930,18381
2009,47,GA,1119,182,937
2009,47,HI,1074,69,1005
2009,47,IA,98,16,82
2009,47,ID,54,11,43
2009,47,IL,326,45,281
2009,47,IN,197,32,165
2009,47,KS,89,10,79
2009,47,KY,226,39,187
2009,47,LA,5317,841,4476
2009,47,MA,573,77,496
2009,47,MD,765,84,681
2009,47,ME,108,11,97
2009,47,MI,140,23,117
2009,47,MN,77,17,60
2009,47,MO,191,37,154
2009,47,MS,823,106,717
2009,47,MT,26,10,16
2009,47,NC,1451,248,1203
2009,47,ND,43,19,24
2009,47,NE,63,16,47
2009,47,NH,87,7,80
2009,47,NJ,2696,920,1776
2009,47,NM,81,17,64
2009,47,NV,145,13,132
2009,47,NY,2159,211,1948
2009,47,OH,504,35,469
2009,47,OK,143,20,123
2009,47,OR,521,75,446
2009,47,PA,730,107,623
2009,47,PR,179,4,175
2009,47,RI,208,33,175
2009,47,SC,1883,343,1540
2009,47,SD,30,11,19
2009,47,TN,232,33,199
2009,47,TX,7049,731,6318
2009,47,UT,43,2,41
2009,47,VA,1505,380,1125
2009,47,VI,8,1,7
2009,47,VT,48,7,41
2009,47,WA,1577,123,1454
2009,47,WI,105,17,88
2009,47,WV,205,26,179
2009,47,WY,17,2,15
2009,48,AK,32,6,26
2009,48,AL,728,95,633
2009,48,AR,172,36,136
2009,48,AZ,311,52,259
2009,48,CA,6310,789,5521
2009,48,CO,150,29,121
2009,48,CT,727,67,660
2009,48,DC,20,3,17
2009,48,DE,363,116,247
2009,48,FL,30792,6779,24013
2009,48,GA,1332,268,1064
2009,48,GU,2,0,2
2009,48,HI,1155,416,739
2009,48,IA,102,28,74
2009,48,ID,60,9,51
2009,48,IL,431,84,347
2009,48,IN,287,51,236
2009,48,KS,94,26,68
2009,48,KY,198,43,155
2009,48,LA,7156,2219,4937
2009,48,MA,631,99,532
2009,48,MD,654,120,534
2009,48,ME,116,18,98
2009,48,MI,309,23,286
2009,48,MN,93,14,79
2009,48,MO,227,49,178
2009,48,MS,1111,152,959
2009,48,MT,32,7,25
2009,48,NC,1686,304,1382
2009,48,ND,41,19,22
2009,48,NE,74,15,59
2009,48,NH,180,12,168
2009,48,NJ,2838,918,1920
2009,48,NM,123,43,80
2009,48,NV,132,19,113
2009,48,NY,2189,415,1774
2009,48,OH,388,58,330
2009,48,OK,141,34,107
2009,48,OR,461,62,399
2009,48,PA,858,136,722
2009,48,PR,146,31,115
2009,48,RI,263,130,133
2009,48,SC,2808,650,2158
2009,48,SD,58,14,44
2009,48,TN,287,56,231
2009,48,TX,7762,946,6816
2009,48,UT,49,3,46
2009,48,VA,1504,265,1239
2009,48,VI,84,37,47
2009,48,VT,26,2,24
2009,48,WA,1341,139,1202
2009,48,WI,109,24,85
2009,48,WV,201,32,169
2009,48,WY,14,1,13
2009,49,AK,23,6,17
2009,49,AL,1691,76,1615
2009,49,AR,124,39,85
2009,49,AZ,230,32,198
2009,49,CA,4918,453,4465
2009,49,CO,149,41,108
2009,49,CT,312,53,259
2009,49,DC,12,2,10
2009,49,DE,268,44,224
2009,49,FL,22547,4488,18059
2009,49,GA,1156,202,954
2009,49,HI,551,159,392
2009,49,IA,80,20,60
2009,49,ID,61,7,54
2009,49,IL,366,71,295
2009,49,IN,176,33,143
2009,49,KS,97,18,79
2009,49,KY,197,30,167
2009,49,LA,4900,872,4028
2009,49,MA,408,52,356
2009,49,MD,814,180,634
2009,49,ME,97,13,84
2009,49,MI,166,37,129
2009,49,MN,66,15,51
2009,49,MO,182,41,141
2009,49,MS,878,164,714
2009,49,MT,37,9,28
2009,49,NC,1452,287,1165
2009,49,ND,59,31,28
2009,49,NE,54,4,50
2009,49,NH,80,13,67
2009,49,NJ,2437,506,1931
2009,49,NM,92,22,70
2009,49,NV,140,23,117
2009,49,NY,2013,339,1674
2009,49,OH,310,41,269
2009,49,OK,122,31,91
2009,49,OR,442,42,400
2009,49,PA,708,110,598
2009,49,PR,150,4,146
2009,49,RI,189,20,169
2009,49,SC,1822,374,1448
2009,49,SD,52,10,42
2009,49,TN,245,31,214
2009,49,TX,6147,788,5359
2009,49,UT,35,2,33
2009,49,VA,1255,324,931
2009,49,VI,6,2,4
2009,49,VT,25,6,19
2009,49,WA,1177,143,1034
2009,49,WI,87,16,71
2009,49,WV,168,26,142
2009,49,WY,13,2,11
2009,50,AK,30,9,21
2009,50,AL,746,276,470
2009,50,AR,138,32,106
2009,50,AZ,278,47,231
2009,50,CA,5573,794,4779
2009,50,CO,165,19,146
2009,50,CT,448,44,404
2009,50,DC,17,0,17
2009,50,DE,303,45,258
2009,50,FL,27816,5130,22686
2009,50,GA,1271,230,1041
2009,50,GU,2,0,2
2009,50,HI,972,283,689
2009,50,IA,95,17,78
2009,50,ID,57,15,42
2009,50,IL,341,45,296
2009,50,IN,220,37,183
2009,50,KS,96,23,73
2009,50,KY,223,68,155
2009,50,LA,6341,1746,4595
2009,50,MA,704,167,537
2009,50,MD,668,124,544
2009,50,ME,108,12,96
2009,50,MI,172,39,133
2009,50,MN,75,16,59
2009,50,MO,183,27,156
2009,50,MS,846,109,737
2009,50,MT,28,3,25
2009,50,NC,1700,324,1376
2009,50,ND,47,13,34
2009,50,NE,80,16,64
2009,50,NH,145,67,78
2009,50,NJ,3258,1075,2183
2009,50,NM,110,32,78
2009,50,NV,183,22,161
2009,50,NY,2000,262,1738
2009,50,OH,503,69,434
2009,50,OK,140,21,119
2009,50,OR,551,65,486
2009,50,PA,794,122,672
2009,50,PR,284,2,282
2009,50,RI,124,20,104
2009,50,SC,2559,596,1963
2009,50,SD,42,9,33
2009,50,TN,248,40,208
2009,50,TX,7003,1003,6000
2009,50,UT,36,6,30
2009,50,VA,1459,362,1097
2009,50,VI,16,0,16
2009,50,VT,31,7,24
2009,50,WA,927,105,822
2009,50,WI,95,22,73
2009,50,WV,176,26,150
2009,50,WY,24,3,21
2009,51,AK,30,7,23
2009,51,AL,446,71,375
2009,51,AR,111,43,68
2009,51,AZ,223,59,164
2009,51,CA,3811,464,3347
2009,51,CO,226,41,185
2009,51,CT,243,41,202
2009,51,DC,30,18,12
2009,51,DE,196,38,158
2009,51,FL,19910,3886,16024
2009,51,GA,890,273,617
2009,51,HI,976,36,940
2009,51,IA,88,27,61
2009,51,ID,41,8,33
2009,51,IL,294,65,229
2009,51,IN,181,36,145
2009,51,KS,71,18,53
2009,51,KY,228,45,183
2009,51,LA,3856,770,3086
2009,51,MA,474,74,400
2009,51,MD,564,152,412
2009,51,ME,81,9,72
2009,51,MI,139,39,100
2009,51,MN,57,12,45
2009,51,MO,163,30,133
2009,51,MS,679,101,578
2009,51,MT,17,2,15
2009,51,NC,1199,266,933
2009,51,ND,36,9,27
2009,51,NE,71,15,56
2009,51,NH,58,14,44
2009,51,NJ,2065,701,1364
2009,51,NM,88,33,55
2009,51,NV,111,19,92
2009,51,NY,1552,233,1319
2009,51,OH,256,37,219
2009,51,OK,91,20,71
2009,51,OR,376,62,314
2009,51,PA,580,92,488
2009,51,PR,165,11,154
2009,51,RI,103,23,80
2009,51,SC,1629,405,1224
2009,51,SD,27,7,20
2009,51,TN,335,138,197
2009,51,TX,5505,959,4546
2009,51,UN,1,0,1
2009,51,UT,35,11,24
2009,51,VA,1073,339,734
2009,51,VI,34,1,33
2009,51,VT,29,4,25
2009,51,WA,861,200,661
2009,51,WI,80,21,59
2009,51,WV,149,21,128
2009,51,WY,16,5,11
2009,52,AK,17,5,12
2009,52,AL,453,128,325
2009,52,AR,90,17,73
2009,52,AZ,197,41,156
2009,52,CA,3264,565,2699
2009,52,CO,151,26,125
2009,52,CT,241,30,211
2009,52,DC,10,3,7
2009,52,DE,172,40,132
2009,52,FL,22988,5404,17584
2009,52,GA,766,162,604
2009,52,HI,140,25,115
2009,52,IA,53,15,38
2009,52,ID,44,7,37
2009,52,IL,198,36,162
2009,52,IN,152,31,121
2009,52,KS,48,14,34
2009,52,KY,119,26,93
2009,52,LA,4374,1019,3355
2009,52,MA,368,49,319
2009,52,MD,808,88,720
2009,52,ME,71,10,61
2009,52,MI,106,23,83
2009,52,MN,46,13,33
2009,52,MO,131,22,109
2009,52,MS,682,129,553
2009,52,MT,18,4,14
2009,52,NC,1122,290,832
2009,52,ND,45,9,36
2009,52,NE,122,22,100
2009,52,NH,45,5,40
2009,52,NJ,1472,346,1126
2009,52,NM,70,17,53
2009,52,NV,82,14,68
2009,52,NY,1172,191,981
2009,52,OH,211,50,161
2009,52,OK,87,14,73
2009,52,OR,285,38,247
2009,52,PA,454,74,380
2009,52,PR,195,20,175
2009,52,RI,96,14,82
2009,52,SC,2207,565,1642
2009,52,SD,42,15,27
2009,52,TN,164,24,140
2009,52,TX,4697,724,3973
2009,52,UT,34,3,31
2009,52,VA,1020,357,663
2009,52,VI,8,2,6
2009,52,VT,16,5,11
2009,52,WA,453,107,346
2009,52,WI,78,13,65
2009,52,WV,126,25,101
2009,52,WY,21,3,18
2010,0,AK,5,6,-1
2010,0,AL,131,125,6
2010,0,AR,23,26,-3
2010,0,AZ,84,86,-2
2010,0,CA,1787,1919,-132
2010,0,CO,45,46,-1
2010,0,CT,82,81,1
2010,0,DC,2,2,0
2010,0,DE,157,60,97
2010,0,FL,13315,13084,231
2010,0,GA,355,290,65
2010,0,HI,101,103,-2
2010,0,IA,22,22,0
2010,0,ID,15,16,-1
2010,0,IL,97,94,3
2010,0,IN,61,58,3
2010,0,KS,17,18,-1
2010,0,KY,59,63,-4
2010,0,LA,3301,3285,16
2010,0,MA,139,133,6
2010,0,MD,161,150,11
2010,0,ME,24,24,0
2010,0,MI,42,36,6
2010,0,MN,21,23,-2
2010,0,MO,49,47,2
2010,0,MS,397,402,-5
2010,0,MT,9,9,0
2010,0,NC,582,573,9
2010,0,ND,13,9,4
2010,0,NE,27,25,2
2010,0,NH,16,13,3
2010,0,NJ,757,770,-13
2010,0,NM,16,17,-1
2010,0,NV,34,34,0
2010,0,NY,610,602,8
2010,0,OH,87,88,-1
2010,0,OK,29,31,-2
2010,0,OR,136,140,-4
2010,0,PA,170,171,-1
2010,0,PR,59,85,-26
2010,0,RI,24,26,-2
2010,0,SC,848,829,19
2010,0,SD,21,20,1
2010,0,TN,77,72,5
2010,0,TX,2020,1905,115
2010,0,UT,14,16,-2
2010,0,VA,579,575,4
2010,0,VI,2,2,0
2010,0,VT,7,5,2
2010,0,WA,188,166,22
2010,0,WI,96,22,74
2010,0,WV,83,83,0
2010,0,WY,2,9,-7
2010,1,AK,16,16,0
2010,1,AL,467,439,28
2010,1,AR,104,88,16
2010,1,AZ,214,224,-10
2010,1,CA,5410,5715,-305
2010,1,CO,182,130,52
2010,1,CT,442,436,6
2010,1,DC,15,16,-1
2010,1,DE,588,595,-7
2010,1,FL,22383,21821,562
2010,1,GA,902,781,121
2010,1,GU,1,1,0
2010,1,HI,532,526,6
2010,1,IA,97,92,5
2010,1,ID,62,59,3
2010,1,IL,571,559,12
2010,1,IN,187,151,36
2010,1,KS,87,83,4
2010,1,KY,157,165,-8
2010,1,LA,4249,4248,1
2010,1,MA,469,448,21
2010,1,MD,612,600,12
2010,1,ME,100,97,3
2010,1,MI,175,131,44
2010,1,MN,63,63,0
2010,1,MO,195,182,13
2010,1,MS,857,869,-12
2010,1,MT,24,27,-3
2010,1,NC,1409,1395,14
2010,1,ND,26,25,1
2010,1,NE,46,48,-2
2010,1,NH,54,54,0
2010,1,NJ,2196,2175,21
2010,1,NM,80,78,2
2010,1,NV,144,152,-8
2010,1,NY,1654,1761,-107
2010,1,OH,294,279,15
2010,1,OK,101,90,11
2010,1,OR,494,506,-12
2010,1,PA,609,623,-14
2010,1,PR,122,128,-6
2010,1,RI,123,119,4
2010,1,SC,1561,1557,4
2010,1,SD,53,48,5
2010,1,TN,236,224,12
2010,1,TX,5475,5519,-44
2010,1,UT,39,54,-15
2010,1,VA,1027,922,105
2010,1,VI,11,12,-1
2010,1,VT,40,39,1
2010,1,WA,759,579,180
2010,1,WI,101,104,-3
2010,1,WV,171,166,5
2010,1,WY,20,22,-2
2010,2,AK,41,34,7
2010,2,AL,413,395,18
2010,2,AR,99,95,4
2010,2,AZ,238,246,-8
2010,2,CA,4023,3797,226
2010,2,CO,143,183,-40
2010,2,CT,359,367,-8
2010,2,DC,16,11,5
2010,2,DE,239,232,7
2010,2,FL,24537,24851,-314
2010,2,GA,1008,893,115
2010,2,GU,2,2,0
2010,2,HI,1124,1132,-8
2010,2,IA,82,84,-2
2010,2,ID,48,55,-7
2010,2,IL,395,374,21
2010,2,IN,196,185,11
2010,2,KS,71,70,1
2010,2,KY,171,177,-6
2010,2,LA,4897,4865,32
2010,2,MA,450,414,36
2010,2,MD,605,602,3
2010,2,ME,118,104,14
2010,2,MI,185,155,30
2010,2,MN,96,80,16
2010,2,MO,180,162,18
2010,2,MS,877,838,39
2010,2,MT,38,34,4
2010,2,NC,1424,1413,11
2010,2,ND,31,27,4
2010,2,NE,72,73,-1
2010,2,NH,101,103,-2
2010,2,NJ,2173,2230,-57
2010,2,NM,90,86,4
2010,2,NV,151,135,16
2010,2,NY,1965,2121,-156
2010,2,OH,405,404,1
2010,2,OK,115,121,-6
2010,2,OR,422,413,9
2010,2,PA,728,731,-3
2010,2,PR,99,110,-11
2010,2,RI,351,319,32
2010,2,SC,2135,2095,40
2010,2,SD,55,44,11
2010,2,TN,238,215,23
2010,2,TX,5443,5409,34
2010,2,UT,34,32,2
2010,2,VA,956,910,46
2010,2,VI,8,8,0
2010,2,VT,26,27,-1
2010,2,WA,861,802,59
2010,2,WI,119,105,14
2010,2,WV,165,166,-1
2010,2,WY,18,17,1
2010,3,AK,38,36,2
2010,3,AL,420,389,31
2010,3,AR,108,96,12
2010,3,AZ,233,228,5
2010,3,CA,3757,3961,-204
2010,3,CO,272,302,-30
2010,3,CT,325,306,19
2010,3,DC,10,7,3
2010,3,DE,348,374,-26
2010,3,FL,22651,22180,471
2010,3,GA,872,786,86
2010,3,GU,2,2,0
2010,3,HI,886,889,-3
2010,3,IA,78,78,0
2010,3,ID,59,53,6
2010,3,IL,278,247,31
2010,3,IN,172,166,6
2010,3,KS,74,66,8
2010,3,KY,147,292,-145
2010,3,LA,4306,4403,-97
2010,3,MA,450,430,20
2010,3,MD,974,775,199
2010,3,ME,71,62,9
2010,3,MI,167,162,5
2010,3,MN,58,46,12
2010,3,MO,196,140,56
2010,3,MS,766,796,-30
2010,3,MT,26,25,1
2010,3,NC,1694,1698,-4
2010,3,ND,35,32,3
2010,3,NE,55,54,1
2010,3,NH,67,57,10
2010,3,NJ,1832,1847,-15
2010,3,NM,68,67,1
2010,3,NV,145,125,20
2010,3,NY,1765,2240,-475
2010,3,OH,230,230,0
2010,3,OK,91,90,1
2010,3,OR,362,388,-26
2010,3,PA,721,704,17
2010,3,PR,128,130,-2
2010,3,RI,107,106,1
2010,3,SC,1819,1797,22
2010,3,SD,37,32,5
2010,3,TN,203,182,21
2010,3,TX,5241,5196,45
2010,3,UT,45,42,3
2010,3,VA,1070,844,226
2010,3,VI,24,22,2
2010,3,VT,26,27,-1
2010,3,WA,554,546,8
2010,3,WI,82,77,5
2010,3,WV,142,150,-8
2010,3,WY,9,11,-2
2010,4,AK,17,16,1
2010,4,AL,384,357,27
2010,4,AR,226,199,27
2010,4,AZ,252,251,1
2010,4,CA,3707,3729,-22
2010,4,CO,146,162,-16
2010,4,CT,450,464,-14
2010,4,DC,12,13,-1
2010,4,DE,237,230,7
2010,4,FL,24259,24704,-445
2010,4,GA,913,831,82
2010,4,HI,706,691,15
2010,4,IA,102,103,-1
2010,4,ID,56,67,-11
2010,4,IL,427,410,17
2010,4,IN,176,179,-3
2010,4,KS,97,95,2
2010,4,KY,160,175,-15
2010,4,LA,5312,5479,-167
2010,4,MA,443,416,27
2010,4,MD,640,615,25
2010,4,ME,76,75,1
2010,4,MI,150,142,8
2010,4,MN,69,78,-9
2010,4,MO,191,192,-1
2010,4,MS,809,799,10
2010,4,MT,31,34,-3
2010,4,NC,1304,1297,7
2010,4,ND,49,44,5
2010,4,NE,73,79,-6
2010,4,NH,57,61,-4
2010,4,NJ,2108,2108,0
2010,4,NM,79,82,-3
2010,4,NV,157,165,-8
2010,4,NY,1637,1804,-167
2010,4,OH,255,261,-6
2010,4,OK,106,94,12
2010,4,OR,433,441,-8
2010,4,PA,734,779,-45
2010,4,PR,492,502,-10
2010,4,RI,94,99,-5
2010,4,SC,1925,1893,32
2010,4,SD,35,30,5
2010,4,TN,217,223,-6
2010,4,TX,5400,5728,-328
2010,4,UT,38,38,0
2010,4,VA,1011,953,58
2010,4,VI,10,10,0
2010,4,VT,26,28,-2
2010,4,WA,506,440,66
2010,4,WI,82,88,-6
2010,4,WV,157,157,0
2010,4,WY,18,19,-1
2010,5,AK,16,16,0
2010,5,AL,766,761,5
2010,5,AR,196,158,38
2010,5,AZ,221,245,-24
2010,5,CA,4247,4358,-111
2010,5,CO,143,134,9
2010,5,CT,300,319,-19
2010,5,DC,5,5,0
2010,5,DE,180,168,12
2010,5,FL,26294,26361,-67
2010,5,GA,997,918,79
2010,5,HI,1461,1494,-33
2010,5,IA,120,117,3
2010,5,ID,92,95,-3
2010,5,IL,369,359,10
2010,5,IN,227,221,6
2010,5,KS,108,104,4
2010,5,KY,193,201,-8
2010,5,LA,5126,5136,-10
2010,5,MA,489,443,46
2010,5,MD,712,694,18
2010,5,ME,87,84,3
2010,5,MI,162,170,-8
2010,5,MN,98,85,13
2010,5,MO,216,214,2
2010,5,MS,1034,1081,-47
2010,5,MT,50,47,3
2010,5,NC,1358,1366,-8
2010,5,ND,64,60,4
2010,5,NE,86,68,18
2010,5,NH,63,61,2
2010,5,NJ,2608,2565,43
2010,5,NM,100,92,8
2010,5,NV,164,174,-10
2010,5,NY,1700,1557,143
2010,5,OH,315,315,0
2010,5,OK,108,114,-6
2010,5,OR,412,437,-25
2010,5,PA,974,1001,-27
2010,5,PR,90,101,-11
2010,5,RI,99,95,4
2010,5,SC,1835,1740,95
2010,5,SD,56,44,12
2010,5,TN,234,247,-13
2010,5,TX,5627,5767,-140
2010,5,UT,31,38,-7
2010,5,VA,921,856,65
2010,5,VI,10,11,-1
2010,5,VT,26,29,-3
2010,5,WA,563,602,-39
2010,5,WI,104,102,2
2010,5,WV,225,224,1
2010,5,WY,9,10,-1
2010,6,AK,21,22,-1
2010,6,AL,1044,1056,-12
2010,6,AR,116,112,4
2010,6,AZ,278,271,7
2010,6,CA,4602,4486,116
2010,6,CO,131,139,-8
2010,6,CT,395,402,-7
2010,6,DC,11,12,-1
2010,6,DE,226,227,-1
2010,6,FL,22913,23239,-326
2010,6,GA,969,898,71
2010,6,HI,642,645,-3
2010,6,IA,133,105,28
2010,6,ID,118,120,-2
2010,6,IL,428,413,15
2010,6,IN,268,269,-1
2010,6,KS,90,79,11
2010,6,KY,211,217,-6
2010,6,LA,5257,5254,3
2010,6,MA,610,608,2
2010,6,MD,482,476,6
2010,6,ME,115,121,-6
2010,6,MI,149,157,-8
2010,6,MN,124,116,8
2010,6,MO,147,162,-15
2010,6,MS,966,981,-15
2010,6,MT,48,41,7
2010,6,NC,1687,1651,36
2010,6,ND,125,124,1
2010,6,NE,116,61,55
2010,6,NH,77,75,2
2010,6,NJ,2046,2050,-4
2010,6,NM,89,85,4
2010,6,NV,239,260,-21
2010,6,NY,1588,1531,57
2010,6,OH,404,414,-10
2010,6,OK,141,130,11
2010,6,OR,460,473,-13
2010,6,PA,878,905,-27
2010,6,PR,107,121,-14
2010,6,RI,120,120,0
2010,6,SC,1865,1832,33
2010,6,SD,39,25,14
2010,6,TN,255,253,2
2010,6,TX,5954,6030,-76
2010,6,UN,1,1,0
2010,6,UT,119,126,-7
2010,6,VA,975,914,61
2010,6,VI,4,5,-1
2010,6,VT,27,29,-2
2010,6,WA,680,721,-41
2010,6,WI,104,109,-5
2010,6,WV,256,252,4
2010,6,WY,31,30,1
2010,7,AK,31,29,2
2010,7,AL,722,709,13
2010,7,AR,191,176,15
2010,7,AZ,277,247,30
2010,7,CA,3948,3418,530
2010,7,CO,161,164,-3
2010,7,CT,345,331,14
2010,7,DC,16,18,-2
2010,7,DE,214,214,0
2010,7,FL,24831,24667,164
2010,7,GA,1019,933,86
2010,7,GU,1,0,1
2010,7,HI,545,554,-9
2010,7,IA,165,145,20
2010,7,ID,96,99,-3
2010,7,IL,734,722,12
2010,7,IN,240,224,16
2010,7,KS,94,81,13
2010,7,KY,229,224,5
2010,7,LA,5654,5634,20
2010,7,MA,407,409,-2
2010,7,MD,551,521,30
2010,7,ME,82,82,0
2010,7,MI,175,187,-12
2010,7,MN,140,121,19
2010,7,MO,193,188,5
2010,7,MS,904,902,2
2010,7,MT,60,50,10
2010,7,NC,1475,1488,-13
2010,7,ND,162,196,-34
2010,7,NE,140,68,72
2010,7,NH,65,69,-4
2010,7,NJ,2033,2018,15
2010,7,NM,96,100,-4
2010,7,NV,244,231,13
2010,7,NY,1595,1493,102
2010,7,OH,415,430,-15
2010,7,OK,123,119,4
2010,7,OR,348,339,9
2010,7,PA,1173,1194,-21
2010,7,PR,88,102,-14
2010,7,RI,93,95,-2
2010,7,SC,2061,2058,3
2010,7,SD,66,41,25
2010,7,TN,249,244,5
2010,7,TX,6049,6098,-49
2010,7,UT,57,59,-2
2010,7,VA,1131,1022,109
2010,7,VI,52,54,-2
2010,7,VT,45,48,-3
2010,7,WA,597,550,47
2010,7,WI,109,121,-12
2010,7,WV,248,247,1
2010,7,WY,21,19,2
2010,8,AK,22,20,2
2010,8,AL,492,471,21
2010,8,AR,136,125,11
2010,8,AZ,295,256,39
2010,8,CA,3759,3653,106
2010,8,CO,157,145,12
2010,8,CT,294,290,4
2010,8,DC,7,11,-4
2010,8,DE,237,234,3
2010,8,FL,25736,26082,-346
2010,8,GA,1121,1031,90
2010,8,HI,1478,1474,4
2010,8,IA,235,213,22
2010,8,ID,82,85,-3
2010,8,IL,446,427,19
2010,8,IN,268,272,-4
2010,8,KS,107,101,6
2010,8,KY,236,221,15
2010,8,LA,6843,6738,105
2010,8,MA,444,424,20
2010,8,MD,559,499,60
2010,8,ME,85,83,2
2010,8,MI,200,226,-26
2010,8,MN,168,162,6
2010,8,MO,230,218,12
2010,8,MS,1232,1193,39
2010,8,MT,75,49,26
2010,8,NC,1841,1821,20
2010,8,ND,287,320,-33
2010,8,NE,122,92,30
2010,8,NH,87,90,-3
2010,8,NJ,2010,1972,38
2010,8,NM,132,134,-2
2010,8,NV,197,212,-15
2010,8,NY,1648,1562,86
2010,8,OH,386,396,-10
2010,8,OK,154,134,20
2010,8,OR,360,366,-6
2010,8,PA,1168,1186,-18
2010,8,PR,179,154,25
2010,8,RI,185,170,15
2010,8,SC,2103,2128,-25
2010,8,SD,103,46,57
2010,8,TN,357,345,12
2010,8,TX,7173,7226,-53
2010,8,UT,63,60,3
2010,8,VA,1256,1203,53
2010,8,VI,7,8,-1
2010,8,VT,28,28,0
2010,8,WA,524,516,8
2010,8,WI,113,113,0
2010,8,WV,269,250,19
2010,8,WY,22,24,-2
2010,9,AK,33,31,2
2010,9,AL,540,542,-2
2010,9,AR,166,167,-1
2010,9,AZ,320,304,16
2010,9,CA,3367,3331,36
2010,9,CO,224,240,-16
2010,9,CT,401,388,13
2010,9,DC,18,17,1
2010,9,DE,248,252,-4
2010,9,FL,33125,34511,-1386
2010,9,GA,1287,1204,83
2010,9,GU,2,2,0
2010,9,HI,943,939,4
2010,9,IA,246,193,53
2010,9,ID,151,163,-12
2010,9,IL,555,566,-11
2010,9,IN,309,307,2
2010,9,KS,129,120,9
2010,9,KY,245,242,3
2010,9,LA,7313,7239,74
2010,9,MA,491,485,6
2010,9,MD,1151,1144,7
2010,9,ME,122,119,3
2010,9,MI,274,293,-19
2010,9,MN,315,254,61
2010,9,MO,250,262,-12
2010,9,MS,1121,1129,-8
2010,9,MT,76,58,18
2010,9,NC,2182,2210,-28
2010,9,ND,625,631,-6
2010,9,NE,122,94,28
2010,9,NH,83,82,1
2010,9,NJ,2639,2647,-8
2010,9,NM,114,116,-2
2010,9,NV,223,240,-17
2010,9,NY,1914,1858,56
2010,9,OH,407,413,-6
2010,9,OK,155,147,8
2010,9,OR,423,435,-12
2010,9,PA,1092,1084,8
2010,9,PR,154,178,-24
2010,9,RI,308,348,-40
2010,9,SC,2798,2792,6
2010,9,SD,99,67,32
2010,9,TN,543,604,-61
2010,9,TX,8313,8584,-271
2010,9,UT,87,91,-4
2010,9,VA,1170,1121,49
2010,9,VI,11,15,-4
2010,9,VT,43,42,1
2010,9,WA,632,649,-17
2010,9,WI,164,169,-5
2010,9,WV,279,280,-1
2010,9,WY,27,29,-2
2010,10,AK,25,27,-2
2010,10,AL,548,535,13
2010,10,AR,170,161,9
2010,10,AZ,238,254,-16
2010,10,CA,2678,2519,159
2010,10,CO,233,214,19
2010,10,CT,229,239,-10
2010,10,DC,16,13,3
2010,10,DE,242,236,6
2010,10,FL,26872,27267,-395
2010,10,GA,987,925,62
2010,10,HI,947,883,64
2010,10,IA,351,232,119
2010,10,ID,155,180,-25
2010,10,IL,559,573,-14
2010,10,IN,270,293,-23
2010,10,KS,122,111,11
2010,10,KY,212,198,14
2010,10,LA,6566,6246,320
2010,10,MA,477,458,19
2010,10,MD,521,473,48
2010,10,ME,118,116,2
2010,10,MI,164,166,-2
2010,10,MN,553,347,206
2010,10,MO,239,219,20
2010,10,MS,1239,1169,70
2010,10,MT,94,57,37
2010,10,NC,1575,1528,47
2010,10,ND,1096,968,128
2010,10,NE,107,79,28
2010,10,NH,131,125,6
2010,10,NJ,2101,2083,18
2010,10,NM,110,110,0
2010,10,NV,246,262,-16
2010,10,NY,1615,1574,41
2010,10,OH,369,377,-8
2010,10,OK,160,152,8
2010,10,OR,327,342,-15
2010,10,PA,953,904,49
2010,10,PR,103,106,-3
2010,10,RI,107,110,-3
2010,10,SC,2831,3041,-210
2010,10,SD,133,56,77
2010,10,TN,435,444,-9
2010,10,TX,6425,6460,-35
2010,10,UT,63,71,-8
2010,10,VA,1325,1265,60
2010,10,VI,19,21,-2
2010,10,VT,47,52,-5
2010,10,WA,576,597,-21
2010,10,WI,290,132,158
2010,10,WV,239,220,19
2010,10,WY,20,17,3
2010,11,AK,30,24,6
2010,11,AL,532,546,-14
2010,11,AR,128,111,17
2010,11,AZ,290,284,6
2010,11,CA,2431,2432,-1
2010,11,CO,229,230,-1
2010,11,CT,304,310,-6
2010,11,DC,14,11,3
2010,11,DE,221,226,-5
2010,11,FL,26194,27311,-1117
2010,11,GA,1093,1018,75
2010,11,GU,1,1,0
2010,11,HI,703,703,0
2010,11,IA,393,206,187
2010,11,ID,101,119,-18
2010,11,IL,414,444,-30
2010,11,IN,283,292,-9
2010,11,KS,108,100,8
2010,11,KY,245,233,12
2010,11,LA,6636,6493,143
2010,11,MA,453,456,-3
2010,11,MD,934,878,56
2010,11,ME,100,102,-2
2010,11,MI,181,191,-10
2010,11,MN,810,356,454
2010,11,MO,253,242,11
2010,11,MS,1347,1357,-10
2010,11,MT,108,68,40
2010,11,NC,1587,1521,66
2010,11,ND,1439,1045,394
2010,11,NE,113,87,26
2010,11,NH,72,71,1
2010,11,NJ,2251,2200,51
2010,11,NM,108,110,-2
2010,11,NV,151,161,-10
2010,11,NY,1703,1669,34
2010,11,OH,471,464,7
2010,11,OK,175,152,23
2010,11,OR,327,329,-2
2010,11,PA,1030,941,89
2010,11,PR,65,245,-180
2010,11,RI,92,90,2
2010,11,SC,2604,2551,53
2010,11,SD,226,83,143
2010,11,TN,534,578,-44
2010,11,TX,6960,7172,-212
2010,11,UT,69,76,-7
2010,11,VA,1083,1028,55
2010,11,VI,41,41,0
2010,11,VT,44,44,0
2010,11,WA,606,606,0
2010,11,WI,159,193,-34
2010,11,WV,269,234,35
2010,11,WY,27,28,-1
2010,12,AK,30,28,2
2010,12,AL,791,787,4
2010,12,AR,179,154,25
2010,12,AZ,273,270,3
2010,12,CA,2987,2857,130
2010,12,CO,248,261,-13
2010,12,CT,306,301,5
2010,12,DC,12,11,1
2010,12,DE,297,290,7
2010,12,FL,29037,29283,-246
2010,12,GA,1116,1072,44
2010,12,HI,1112,1119,-7
2010,12,IA,594,200,394
2010,12,ID,145,151,-6
2010,12,IL,571,525,46
2010,12,IN,359,257,102
2010,12,KS,137,120,17
2010,12,KY,249,237,12
2010,12,LA,7338,7056,282
2010,12,MA,626,616,10
2010,12,MD,899,875,24
2010,12,ME,114,118,-4
2010,12,MI,202,224,-22
2010,12,MN,1119,366,753
2010,12,MO,322,298,24
2010,12,MS,1344,1352,-8
2010,12,MT,106,59,47
2010,12,NC,1761,1768,-7
2010,12,ND,2130,943,1187
2010,12,NE,114,83,31
2010,12,NH,93,91,2
2010,12,NJ,2140,2089,51
2010,12,NM,109,116,-7
2010,12,NV,174,189,-15
2010,12,NY,1757,1587,170
2010,12,OH,405,403,2
2010,12,OK,152,140,12
2010,12,OR,299,274,25
2010,12,PA,1003,940,63
2010,12,PR,216,213,3
2010,12,RI,122,113,9
2010,12,SC,2302,2264,38
2010,12,SD,451,89,362
2010,12,TN,438,453,-15
2010,12,TX,7684,7737,-53
2010,12,UT,79,89,-10
2010,12,VA,1660,1631,29
2010,12,VI,312,312,0
2010,12,VT,41,44,-3
2010,12,WA,482,477,5
2010,12,WI,162,157,5
2010,12,WV,283,257,26
2010,12,WY,40,41,-1
2010,13,AK,31,24,7
2010,13,AL,991,1036,-45
2010,13,AR,165,167,-2
2010,13,AZ,260,262,-2
2010,13,CA,2652,2921,-269
2010,13,CO,249,284,-35
2010,13,CT,384,381,3
2010,13,DC,18,15,3
2010,13,DE,251,257,-6
2010,13,FL,38857,40720,-1863
2010,13,GA,1371,1327,44
2010,13,GU,1,1,0
2010,13,HI,429,458,-29
2010,13,IA,508,202,306
2010,13,ID,113,124,-11
2010,13,IL,697,650,47
2010,13,IN,275,281,-6
2010,13,KS,153,160,-7
2010,13,KY,222,223,-1
2010,13,LA,8493,8463,30
2010,13,MA,514,491,23
2010,13,MD,840,821,19
2010,13,ME,149,157,-8
2010,13,MI,174,197,-23
2010,13,MN,655,511,144
2010,13,MO,381,290,91
2010,13,MS,1344,1417,-73
2010,13,MT,70,49,21
2010,13,NC,2051,2104,-53
2010,13,ND,1226,1337,-111
2010,13,NE,109,88,21
2010,13,NH,129,127,2
2010,13,NJ,2374,2397,-23
2010,13,NM,119,122,-3
2010,13,NV,148,163,-15
2010,13,NY,1867,1888,-21
2010,13,OH,364,369,-5
2010,13,OK,197,197,0
2010,13,OR,363,602,-239
2010,13,PA,1013,1007,6
2010,13,PR,353,585,-232
2010,13,RI,131,171,-40
2010,13,SC,3684,3979,-295
2010,13,SD,491,98,393
2010,13,TN,401,445,-44
2010,13,TX,8830,9088,-258
2010,13,UT,77,93,-16
2010,13,VA,1339,1394,-55
2010,13,VI,7,7,0
2010,13,VT,39,41,-2
2010,13,WA,641,679,-38
2010,13,WI,215,224,-9
2010,13,WV,309,299,10
2010,13,WY,41,39,2
2010,14,AK,29,27,2
2010,14,AL,570,539,31
2010,14,AR,177,166,11
2010,14,AZ,227,242,-15
2010,14,CA,2232,2250,-18
2010,14,CO,245,258,-13
2010,14,CT,288,295,-7
2010,14,DC,14,10,4
2010,14,DE,264,263,1
2010,14,FL,27868,28679,-811
2010,14,GA,1016,983,33
2010,14,GU,2,3,-1
2010,14,HI,1002,1003,-1
2010,14,IA,593,271,322
2010,14,ID,105,115,-10
2010,14,IL,510,468,42
2010,14,IN,280,299,-19
2010,14,KS,158,132,26
2010,14,KY,205,197,8
2010,14,LA,7443,7196,247
2010,14,MA,425,413,12
2010,14,MD,767,765,2
2010,14,ME,178,185,-7
2010,14,MI,191,198,-7
2010,14,MN,505,598,-93
2010,14,MO,393,303,90
2010,14,MS,1347,1366,-19
2010,14,MT,99,56,43
2010,14,NC,1757,1755,2
2010,14,ND,988,1761,-773
2010,14,NE,90,75,15
2010,14,NH,135,131,4
2010,14,NJ,2178,2178,0
2010,14,NM,95,97,-2
2010,14,NV,136,144,-8
2010,14,NY,1753,1793,-40
2010,14,OH,391,377,14
2010,14,OK,172,181,-9
2010,14,OR,267,273,-6
2010,14,PA,852,843,9
2010,14,PR,176,234,-58
2010,14,RI,223,226,-3
2010,14,SC,2409,2415,-6
2010,14,SD,222,70,152
2010,14,TN,325,323,2
2010,14,TX,7579,7829,-250
2010,14,UT,79,81,-2
2010,14,VA,1063,1073,-10
2010,14,VI,3,4,-1
2010,14,VT,42,40,2
2010,14,WA,449,451,-2
2010,14,WI,234,289,-55
2010,14,WV,266,254,12
2010,14,WY,46,47,-1
2010,15,AK,41,37,4
2010,15,AL,1180,1157,23
2010,15,AR,175,157,18
2010,15,AZ,270,258,12
2010,15,CA,2330,2321,9
2010,15,CO,233,253,-20
2010,15,CT,358,337,21
2010,15,DC,14,11,3
2010,15,DE,262,251,11
2010,15,FL,34621,35326,-705
2010,15,GA,1283,1212,71
2010,15,GU,3,4,-1
2010,15,HI,988,963,25
2010,15,IA,337,209,128
2010,15,ID,93,95,-2
2010,15,IL,751,644,107
2010,15,IN,294,278,16
2010,15,KS,172,164,8
2010,15,KY,246,233,13
2010,15,LA,8302,8255,47
2010,15,MA,539,485,54
2010,15,MD,726,705,21
2010,15,ME,156,174,-18
2010,15,MI,170,182,-12
2010,15,MN,337,560,-223
2010,15,MO,397,317,80
2010,15,MS,1446,1454,-8
2010,15,MT,96,65,31
2010,15,NC,1862,1902,-40
2010,15,ND,830,1799,-969
2010,15,NE,100,89,11
2010,15,NH,134,128,6
2010,15,NJ,2276,2217,59
2010,15,NM,95,96,-1
2010,15,NV,138,138,0
2010,15,NY,1873,1865,8
2010,15,OH,386,390,-4
2010,15,OK,198,182,16
2010,15,OR,297,299,-2
2010,15,PA,812,771,41
2010,15,PR,92,106,-14
2010,15,RI,154,153,1
2010,15,SC,2323,2252,71
2010,15,SD,129,87,42
2010,15,TN,329,318,11
2010,15,TX,8391,8662,-271
2010,15,UT,89,99,-10
2010,15,VA,1214,1205,9
2010,15,VI,72,74,-2
2010,15,VT,39,39,0
2010,15,WA,531,467,64
2010,15,WI,248,251,-3
2010,15,WV,222,211,11
2010,15,WY,65,62,3
2010,16,AK,37,37,0
2010,16,AL,972,949,23
2010,16,AR,173,172,1
2010,16,AZ,235,237,-2
2010,16,CA,2365,2275,90
2010,16,CO,255,277,-22
2010,16,CT,346,342,4
2010,16,DC,14,12,2
2010,16,DE,246,239,7
2010,16,FL,32126,32167,-41
2010,16,GA,1197,1160,37
2010,16,GU,1,1,0
2010,16,HI,1037,1019,18
2010,16,IA,263,202,61
2010,16,ID,95,100,-5
2010,16,IL,644,622,22
2010,16,IN,286,271,15
2010,16,KS,188,171,17
2010,16,KY,225,208,17
2010,16,LA,8772,8646,126
2010,16,MA,568,485,83
2010,16,MD,678,628,50
2010,16,ME,129,137,-8
2010,16,MI,179,176,3
2010,16,MN,163,178,-15
2010,16,MO,413,340,73
2010,16,MS,1525,1526,-1
2010,16,MT,105,68,37
2010,16,NC,1943,1940,3
2010,16,ND,168,249,-81
2010,16,NE,122,96,26
2010,16,NH,104,97,7
2010,16,NJ,2357,2256,101
2010,16,NM,106,108,-2
2010,16,NV,135,142,-7
2010,16,NY,2597,1795,802
2010,16,OH,410,398,12
2010,16,OK,184,183,1
2010,16,OR,298,278,20
2010,16,PA,845,828,17
2010,16,PR,252,665,-413
2010,16,RI,141,129,12
2010,16,SC,2614,2606,8
2010,16,SD,64,57,7
2010,16,TN,341,333,8
2010,16,TX,9519,9812,-293
2010,16,UN,1,1,0
2010,16,UT,83,91,-8
2010,16,VA,1236,1191,45
2010,16,VI,17,14,3
2010,16,VT,43,35,8
2010,16,WA,506,499,7
2010,16,WI,302,254,48
2010,16,WV,232,234,-2
2010,16,WY,54,56,-2
2010,17,AK,35,36,-1
2010,17,AL,1533,1571,-38
2010,17,AR,198,194,4
2010,17,AZ,327,329,-2
2010,17,CA,3073,3275,-202
2010,17,CO,360,388,-28
2010,17,CT,450,428,22
2010,17,DC,22,18,4
2010,17,DE,330,327,3
2010,17,FL,49775,51402,-1627
2010,17,GA,1732,1687,45
2010,17,GU,1,1,0
2010,17,HI,1969,1962,7
2010,17,IA,212,192,20
2010,17,ID,189,198,-9
2010,17,IL,673,651,22
2010,17,IN,298,305,-7
2010,17,KS,246,242,4
2010,17,KY,302,300,2
2010,17,LA,11979,12195,-216
2010,17,MA,715,664,51
2010,17,MD,913,884,29
2010,17,ME,149,158,-9
2010,17,MI,193,219,-26
2010,17,MN,163,168,-5
2010,17,MO,459,432,27
2010,17,MS,1716,1798,-82
2010,17,MT,95,67,28
2010,17,NC,2701,2716,-15
2010,17,ND,88,131,-43
2010,17,NE,105,101,4
2010,17,NH,121,118,3
2010,17,NJ,3202,3131,71
2010,17,NM,153,141,12
2010,17,NV,167,161,6
2010,17,NY,2213,2133,80
2010,17,OH,434,433,1
2010,17,OK,254,253,1
2010,17,OR,325,325,0
2010,17,PA,981,979,2
2010,17,PR,880,1000,-120
2010,17,RI,336,315,21
2010,17,SC,3499,3572,-73
2010,17,SD,68,71,-3
2010,17,TN,370,356,14
2010,17,TX,12939,13571,-632
2010,17,UT,58,74,-16
2010,17,VA,1941,1950,-9
2010,17,VI,12,14,-2
2010,17,VT,36,35,1
2010,17,WA,570,589,-19
2010,17,WI,201,208,-7
2010,17,WV,220,231,-11
2010,17,WY,43,46,-3
2010,18,AK,35,35,0
2010,18,AL,667,634,33
2010,18,AR,207,200,7
2010,18,AZ,213,224,-11
2010,18,CA,2108,2151,-43
2010,18,CO,354,356,-2
2010,18,CT,361,355,6
2010,18,DC,9,12,-3
2010,18,DE,262,263,-1
2010,18,FL,28917,29855,-938
2010,18,GA,1157,1109,48
2010,18,HI,533,529,4
2010,18,IA,121,124,-3
2010,18,ID,72,89,-17
2010,18,IL,548,548,0
2010,18,IN,248,246,2
2010,18,KS,124,130,-6
2010,18,KY,249,248,1
2010,18,LA,8013,8248,-235
2010,18,MA,413,385,28
2010,18,MD,581,594,-13
2010,18,ME,97,96,1
2010,18,MI,152,152,0
2010,18,MN,129,146,-17
2010,18,MO,301,304,-3
2010,18,MS,1462,1563,-101
2010,18,MT,67,64,3
2010,18,NC,1782,1782,0
2010,18,ND,50,64,-14
2010,18,NE,86,61,25
2010,18,NH,87,74,13
2010,18,NJ,2152,2172,-20
2010,18,NM,114,113,1
2010,18,NV,111,128,-17
2010,18,NY,1819,1667,152
2010,18,OH,312,317,-5
2010,18,OK,167,178,-11
2010,18,OR,294,291,3
2010,18,PA,701,721,-20
2010,18,PR,97,149,-52
2010,18,RI,127,111,16
2010,18,SC,2347,2387,-40
2010,18,SD,50,52,-2
2010,18,TN,446,456,-10
2010,18,TX,9002,9384,-382
2010,18,UN,4,4,0
2010,18,UT,148,155,-7
2010,18,VA,1145,1171,-26
2010,18,VI,7,6,1
2010,18,VT,30,32,-2
2010,18,WA,425,461,-36
2010,18,WI,141,152,-11
2010,18,WV,185,189,-4
2010,18,WY,39,40,-1
2010,19,AK,27,31,-4
2010,19,AL,847,859,-12
2010,19,AR,170,174,-4
2010,19,AZ,230,239,-9
2010,19,CA,2116,2130,-14
2010,19,CO,216,235,-19
2010,19,CT,306,301,5
2010,19,DC,13,14,-1
2010,19,DE,362,357,5
2010,19,FL,34917,34074,843
2010,19,GA,1267,1267,0
2010,19,GU,1,1,0
2010,19,HI,607,609,-2
2010,19,IA,128,133,-5
2010,19,ID,76,82,-6
2010,19,IL,535,532,3
2010,19,IN,207,264,-57
2010,19,KS,172,171,1
2010,19,KY,227,244,-17
2010,19,LA,8550,8705,-155
2010,19,MA,440,419,21
2010,19,MD,570,563,7
2010,19,ME,108,108,0
2010,19,MI,163,168,-5
2010,19,MN,90,97,-7
2010,19,MO,256,270,-14
2010,19,MS,1348,1415,-67
2010,19,MT,74,73,1
2010,19,NC,1997,2043,-46
2010,19,ND,60,57,3
2010,19,NE,77,67,10
2010,19,NH,78,77,1
2010,19,NJ,2297,2308,-11
2010,19,NM,88,89,-1
2010,19,NV,116,119,-3
2010,19,NY,1812,1788,24
2010,19,OH,328,336,-8
2010,19,OK,181,191,-10
2010,19,OR,236,243,-7
2010,19,PA,773,784,-11
2010,19,PR,170,299,-129
2010,19,RI,135,121,14
2010,19,SC,2954,2971,-17
2010,19,SD,49,51,-2
2010,19,TN,306,316,-10
2010,19,TX,10008,10366,-358
2010,19,UT,53,57,-4
2010,19,VA,1364,1369,-5
2010,19,VI,10,9,1
2010,19,VT,38,35,3
2010,19,WA,388,416,-28
2010,19,WI,139,145,-6
2010,19,WV,213,216,-3
2010,19,WY,40,43,-3
2010,20,AK,24,26,-2
2010,20,AL,811,795,16
2010,20,AR,197,178,19
2010,20,AZ,228,245,-17
2010,20,CA,2162,2149,13
2010,20,CO,228,226,2
2010,20,CT,692,675,17
2010,20,DC,18,17,1
2010,20,DE,300,295,5
2010,20,FL,36934,36601,333
2010,20,GA,1293,1266,27
2010,20,GU,1,1,0
2010,20,HI,726,719,7
2010,20,IA,228,215,13
2010,20,ID,110,129,-19
2010,20,IL,425,398,27
2010,20,IN,237,214,23
2010,20,KS,135,132,3
2010,20,KY,244,237,7
2010,20,LA,9530,9459,71
2010,20,MA,483,435,48
2010,20,MD,666,649,17
2010,20,ME,77,77,0
2010,20,MI,166,160,6
2010,20,MN,80,87,-7
2010,20,MO,235,238,-3
2010,20,MS,1684,1663,21
2010,20,MT,65,60,5
2010,20,NC,2294,2286,8
2010,20,ND,60,68,-8
2010,20,NE,102,86,16
2010,20,NH,88,81,7
2010,20,NJ,2874,2819,55
2010,20,NM,119,119,0
2010,20,NV,119,128,-9
2010,20,NY,1930,1887,43
2010,20,OH,313,323,-10
2010,20,OK,202,184,18
2010,20,OR,319,300,19
2010,20,PA,846,870,-24
2010,20,PR,428,457,-29
2010,20,RI,178,147,31
2010,20,SC,2991,2952,39
2010,20,SD,89,90,-1
2010,20,TN,320,297,23
2010,20,TX,11693,11843,-150
2010,20,UN,1,0,1
2010,20,UT,55,58,-3
2010,20,VA,1466,1459,7
2010,20,VI,12,14,-2
2010,20,VT,32,30,2
2010,20,WA,371,378,-7
2010,20,WI,187,140,47
2010,20,WV,202,191,11
2010,20,WY,43,46,-3
2010,21,AK,32,33,-1
2010,21,AL,1172,1157,15
2010,21,AR,170,156,14
2010,21,AZ,299,287,12
2010,21,CA,2399,2242,157
2010,21,CO,370,366,4
2010,21,CT,377,375,2
2010,21,DC,12,12,0
2010,21,DE,306,297,9
2010,21,FL,41463,41133,330
2010,21,GA,1471,1441,30
2010,21,GU,3,3,0
2010,21,HI,1078,1070,8
2010,21,IA,155,151,4
2010,21,ID,74,79,-5
2010,21,IL,418,451,-33
2010,21,IN,251,239,12
2010,21,KS,160,164,-4
2010,21,KY,210,205,5
2010,21,LA,11020,11006,14
2010,21,MA,595,533,62
2010,21,MD,709,663,46
2010,21,ME,107,103,4
2010,21,MI,166,182,-16
2010,21,MN,99,111,-12
2010,21,MO,268,252,16
2010,21,MS,1874,1930,-56
2010,21,MT,98,72,26
2010,21,NC,2287,2264,23
2010,21,ND,84,85,-1
2010,21,NE,107,84,23
2010,21,NH,85,91,-6
2010,21,NJ,2976,2958,18
2010,21,NM,100,104,-4
2010,21,NV,155,148,7
2010,21,NY,2211,2174,37
2010,21,OH,416,365,51
2010,21,OK,168,165,3
2010,21,OR,279,275,4
2010,21,PA,789,719,70
2010,21,PR,323,335,-12
2010,21,RI,254,196,58
2010,21,SC,3816,3741,75
2010,21,SD,51,45,6
2010,21,TN,367,339,28
2010,21,TX,13916,14458,-542
2010,21,UT,82,86,-4
2010,21,VA,1669,1642,27
2010,21,VI,7,10,-3
2010,21,VT,18,17,1
2010,21,WA,446,410,36
2010,21,WI,148,139,9
2010,21,WV,202,194,8
2010,21,WY,39,30,9
2010,22,AK,33,35,-2
2010,22,AL,914,833,81
2010,22,AR,210,179,31
2010,22,AZ,278,286,-8
2010,22,CA,2557,2681,-124
2010,22,CO,231,224,7
2010,22,CT,456,459,-3
2010,22,DC,29,27,2
2010,22,DE,394,348,46
2010,22,FL,47370,47911,-541
2010,22,GA,2011,1928,83
2010,22,HI,820,820,0
2010,22,IA,154,162,-8
2010,22,ID,79,78,1
2010,22,IL,442,427,15
2010,22,IN,277,268,9
2010,22,KS,174,171,3
2010,22,KY,331,277,54
2010,22,LA,12394,12519,-125
2010,22,MA,581,513,68
2010,22,MD,978,960,18
2010,22,ME,99,104,-5
2010,22,MI,144,149,-5
2010,22,MN,123,125,-2
2010,22,MO,289,281,8
2010,22,MS,2193,2256,-63
2010,22,MT,115,84,31
2010,22,NC,2594,2537,57
2010,22,ND,114,127,-13
2010,22,NE,87,76,11
2010,22,NH,110,104,6
2010,22,NJ,2937,2940,-3
2010,22,NM,111,119,-8
2010,22,NV,139,154,-15
2010,22,NY,2033,2014,19
2010,22,OH,382,376,6
2010,22,OK,241,231,10
2010,22,OR,361,365,-4
2010,22,PA,723,761,-38
2010,22,PR,172,140,32
2010,22,RI,214,207,7
2010,22,SC,3681,3655,26
2010,22,SD,48,48,0
2010,22,TN,1027,356,671
2010,22,TX,16842,17570,-728
2010,22,UT,109,100,9
2010,22,VA,2592,2542,50
2010,22,VI,27,26,1
2010,22,VT,32,34,-2
2010,22,WA,458,425,33
2010,22,WI,133,123,10
2010,22,WV,183,180,3
2010,22,WY,37,37,0
2010,23,AK,31,32,-1
2010,23,AL,1246,1194,52
2010,23,AR,189,151,38
2010,23,AZ,299,280,19
2010,23,CA,2140,2262,-122
2010,23,CO,247,233,14
2010,23,CT,351,346,5
2010,23,DC,257,255,2
2010,23,DE,224,222,2
2010,23,FL,35976,36367,-391
2010,23,GA,1491,1400,91
2010,23,GU,2,2,0
2010,23,HI,805,801,4
2010,23,IA,174,167,7
2010,23,ID,66,68,-2
2010,23,IL,425,341,84
2010,23,IN,269,211,58
2010,23,KS,177,167,10
2010,23,KY,343,272,71
2010,23,LA,10551,10632,-81
2010,23,MA,629,614,15
2010,23,MD,705,698,7
2010,23,ME,104,101,3
2010,23,MI,166,152,14
2010,23,MN,92,96,-4
2010,23,MO,302,292,10
2010,23,MS,1667,1712,-45
2010,23,MT,100,63,37
2010,23,NC,2336,2298,38
2010,23,ND,52,65,-13
2010,23,NE,92,94,-2
2010,23,NH,80,72,8
2010,23,NJ,2426,2439,-13
2010,23,NM,112,105,7
2010,23,NV,139,138,1
2010,23,NY,1962,1984,-22
2010,23,OH,330,313,17
2010,23,OK,236,236,0
2010,23,OR,251,255,-4
2010,23,PA,664,711,-47
2010,23,PR,142,379,-237
2010,23,RI,165,151,14
2010,23,SC,3240,3195,45
2010,23,SD,52,47,5
2010,23,TN,964,300,664
2010,23,TX,15183,15462,-279
2010,23,UT,48,47,1
2010,23,VA,1614,1541,73
2010,23,VI,19,25,-6
2010,23,VT,17,17,0
2010,23,WA,378,375,3
2010,23,WI,102,97,5
2010,23,WV,171,181,-10
2010,23,WY,33,32,1
2010,24,AK,28,26,2
2010,24,AL,806,803,3
2010,24,AR,196,169,27
2010,24,AZ,272,275,-3
2010,24,CA,2236,2455,-219
2010,24,CO,398,391,7
2010,24,CT,421,415,6
2010,24,DC,19,16,3
2010,24,DE,354,362,-8
2010,24,FL,40882,41554,-672
2010,24,GA,1756,1696,60
2010,24,GU,1,0,1
2010,24,HI,955,941,14
2010,24,IA,120,121,-1
2010,24,ID,104,107,-3
2010,24,IL,571,531,40
2010,24,IN,243,222,21
2010,24,KS,209,161,48
2010,24,KY,289,233,56
2010,24,LA,11474,11499,-25
2010,24,MA,533,505,28
2010,24,MD,835,823,12
2010,24,ME,117,113,4
2010,24,MI,160,154,6
2010,24,MN,100,113,-13
2010,24,MO,307,317,-10
2010,24,MS,1856,1788,68
2010,24,MT,76,47,29
2010,24,NC,2647,2601,46
2010,24,ND,67,71,-4
2010,24,NE,69,63,6
2010,24,NH,88,91,-3
2010,24,NJ,2632,2593,39
2010,24,NM,123,125,-2
2010,24,NV,106,108,-2
2010,24,NY,2103,2139,-36
2010,24,OH,321,307,14
2010,24,OK,206,195,11
2010,24,OR,241,260,-19
2010,24,PA,727,770,-43
2010,24,PR,142,174,-32
2010,24,RI,232,224,8
2010,24,SC,3689,3629,60
2010,24,SD,39,47,-8
2010,24,TN,868,312,556
2010,24,TX,17907,17973,-66
2010,24,UT,38,44,-6
2010,24,VA,1948,1923,25
2010,24,VI,97,97,0
2010,24,VT,35,35,0
2010,24,WA,410,440,-30
2010,24,WI,167,163,4
2010,24,WV,252,252,0
2010,24,WY,32,31,1
2010,25,AK,17,21,-4
2010,25,AL,1031,984,47
2010,25,AR,134,107,27
2010,25,AZ,385,396,-11
2010,25,CA,2012,2041,-29
2010,25,CO,206,264,-58
2010,25,CT,379,391,-12
2010,25,DC,24,30,-6
2010,25,DE,318,317,1
2010,25,FL,41796,42189,-393
2010,25,GA,1686,1609,77
2010,25,GU,1,1,0
2010,25,HI,805,809,-4
2010,25,IA,128,120,8
2010,25,ID,79,72,7
2010,25,IL,397,380,17
2010,25,IN,219,208,11
2010,25,KS,152,153,-1
2010,25,KY,213,185,28
2010,25,LA,11375,11196,179
2010,25,MA,506,479,27
2010,25,MD,870,770,100
2010,25,ME,105,106,-1
2010,25,MI,170,177,-7
2010,25,MN,88,89,-1
2010,25,MO,249,239,10
2010,25,MS,1791,1796,-5
2010,25,MT,87,35,52
2010,25,NC,2756,2698,58
2010,25,ND,52,68,-16
2010,25,NE,85,71,14
2010,25,NH,82,78,4
2010,25,NJ,3095,3092,3
2010,25,NM,117,122,-5
2010,25,NV,126,132,-6
2010,25,NY,3816,3867,-51
2010,25,OH,331,321,10
2010,25,OK,171,176,-5
2010,25,OR,243,240,3
2010,25,PA,718,747,-29
2010,25,PR,203,229,-26
2010,25,RI,218,221,-3
2010,25,SC,3900,3762,138
2010,25,SD,49,43,6
2010,25,TN,750,306,444
2010,25,TX,20168,20194,-26
2010,25,UT,54,46,8
2010,25,VA,2206,2129,77
2010,25,VI,13,14,-1
2010,25,VT,26,30,-4
2010,25,WA,347,345,2
2010,25,WI,127,129,-2
2010,25,WV,211,196,15
2010,25,WY,24,23,1
2010,26,AK,42,39,3
2010,26,AL,1150,1158,-8
2010,26,AR,191,183,8
2010,26,AZ,317,355,-38
2010,26,CA,2057,2272,-215
2010,26,CO,296,282,14
2010,26,CT,521,558,-37
2010,26,DC,26,25,1
2010,26,DE,442,439,3
2010,26,FL,55265,55545,-280
2010,26,GA,2394,2331,63
2010,26,HI,1134,1130,4
2010,26,IA,199,199,0
2010,26,ID,68,74,-6
2010,26,IL,586,599,-13
2010,26,IN,261,255,6
2010,26,KS,194,195,-1
2010,26,KY,250,235,15
2010,26,LA,16188,16035,153
2010,26,MA,859,865,-6
2010,26,MD,1824,1838,-14
2010,26,ME,124,125,-1
2010,26,MI,159,164,-5
2010,26,MN,105,117,-12
2010,26,MO,261,260,1
2010,26,MS,1865,1916,-51
2010,26,MT,179,116,63
2010,26,NC,3331,3281,50
2010,26,ND,44,65,-21
2010,26,NE,106,98,8
2010,26,NH,112,113,-1
2010,26,NJ,3261,3352,-91
2010,26,NM,173,178,-5
2010,26,NV,139,184,-45
2010,26,NY,2752,2842,-90
2010,26,OH,365,379,-14
2010,26,OK,184,191,-7
2010,26,OR,268,267,1
2010,26,PA,858,933,-75
2010,26,PR,159,370,-211
2010,26,RI,249,250,-1
2010,26,SC,5148,5499,-351
2010,26,SD,44,47,-3
2010,26,TN,613,298,315
2010,26,TX,26345,26500,-155
2010,26,UN,1,1,0
2010,26,UT,57,56,1
2010,26,VA,2942,2889,53
2010,26,VI,16,18,-2
2010,26,VT,40,40,0
2010,26,WA,570,580,-10
2010,26,WI,142,134,8
2010,26,WV,267,280,-13
2010,26,WY,27,29,-2
2010,27,AK,27,23,4
2010,27,AL,1029,1023,6
2010,27,AR,137,118,19
2010,27,AZ,230,271,-41
2010,27,CA,1811,1968,-157
2010,27,CO,202,199,3
2010,27,CT,395,400,-5
2010,27,DC,19,21,-2
2010,27,DE,311,306,5
2010,27,FL,39404,40310,-906
2010,27,GA,2033,1979,54
2010,27,HI,282,278,4
2010,27,IA,156,157,-1
2010,27,ID,44,41,3
2010,27,IL,388,374,14
2010,27,IN,235,253,-18
2010,27,KS,132,131,1
2010,27,KY,234,226,8
2010,27,LA,11554,11432,122
2010,27,MA,590,546,44
2010,27,MD,769,774,-5
2010,27,ME,106,108,-2
2010,27,MI,135,121,14
2010,27,MN,92,100,-8
2010,27,MO,244,247,-3
2010,27,MS,1433,1597,-164
2010,27,MT,67,38,29
2010,27,NC,2533,2491,42
2010,27,ND,44,47,-3
2010,27,NE,72,67,5
2010,27,NH,76,78,-2
2010,27,NJ,2310,2289,21
2010,27,NM,115,116,-1
2010,27,NV,103,105,-2
2010,27,NY,2106,2201,-95
2010,27,OH,322,332,-10
2010,27,OK,182,170,12
2010,27,OR,267,263,4
2010,27,PA,611,622,-11
2010,27,PR,276,285,-9
2010,27,RI,205,207,-2
2010,27,SC,3676,3594,82
2010,27,SD,44,44,0
2010,27,TN,440,238,202
2010,27,TX,23315,23298,17
2010,27,UT,55,48,7
2010,27,VA,2191,2169,22
2010,27,VI,11,15,-4
2010,27,VT,16,19,-3
2010,27,WA,336,352,-16
2010,27,WI,129,122,7
2010,27,WV,190,206,-16
2010,27,WY,37,49,-12
2010,28,AK,21,22,-1
2010,28,AL,924,910,14
2010,28,AR,172,155,17
2010,28,AZ,292,299,-7
2010,28,CA,2622,2797,-175
2010,28,CO,242,236,6
2010,28,CT,454,460,-6
2010,28,DC,18,22,-4
2010,28,DE,334,342,-8
2010,28,FL,40953,41822,-869
2010,28,GA,1972,1984,-12
2010,28,GU,1,0,1
2010,28,HI,477,483,-6
2010,28,IA,191,200,-9
2010,28,ID,47,57,-10
2010,28,IL,452,454,-2
2010,28,IN,432,454,-22
2010,28,KS,195,165,30
2010,28,KY,293,269,24
2010,28,LA,12179,12084,95
2010,28,MA,580,575,5
2010,28,MD,1036,1024,12
2010,28,ME,118,122,-4
2010,28,MI,216,214,2
2010,28,MN,117,134,-17
2010,28,MO,320,328,-8
2010,28,MS,1495,1472,23
2010,28,MT,119,29,90
2010,28,NC,3322,3296,26
2010,28,ND,57,54,3
2010,28,NE,124,119,5
2010,28,NH,140,173,-33
2010,28,NJ,3329,3285,44
2010,28,NM,120,129,-9
2010,28,NV,129,149,-20
2010,28,NY,2773,2846,-73
2010,28,OH,409,406,3
2010,28,OK,274,182,92
2010,28,OR,352,331,21
2010,28,PA,765,768,-3
2010,28,PR,337,351,-14
2010,28,RI,246,254,-8
2010,28,SC,3977,3913,64
2010,28,SD,46,52,-6
2010,28,TN,520,348,172
2010,28,TX,26651,27061,-410
2010,28,UN,1,1,0
2010,28,UT,52,55,-3
2010,28,VA,2324,2454,-130
2010,28,VI,15,17,-2
2010,28,VT,40,42,-2
2010,28,WA,359,386,-27
2010,28,WI,246,258,-12
2010,28,WV,240,242,-2
2010,28,WY,27,27,0
2010,29,AK,32,35,-3
2010,29,AL,871,889,-18
2010,29,AR,180,168,12
2010,29,AZ,344,358,-14
2010,29,CA,1826,1955,-129
2010,29,CO,211,220,-9
2010,29,CT,418,420,-2
2010,29,DC,17,16,1
2010,29,DE,320,338,-18
2010,29,FL,38271,39007,-736
2010,29,GA,1776,1765,11
2010,29,HI,884,883,1
2010,29,IA,219,207,12
2010,29,ID,62,62,0
2010,29,IL,515,505,10
2010,29,IN,401,389,12
2010,29,KS,202,192,10
2010,29,KY,261,259,2
2010,29,LA,10701,10697,4
2010,29,MA,767,755,12
2010,29,MD,974,973,1
2010,29,ME,104,107,-3
2010,29,MI,211,200,11
2010,29,MN,105,111,-6
2010,29,MO,276,293,-17
2010,29,MS,1301,1280,21
2010,29,MT,140,42,98
2010,29,NC,2617,2587,30
2010,29,ND,70,67,3
2010,29,NE,114,90,24
2010,29,NH,127,101,26
2010,29,NJ,2696,2697,-1
2010,29,NM,125,130,-5
2010,29,NV,142,164,-22
2010,29,NY,2502,2598,-96
2010,29,OH,386,410,-24
2010,29,OK,238,204,34
2010,29,OR,282,291,-9
2010,29,PA,776,841,-65
2010,29,PR,729,807,-78
2010,29,RI,235,235,0
2010,29,SC,3716,3669,47
2010,29,SD,54,52,2
2010,29,TN,451,322,129
2010,29,TX,23898,24432,-534
2010,29,UT,43,50,-7
2010,29,VA,2322,2366,-44
2010,29,VI,39,38,1
2010,29,VT,37,41,-4
2010,29,WA,408,413,-5
2010,29,WI,220,204,16
2010,29,WV,215,218,-3
2010,29,WY,34,35,-1
2010,30,AK,37,33,4
2010,30,AL,1280,1270,10
2010,30,AR,155,148,7
2010,30,AZ,381,400,-19
2010,30,CA,2087,2188,-101
2010,30,CO,253,267,-14
2010,30,CT,525,522,3
2010,30,DC,22,19,3
2010,30,DE,460,453,7
2010,30,FL,46680,47358,-678
2010,30,GA,2197,2165,32
2010,30,HI,615,621,-6
2010,30,IA,217,213,4
2010,30,ID,66,62,4
2010,30,IL,573,593,-20
2010,30,IN,385,387,-2
2010,30,KS,241,235,6
2010,30,KY,284,273,11
2010,30,LA,12835,12765,70
2010,30,MA,701,694,7
2010,30,MD,1214,1232,-18
2010,30,ME,105,106,-1
2010,30,MI,181,166,15
2010,30,MN,101,104,-3
2010,30,MO,307,317,-10
2010,30,MS,1402,1367,35
2010,30,MT,67,45,22
2010,30,NC,3349,3376,-27
2010,30,ND,55,63,-8
2010,30,NE,127,111,16
2010,30,NH,107,119,-12
2010,30,NJ,3319,3382,-63
2010,30,NM,174,180,-6
2010,30,NV,141,156,-15
2010,30,NY,2522,2617,-95
2010,30,OH,416,440,-24
2010,30,OK,251,233,18
2010,30,OR,353,336,17
2010,30,PA,1007,1064,-57
2010,30,PR,301,258,43
2010,30,RI,298,294,4
2010,30,SC,4286,4251,35
2010,30,SD,48,49,-1
2010,30,TN,469,365,104
2010,30,TX,23586,23390,196
2010,30,UN,1,1,0
2010,30,UT,68,66,2
2010,30,VA,3011,3013,-2
2010,30,VI,10,10,0
2010,30,VT,37,40,-3
2010,30,WA,414,429,-15
2010,30,WI,205,209,-4
2010,30,WV,264,277,-13
2010,30,WY,36,32,4
2010,31,AK,25,27,-2
2010,31,AL,727,719,8
2010,31,AR,156,145,11
2010,31,AZ,455,395,60
2010,31,CA,2263,2314,-51
2010,31,CO,174,183,-9
2010,31,CT,521,516,5
2010,31,DC,22,24,-2
2010,31,DE,332,328,4
2010,31,FL,34588,34618,-30
2010,31,GA,1917,1856,61
2010,31,HI,1057,1050,7
2010,31,IA,213,199,14
2010,31,ID,49,50,-1
2010,31,IL,462,451,11
2010,31,IN,300,293,7
2010,31,KS,169,164,5
2010,31,KY,204,199,5
2010,31,LA,9463,9198,265
2010,31,MA,747,750,-3
2010,31,MD,913,897,16
2010,31,ME,114,118,-4
2010,31,MI,156,152,4
2010,31,MN,85,89,-4
2010,31,MO,278,293,-15
2010,31,MS,1644,1577,67
2010,31,MT,54,41,13
2010,31,NC,2737,2679,58
2010,31,ND,39,35,4
2010,31,NE,89,81,8
2010,31,NH,70,66,4
2010,31,NJ,2528,2503,25
2010,31,NM,138,139,-1
2010,31,NV,148,157,-9
2010,31,NY,2144,2182,-38
2010,31,OH,370,369,1
2010,31,OK,308,238,70
2010,31,OR,278,260,18
2010,31,PA,904,929,-25
2010,31,PR,10424,10428,-4
2010,31,RI,280,281,-1
2010,31,SC,3603,3530,73
2010,31,SD,42,39,3
2010,31,TN,467,289,178
2010,31,TX,19402,18036,1366
2010,31,UT,57,48,9
2010,31,VA,2169,2124,45
2010,31,VI,34,34,0
2010,31,VT,28,26,2
2010,31,WA,358,378,-20
2010,31,WI,162,167,-5
2010,31,WV,182,187,-5
2010,31,WY,32,30,2
2010,32,AK,27,24,3
2010,32,AL,828,831,-3
2010,32,AR,173,144,29
2010,32,AZ,531,376,155
2010,32,CA,1866,1844,22
2010,32,CO,225,211,14
2010,32,CT,495,486,9
2010,32,DC,258,259,-1
2010,32,DE,396,387,9
2010,32,FL,37137,37980,-843
2010,32,GA,2015,1957,58
2010,32,HI,421,415,6
2010,32,IA,165,162,3
2010,32,ID,45,47,-2
2010,32,IL,416,402,14
2010,32,IN,349,337,12
2010,32,KS,167,155,12
2010,32,KY,247,238,9
2010,32,LA,10305,10108,197
2010,32,MA,710,679,31
2010,32,MD,850,826,24
2010,32,ME,134,134,0
2010,32,MI,163,154,9
2010,32,MN,118,109,9
2010,32,MO,419,220,199
2010,32,MS,1277,1189,88
2010,32,MT,65,34,31
2010,32,NC,3347,3282,65
2010,32,ND,76,78,-2
2010,32,NE,99,87,12
2010,32,NH,85,93,-8
2010,32,NJ,3630,3585,45
2010,32,NM,157,164,-7
2010,32,NV,166,171,-5
2010,32,NY,2577,2618,-41
2010,32,OH,379,379,0
2010,32,OK,309,209,100
2010,32,OR,305,288,17
2010,32,PA,927,923,4
2010,32,PR,140,161,-21
2010,32,RI,290,279,11
2010,32,SC,3941,3908,33
2010,32,SD,70,71,-1
2010,32,TN,557,338,219
2010,32,TX,19207,18658,549
2010,32,UT,29,30,-1
2010,32,VA,2545,2467,78
2010,32,VI,19,19,0
2010,32,VT,37,42,-5
2010,32,WA,428,421,7
2010,32,WI,162,163,-1
2010,32,WV,235,237,-2
2010,32,WY,19,19,0
2010,33,AK,25,26,-1
2010,33,AL,874,828,46
2010,33,AR,213,195,18
2010,33,AZ,559,365,194
2010,33,CA,2043,2014,29
2010,33,CO,206,201,5
2010,33,CT,673,531,142
2010,33,DC,14,15,-1
2010,33,DE,364,337,27
2010,33,FL,36660,36618,42
2010,33,GA,2043,1986,57
2010,33,GU,1,1,0
2010,33,HI,1212,1242,-30
2010,33,IA,210,201,9
2010,33,ID,53,48,5
2010,33,IL,589,576,13
2010,33,IN,304,287,17
2010,33,KS,155,143,12
2010,33,KY,254,212,42
2010,33,LA,9820,9581,239
2010,33,MA,754,740,14
2010,33,MD,870,838,32
2010,33,ME,114,104,10
2010,33,MI,185,167,18
2010,33,MN,91,90,1
2010,33,MO,243,246,-3
2010,33,MS,1401,1367,34
2010,33,MT,98,37,61
2010,33,NC,2934,2860,74
2010,33,ND,58,51,7
2010,33,NE,99,86,13
2010,33,NH,93,88,5
2010,33,NJ,2923,2919,4
2010,33,NM,155,157,-2
2010,33,NV,167,170,-3
2010,33,NY,2929,2955,-26
2010,33,OH,398,391,7
2010,33,OK,272,198,74
2010,33,OR,313,284,29
2010,33,PA,1187,1204,-17
2010,33,PR,340,219,121
2010,33,RI,317,316,1
2010,33,SC,3666,3615,51
2010,33,SD,126,118,8
2010,33,TN,492,293,199
2010,33,TX,18974,18606,368
2010,33,UT,40,40,0
2010,33,VA,2335,2225,110
2010,33,VI,40,39,1
2010,33,VT,27,24,3
2010,33,WA,420,444,-24
2010,33,WI,196,175,21
2010,33,WV,240,231,9
2010,33,WY,60,28,32
2010,34,AK,41,42,-1
2010,34,AL,1146,1117,29
2010,34,AR,178,154,24
2010,34,AZ,575,452,123
2010,34,CA,2144,2259,-115
2010,34,CO,289,217,72
2010,34,CT,514,497,17
2010,34,DC,96,88,8
2010,34,DE,385,368,17
2010,34,FL,37952,38459,-507
2010,34,GA,1984,1876,108
2010,34,GU,5,4,1
2010,34,HI,2998,3013,-15
2010,34,IA,209,196,13
2010,34,ID,55,50,5
2010,34,IL,499,398,101
2010,34,IN,292,293,-1
2010,34,KS,138,135,3
2010,34,KY,265,209,56
2010,34,LA,10063,9870,193
2010,34,MA,767,742,25
2010,34,MD,932,910,22
2010,34,ME,121,115,6
2010,34,MI,163,158,5
2010,34,MN,92,98,-6
2010,34,MO,210,205,5
2010,34,MS,1365,1351,14
2010,34,MT,38,31,7
2010,34,NC,3009,2954,55
2010,34,ND,53,59,-6
2010,34,NE,106,93,13
2010,34,NH,79,79,0
2010,34,NJ,3004,3011,-7
2010,34,NM,180,173,7
2010,34,NV,161,169,-8
2010,34,NY,3090,3144,-54
2010,34,OH,422,418,4
2010,34,OK,215,166,49
2010,34,OR,421,359,62
2010,34,PA,912,916,-4
2010,34,PR,170,175,-5
2010,34,RI,348,333,15
2010,34,SC,3955,3907,48
2010,34,SD,111,111,0
2010,34,TN,471,315,156
2010,34,TX,16831,16564,267
2010,34,UT,40,39,1
2010,34,VA,2885,3084,-199
2010,34,VI,16,33,-17
2010,34,VT,36,35,1
2010,34,WA,642,652,-10
2010,34,WI,248,168,80
2010,34,WV,234,234,0
2010,34,WY,20,22,-2
2010,35,AK,42,40,2
2010,35,AL,1022,1024,-2
2010,35,AR,165,141,24
2010,35,AZ,460,372,88
2010,35,CA,2334,2406,-72
2010,35,CO,356,350,6
2010,35,CT,589,555,34
2010,35,DC,26,23,3
2010,35,DE,386,378,8
2010,35,FL,40115,40792,-677
2010,35,GA,2168,2099,69
2010,35,GU,1,1,0
2010,35,HI,1761,1758,3
2010,35,IA,185,176,9
2010,35,ID,59,53,6
2010,35,IL,504,408,96
2010,35,IN,298,271,27
2010,35,KS,149,137,12
2010,35,KY,278,225,53
2010,35,LA,10578,10645,-67
2010,35,MA,942,913,29
2010,35,MD,1137,1110,27
2010,35,ME,129,126,3
2010,35,MI,159,159,0
2010,35,MN,101,91,10
2010,35,MO,249,235,14
2010,35,MS,1393,1462,-69
2010,35,MT,42,35,7
2010,35,NC,3159,3010,149
2010,35,ND,57,64,-7
2010,35,NE,99,98,1
2010,35,NH,172,165,7
2010,35,NJ,3658,3615,43
2010,35,NM,183,171,12
2010,35,NV,160,161,-1
2010,35,NY,3301,3341,-40
2010,35,OH,473,478,-5
2010,35,OK,229,193,36
2010,35,OR,551,428,123
2010,35,PA,1028,1040,-12
2010,35,PR,270,269,1
2010,35,RI,346,315,31
2010,35,SC,3902,3812,90
2010,35,SD,176,187,-11
2010,35,TN,554,386,168
2010,35,TX,17183,17019,164
2010,35,UT,42,39,3
2010,35,VA,2708,2581,127
2010,35,VI,15,14,1
2010,35,VT,27,29,-2
2010,35,WA,498,512,-14
2010,35,WI,226,154,72
2010,35,WV,278,260,18
2010,35,WY,32,32,0
2010,36,AK,34,31,3
2010,36,AL,745,729,16
2010,36,AR,164,159,5
2010,36,AZ,298,273,25
2010,36,CA,2081,2059,22
2010,36,CO,248,250,-2
2010,36,CT,459,399,60
2010,36,DC,24,22,2
2010,36,DE,403,414,-11
2010,36,FL,30283,30906,-623
2010,36,GA,1628,1627,1
2010,36,GU,1,0,1
2010,36,HI,344,351,-7
2010,36,IA,184,149,35
2010,36,ID,38,39,-1
2010,36,IL,392,329,63
2010,36,IN,264,267,-3
2010,36,KS,117,119,-2
2010,36,KY,251,217,34
2010,36,LA,7655,7648,7
2010,36,MA,753,706,47
2010,36,MD,905,884,21
2010,36,ME,107,102,5
2010,36,MI,141,142,-1
2010,36,MN,90,83,7
2010,36,MO,234,243,-9
2010,36,MS,1049,1125,-76
2010,36,MT,51,46,5
2010,36,NC,2515,2485,30
2010,36,ND,35,41,-6
2010,36,NE,71,64,7
2010,36,NH,87,91,-4
2010,36,NJ,2817,2849,-32
2010,36,NM,160,167,-7
2010,36,NV,132,131,1
2010,36,NY,2805,2895,-90
2010,36,OH,376,378,-2
2010,36,OK,173,156,17
2010,36,OR,548,478,70
2010,36,PA,822,830,-8
2010,36,PR,307,311,-4
2010,36,RI,332,255,77
2010,36,SC,3086,3032,54
2010,36,SD,66,69,-3
2010,36,TN,401,296,105
2010,36,TX,13162,13402,-240
2010,36,UT,88,86,2
2010,36,VA,2298,2062,236
2010,36,VI,21,16,5
2010,36,VT,21,20,1
2010,36,WA,416,463,-47
2010,36,WI,187,122,65
2010,36,WV,255,259,-4
2010,36,WY,32,32,0
2010,37,AK,34,32,2
2010,37,AL,926,893,33
2010,37,AR,160,144,16
2010,37,AZ,366,346,20
2010,37,CA,2459,2481,-22
2010,37,CO,257,241,16
2010,37,CT,522,441,81
2010,37,DC,39,31,8
2010,37,DE,383,372,11
2010,37,FL,32777,33822,-1045
2010,37,GA,1778,1721,57
2010,37,GU,2,3,-1
2010,37,HI,1205,1210,-5
2010,37,IA,173,162,11
2010,37,ID,60,54,6
2010,37,IL,438,392,46
2010,37,IN,298,295,3
2010,37,KS,133,142,-9
2010,37,KY,272,236,36
2010,37,LA,8338,8297,41
2010,37,MA,760,750,10
2010,37,MD,807,760,47
2010,37,ME,144,138,6
2010,37,MI,163,166,-3
2010,37,MN,92,85,7
2010,37,MO,206,223,-17
2010,37,MS,1150,1221,-71
2010,37,MT,65,55,10
2010,37,NC,2526,2504,22
2010,37,ND,47,51,-4
2010,37,NE,89,84,5
2010,37,NH,133,138,-5
2010,37,NJ,3133,3155,-22
2010,37,NM,200,191,9
2010,37,NV,132,132,0
2010,37,NY,3289,3436,-147
2010,37,OH,408,400,8
2010,37,OK,212,172,40
2010,37,OR,463,357,106
2010,37,PA,866,875,-9
2010,37,PR,295,475,-180
2010,37,RI,279,267,12
2010,37,SC,3807,3781,26
2010,37,SD,84,82,2
2010,37,TN,467,293,174
2010,37,TX,13507,14002,-495
2010,37,UT,47,50,-3
2010,37,VA,2145,2028,117
2010,37,VI,19,19,0
2010,37,VT,39,40,-1
2010,37,WA,556,690,-134
2010,37,WI,198,152,46
2010,37,WV,254,264,-10
2010,37,WY,19,16,3
2010,38,AK,37,39,-2
2010,38,AL,717,738,-21
2010,38,AR,186,168,18
2010,38,AZ,418,426,-8
2010,38,CA,2370,2455,-85
2010,38,CO,204,206,-2
2010,38,CT,591,549,42
2010,38,DC,289,25,264
2010,38,DE,390,389,1
2010,38,FL,33574,34437,-863
2010,38,GA,1641,1630,11
2010,38,GU,5,5,0
2010,38,HI,1235,1238,-3
2010,38,IA,162,156,6
2010,38,ID,75,74,1
2010,38,IL,478,422,56
2010,38,IN,282,284,-2
2010,38,KS,139,164,-25
2010,38,KY,273,233,40
2010,38,LA,7969,8012,-43
2010,38,MA,759,758,1
2010,38,MD,858,808,50
2010,38,ME,129,133,-4
2010,38,MI,269,332,-63
2010,38,MN,109,117,-8
2010,38,MO,206,209,-3
2010,38,MS,1069,1106,-37
2010,38,MT,56,56,0
2010,38,NC,2440,2400,40
2010,38,ND,63,63,0
2010,38,NE,69,70,-1
2010,38,NH,160,158,2
2010,38,NJ,3610,3634,-24
2010,38,NM,159,160,-1
2010,38,NV,177,178,-1
2010,38,NY,3559,3574,-15
2010,38,OH,461,460,1
2010,38,OK,243,224,19
2010,38,OR,543,334,209
2010,38,PA,920,946,-26
2010,38,PR,316,250,66
2010,38,RI,352,349,3
2010,38,SC,3809,3719,90
2010,38,SD,84,85,-1
2010,38,TN,742,414,328
2010,38,TX,12823,13344,-521
2010,38,UT,49,48,1
2010,38,VA,2119,2091,28
2010,38,VI,21,21,0
2010,38,VT,32,36,-4
2010,38,WA,778,914,-136
2010,38,WI,194,158,36
2010,38,WV,221,222,-1
2010,38,WY,25,24,1
2010,39,AK,45,48,-3
2010,39,AL,1029,982,47
2010,39,AR,193,186,7
2010,39,AZ,395,417,-22
2010,39,CA,2834,3064,-230
2010,39,CO,204,206,-2
2010,39,CT,601,570,31
2010,39,DC,42,24,18
2010,39,DE,493,489,4
2010,39,FL,46200,47651,-1451
2010,39,GA,2171,2140,31
2010,39,GU,1,1,0
2010,39,HI,2338,2344,-6
2010,39,IA,321,303,18
2010,39,ID,48,53,-5
2010,39,IL,477,457,20
2010,39,IN,370,399,-29
2010,39,KS,145,146,-1
2010,39,KY,347,298,49
2010,39,LA,9466,9595,-129
2010,39,MA,990,924,66
2010,39,MD,1402,1340,62
2010,39,ME,173,155,18
2010,39,MI,187,209,-22
2010,39,MN,154,153,1
2010,39,MO,294,288,6
2010,39,MS,1128,1176,-48
2010,39,MT,63,57,6
2010,39,NC,3128,3083,45
2010,39,ND,53,54,-1
2010,39,NE,113,102,11
2010,39,NH,132,119,13
2010,39,NJ,4057,4006,51
2010,39,NM,150,160,-10
2010,39,NV,152,172,-20
2010,39,NY,4392,4393,-1
2010,39,OH,485,527,-42
2010,39,OK,269,243,26
2010,39,OR,717,491,226
2010,39,PA,990,1005,-15
2010,39,PR,175,281,-106
2010,39,RI,307,268,39
2010,39,SC,5274,5207,67
2010,39,SD,75,71,4
2010,39,TN,553,390,163
2010,39,TX,14786,15223,-437
2010,39,UT,67,60,7
2010,39,VA,3254,3011,243
2010,39,VI,12,13,-1
2010,39,VT,32,33,-1
2010,39,WA,1038,1347,-309
2010,39,WI,211,179,32
2010,39,WV,222,245,-23
2010,39,WY,23,22,1
2010,40,AK,31,33,-2
2010,40,AL,704,713,-9
2010,40,AR,148,145,3
2010,40,AZ,287,282,5
2010,40,CA,2808,2962,-154
2010,40,CO,161,159,2
2010,40,CT,471,416,55
2010,40,DC,22,20,2
2010,40,DE,353,366,-13
2010,40,FL,28602,30035,-1433
2010,40,GA,1603,1654,-51
2010,40,HI,1075,653,422
2010,40,IA,121,126,-5
2010,40,ID,54,53,1
2010,40,IL,362,435,-73
2010,40,IN,246,254,-8
2010,40,KS,93,92,1
2010,40,KY,213,207,6
2010,40,LA,5956,6001,-45
2010,40,MA,793,760,33
2010,40,MD,834,858,-24
2010,40,ME,128,118,10
2010,40,MI,123,124,-1
2010,40,MN,122,108,14
2010,40,MO,220,211,9
2010,40,MS,899,963,-64
2010,40,MT,34,36,-2
2010,40,NC,2212,2287,-75
2010,40,ND,38,40,-2
2010,40,NE,64,63,1
2010,40,NH,80,79,1
2010,40,NJ,2592,2732,-140
2010,40,NM,124,136,-12
2010,40,NV,123,141,-18
2010,40,NY,3124,3279,-155
2010,40,OH,459,467,-8
2010,40,OK,222,193,29
2010,40,OR,391,369,22
2010,40,PA,903,937,-34
2010,40,PR,793,791,2
2010,40,RI,212,202,10
2010,40,SC,2845,2977,-132
2010,40,SD,44,46,-2
2010,40,TN,370,271,99
2010,40,TX,10441,10839,-398
2010,40,UT,63,64,-1
2010,40,VA,1930,1967,-37
2010,40,VI,14,16,-2
2010,40,VT,29,25,4
2010,40,WA,759,1092,-333
2010,40,WI,131,217,-86
2010,40,WV,240,265,-25
2010,40,WY,23,28,-5
2010,41,AK,22,25,-3
2010,41,AL,621,647,-26
2010,41,AR,155,160,-5
2010,41,AZ,354,386,-32
2010,41,CA,3367,3590,-223
2010,41,CO,198,198,0
2010,41,CT,531,491,40
2010,41,DC,31,25,6
2010,41,DE,369,376,-7
2010,41,FL,29436,30745,-1309
2010,41,GA,1454,1469,-15
2010,41,HI,320,299,21
2010,41,IA,132,125,7
2010,41,ID,63,73,-10
2010,41,IL,428,429,-1
2010,41,IN,269,274,-5
2010,41,KS,130,128,2
2010,41,KY,234,219,15
2010,41,LA,6627,6814,-187
2010,41,MA,822,809,13
2010,41,MD,969,969,0
2010,41,ME,166,165,1
2010,41,MI,163,167,-4
2010,41,MN,120,118,2
2010,41,MO,217,224,-7
2010,41,MS,894,950,-56
2010,41,MT,41,39,2
2010,41,NC,2270,2318,-48
2010,41,ND,51,58,-7
2010,41,NE,62,67,-5
2010,41,NH,80,78,2
2010,41,NJ,2794,2854,-60
2010,41,NM,129,125,4
2010,41,NV,160,172,-12
2010,41,NY,3143,3038,105
2010,41,OH,386,405,-19
2010,41,OK,221,212,9
2010,41,OR,470,453,17
2010,41,PA,832,880,-48
2010,41,PR,332,343,-11
2010,41,RI,252,247,5
2010,41,SC,2663,2674,-11
2010,41,SD,40,38,2
2010,41,TN,463,346,117
2010,41,TX,10659,10837,-178
2010,41,UT,46,53,-7
2010,41,VA,2122,2132,-10
2010,41,VI,75,77,-2
2010,41,VT,36,35,1
2010,41,WA,1421,2095,-674
2010,41,WI,157,237,-80
2010,41,WV,212,209,3
2010,41,WY,23,22,1
2010,42,AK,34,23,11
2010,42,AL,568,596,-28
2010,42,AR,193,181,12
2010,42,AZ,419,451,-32
2010,42,CA,4023,4198,-175
2010,42,CO,169,174,-5
2010,42,CT,415,406,9
2010,42,DC,28,22,6
2010,42,DE,357,376,-19
2010,42,FL,29219,30179,-960
2010,42,GA,2026,2327,-301
2010,42,GU,3,4,-1
2010,42,HI,827,812,15
2010,42,IA,195,190,5
2010,42,ID,74,78,-4
2010,42,IL,424,426,-2
2010,42,IN,293,303,-10
2010,42,KS,141,137,4
2010,42,KY,231,222,9
2010,42,LA,6492,6692,-200
2010,42,MA,731,715,16
2010,42,MD,798,790,8
2010,42,ME,186,184,2
2010,42,MI,170,184,-14
2010,42,MN,121,97,24
2010,42,MO,241,240,1
2010,42,MS,925,971,-46
2010,42,MT,40,38,2
2010,42,NC,1965,1995,-30
2010,42,ND,51,39,12
2010,42,NE,74,76,-2
2010,42,NH,75,77,-2
2010,42,NJ,2765,2822,-57
2010,42,NM,138,144,-6
2010,42,NV,128,463,-335
2010,42,NY,2682,2773,-91
2010,42,OH,398,394,4
2010,42,OK,235,223,12
2010,42,OR,466,441,25
2010,42,PA,956,987,-31
2010,42,PR,253,279,-26
2010,42,RI,194,189,5
2010,42,SC,2823,2853,-30
2010,42,SD,45,46,-1
2010,42,TN,553,484,69
2010,42,TX,11583,11951,-368
2010,42,UT,53,39,14
2010,42,VA,2145,2192,-47
2010,42,VI,11,10,1
2010,42,VT,38,41,-3
2010,42,WA,1419,2093,-674
2010,42,WI,152,131,21
2010,42,WV,229,234,-5
2010,42,WY,22,19,3
2010,43,AK,32,30,2
2010,43,AL,806,799,7
2010,43,AR,164,154,10
2010,43,AZ,722,728,-6
2010,43,CA,4334,4548,-214
2010,43,CO,181,199,-18
2010,43,CT,507,519,-12
2010,43,DC,33,29,4
2010,43,DE,547,551,-4
2010,43,FL,33664,34683,-1019
2010,43,GA,2202,2548,-346
2010,43,GU,1,1,0
2010,43,HI,759,792,-33
2010,43,IA,129,128,1
2010,43,ID,65,68,-3
2010,43,IL,530,536,-6
2010,43,IN,318,326,-8
2010,43,KS,132,139,-7
2010,43,KY,259,252,7
2010,43,LA,7259,7458,-199
2010,43,MA,828,750,78
2010,43,MD,881,865,16
2010,43,ME,136,115,21
2010,43,MI,235,269,-34
2010,43,MN,126,95,31
2010,43,MO,260,259,1
2010,43,MS,1031,1079,-48
2010,43,MT,57,53,4
2010,43,NC,2161,2116,45
2010,43,ND,49,48,1
2010,43,NE,91,78,13
2010,43,NH,96,87,9
2010,43,NJ,2867,2939,-72
2010,43,NM,128,146,-18
2010,43,NV,147,165,-18
2010,43,NY,2445,2458,-13
2010,43,OH,432,436,-4
2010,43,OK,237,244,-7
2010,43,OR,496,454,42
2010,43,PA,958,958,0
2010,43,PR,179,192,-13
2010,43,RI,242,247,-5
2010,43,SC,2872,2848,24
2010,43,SD,78,74,4
2010,43,TN,480,384,96
2010,43,TX,12420,12976,-556
2010,43,UT,60,54,6
2010,43,VA,1971,1970,1
2010,43,VI,15,15,0
2010,43,VT,35,32,3
2010,43,WA,1619,2592,-973
2010,43,WI,187,154,33
2010,43,WV,203,198,5
2010,43,WY,29,31,-2
2010,44,AK,28,24,4
2010,44,AL,801,835,-34
2010,44,AR,163,161,2
2010,44,AZ,312,322,-10
2010,44,CA,4437,4824,-387
2010,44,CO,211,210,1
2010,44,CT,509,496,13
2010,44,DC,17,20,-3
2010,44,DE,316,321,-5
2010,44,FL,30673,31815,-1142
2010,44,GA,1935,2103,-168
2010,44,HI,2272,2275,-3
2010,44,IA,108,112,-4
2010,44,ID,66,66,0
2010,44,IL,451,442,9
2010,44,IN,290,303,-13
2010,44,KS,125,129,-4
2010,44,KY,230,236,-6
2010,44,LA,6476,6665,-189
2010,44,MA,652,666,-14
2010,44,MD,783,764,19
2010,44,ME,117,119,-2
2010,44,MI,161,161,0
2010,44,MN,113,111,2
2010,44,MO,267,252,15
2010,44,MS,929,959,-30
2010,44,MT,53,50,3
2010,44,NC,1911,1934,-23
2010,44,ND,85,80,5
2010,44,NE,74,76,-2
2010,44,NH,144,142,2
2010,44,NJ,2755,2771,-16
2010,44,NM,104,104,0
2010,44,NV,185,227,-42
2010,44,NY,2571,2589,-18
2010,44,OH,352,354,-2
2010,44,OK,219,220,-1
2010,44,OR,577,523,54
2010,44,PA,869,876,-7
2010,44,PR,219,423,-204
2010,44,RI,203,191,12
2010,44,SC,3060,3084,-24
2010,44,SD,44,44,0
2010,44,TN,399,308,91
2010,44,TX,10622,10973,-351
2010,44,UT,42,44,-2
2010,44,VA,1606,1564,42
2010,44,VI,17,10,7
2010,44,VT,41,37,4
2010,44,WA,1493,2390,-897
2010,44,WI,174,162,12
2010,44,WV,228,233,-5
2010,44,WY,30,31,-1
2010,45,AK,16,20,-4
2010,45,AL,719,736,-17
2010,45,AR,162,161,1
2010,45,AZ,255,269,-14
2010,45,CA,4647,5143,-496
2010,45,CO,142,178,-36
2010,45,CT,437,423,14
2010,45,DC,20,18,2
2010,45,DE,255,248,7
2010,45,FL,22265,22988,-723
2010,45,GA,1444,1631,-187
2010,45,HI,696,633,63
2010,45,IA,122,124,-2
2010,45,ID,67,73,-6
2010,45,IL,347,333,14
2010,45,IN,283,290,-7
2010,45,KS,90,93,-3
2010,45,KY,200,203,-3
2010,45,LA,4941,5109,-168
2010,45,MA,541,547,-6
2010,45,MD,612,631,-19
2010,45,ME,127,118,9
2010,45,MI,150,148,2
2010,45,MN,94,89,5
2010,45,MO,263,271,-8
2010,45,MS,916,974,-58
2010,45,MT,31,36,-5
2010,45,NC,1828,1826,2
2010,45,ND,37,39,-2
2010,45,NE,59,50,9
2010,45,NH,76,78,-2
2010,45,NJ,2899,2942,-43
2010,45,NM,97,97,0
2010,45,NV,134,153,-19
2010,45,NY,2006,2051,-45
2010,45,OH,437,462,-25
2010,45,OK,176,158,18
2010,45,OR,492,458,34
2010,45,PA,751,776,-25
2010,45,PR,98,123,-25
2010,45,RI,165,173,-8
2010,45,SC,2172,2218,-46
2010,45,SD,37,41,-4
2010,45,TN,321,300,21
2010,45,TX,7461,7857,-396
2010,45,UN,1,0,1
2010,45,UT,37,36,1
2010,45,VA,1450,1476,-26
2010,45,VI,16,16,0
2010,45,VT,27,32,-5
2010,45,WA,1418,2142,-724
2010,45,WI,122,108,14
2010,45,WV,179,187,-8
2010,45,WY,21,18,3
2010,46,AK,19,19,0
2010,46,AL,558,576,-18
2010,46,AR,146,157,-11
2010,46,AZ,306,322,-16
2010,46,CA,5276,6089,-813
2010,46,CO,254,251,3
2010,46,CT,416,427,-11
2010,46,DC,20,16,4
2010,46,DE,302,304,-2
2010,46,FL,28542,29627,-1085
2010,46,GA,1368,1547,-179
2010,46,GU,1,1,0
2010,46,HI,994,530,464
2010,46,IA,101,104,-3
2010,46,ID,51,58,-7
2010,46,IL,426,431,-5
2010,46,IN,265,274,-9
2010,46,KS,132,134,-2
2010,46,KY,207,197,10
2010,46,LA,5843,6075,-232
2010,46,MA,739,699,40
2010,46,MD,944,953,-9
2010,46,ME,143,146,-3
2010,46,MI,134,150,-16
2010,46,MN,74,64,10
2010,46,MO,205,208,-3
2010,46,MS,1136,1188,-52
2010,46,MT,34,37,-3
2010,46,NC,2092,2109,-17
2010,46,ND,43,44,-1
2010,46,NE,77,75,2
2010,46,NH,75,70,5
2010,46,NJ,2940,3003,-63
2010,46,NM,129,121,8
2010,46,NV,154,165,-11
2010,46,NY,2177,2228,-51
2010,46,OH,367,394,-27
2010,46,OK,200,184,16
2010,46,OR,588,519,69
2010,46,PA,842,867,-25
2010,46,PR,946,960,-14
2010,46,RI,180,195,-15
2010,46,SC,2728,2696,32
2010,46,SD,44,40,4
2010,46,TN,393,325,68
2010,46,TX,8508,8900,-392
2010,46,UT,51,48,3
2010,46,VA,1518,1561,-43
2010,46,VI,23,20,3
2010,46,VT,45,45,0
2010,46,WA,1556,2241,-685
2010,46,WI,128,130,-2
2010,46,WV,279,289,-10
2010,46,WY,21,24,-3
2010,47,AK,28,29,-1
2010,47,AL,482,488,-6
2010,47,AR,140,142,-2
2010,47,AZ,250,263,-13
2010,47,CA,3999,4261,-262
2010,47,CO,124,121,3
2010,47,CT,598,596,2
2010,47,DC,13,12,1
2010,47,DE,256,264,-8
2010,47,FL,22702,23365,-663
2010,47,GA,1068,1109,-41
2010,47,HI,1038,1032,6
2010,47,IA,107,105,2
2010,47,ID,56,60,-4
2010,47,IL,366,349,17
2010,47,IN,235,228,7
2010,47,KS,107,99,8
2010,47,KY,214,211,3
2010,47,LA,5026,5190,-164
2010,47,MA,571,579,-8
2010,47,MD,873,873,0
2010,47,ME,123,115,8
2010,47,MI,130,136,-6
2010,47,MN,103,97,6
2010,47,MO,251,253,-2
2010,47,MS,833,857,-24
2010,47,MT,31,32,-1
2010,47,NC,1509,1522,-13
2010,47,ND,46,42,4
2010,47,NE,60,61,-1
2010,47,NH,79,83,-4
2010,47,NJ,2252,2288,-36
2010,47,NM,76,78,-2
2010,47,NV,137,145,-8
2010,47,NY,2053,2134,-81
2010,47,OH,498,511,-13
2010,47,OK,146,155,-9
2010,47,OR,544,481,63
2010,47,PA,688,725,-37
2010,47,PR,244,250,-6
2010,47,RI,190,196,-6
2010,47,SC,1940,1959,-19
2010,47,SD,35,31,4
2010,47,TN,299,239,60
2010,47,TX,6937,7219,-282
2010,47,UT,46,47,-1
2010,47,VA,1359,1345,14
2010,47,VI,9,10,-1
2010,47,VT,42,42,0
2010,47,WA,1114,1561,-447
2010,47,WI,114,114,0
2010,47,WV,171,188,-17
2010,47,WY,18,18,0
2010,48,AK,29,31,-2
2010,48,AL,900,899,1
2010,48,AR,150,157,-7
2010,48,AZ,335,360,-25
2010,48,CA,5149,6029,-880
2010,48,CO,155,144,11
2010,48,CT,783,785,-2
2010,48,DC,22,21,1
2010,48,DE,335,327,8
2010,48,FL,30090,31334,-1244
2010,48,GA,1324,1353,-29
2010,48,GU,2,2,0
2010,48,HI,1059,1032,27
2010,48,IA,109,96,13
2010,48,ID,55,59,-4
2010,48,IL,433,437,-4
2010,48,IN,264,268,-4
2010,48,KS,90,97,-7
2010,48,KY,193,200,-7
2010,48,LA,6211,6480,-269
2010,48,MA,633,626,7
2010,48,MD,863,833,30
2010,48,ME,114,112,2
2010,48,MI,350,334,16
2010,48,MN,106,87,19
2010,48,MO,218,214,4
2010,48,MS,1115,1142,-27
2010,48,MT,43,38,5
2010,48,NC,1659,1698,-39
2010,48,ND,35,43,-8
2010,48,NE,81,77,4
2010,48,NH,189,191,-2
2010,48,NJ,2504,2534,-30
2010,48,NM,132,111,21
2010,48,NV,102,124,-22
2010,48,NY,2139,2194,-55
2010,48,OH,386,393,-7
2010,48,OK,150,150,0
2010,48,OR,610,543,67
2010,48,PA,811,836,-25
2010,48,PR,130,151,-21
2010,48,RI,175,180,-5
2010,48,SC,2562,2648,-86
2010,48,SD,50,52,-2
2010,48,TN,360,288,72
2010,48,TX,8700,8941,-241
2010,48,UT,45,53,-8
2010,48,VA,1852,1838,14
2010,48,VI,45,48,-3
2010,48,VT,29,32,-3
2010,48,WA,1272,1397,-125
2010,48,WI,120,115,5
2010,48,WV,189,203,-14
2010,48,WY,14,14,0
2010,49,AK,23,25,-2
2010,49,AL,1673,1661,12
2010,49,AR,136,137,-1
2010,49,AZ,341,340,1
2010,49,CA,4491,5006,-515
2010,49,CO,130,127,3
2010,49,CT,336,330,6
2010,49,DC,23,16,7
2010,49,DE,291,298,-7
2010,49,FL,22040,22795,-755
2010,49,GA,1079,1128,-49
2010,49,HI,562,574,-12
2010,49,IA,83,84,-1
2010,49,ID,61,63,-2
2010,49,IL,383,383,0
2010,49,IN,190,190,0
2010,49,KS,99,98,1
2010,49,KY,197,187,10
2010,49,LA,4618,4753,-135
2010,49,MA,501,485,16
2010,49,MD,808,795,13
2010,49,ME,107,102,5
2010,49,MI,124,128,-4
2010,49,MN,87,80,7
2010,49,MO,173,172,1
2010,49,MS,953,967,-14
2010,49,MT,48,46,2
2010,49,NC,1468,1478,-10
2010,49,ND,51,46,5
2010,49,NE,65,66,-1
2010,49,NH,77,76,1
2010,49,NJ,2132,2118,14
2010,49,NM,110,94,16
2010,49,NV,113,132,-19
2010,49,NY,1877,1902,-25
2010,49,OH,295,306,-11
2010,49,OK,120,113,7
2010,49,OR,503,468,35
2010,49,PA,710,722,-12
2010,49,PR,230,142,88
2010,49,RI,204,206,-2
2010,49,SC,1892,1895,-3
2010,49,SD,53,43,10
2010,49,TN,323,268,55
2010,49,TX,5855,6112,-257
2010,49,UT,37,42,-5
2010,49,VA,1117,1141,-24
2010,49,VI,8,7,1
2010,49,VT,16,18,-2
2010,49,WA,997,1190,-193
2010,49,WI,102,93,9
2010,49,WV,158,167,-9
2010,49,WY,17,17,0
2010,50,AK,24,24,0
2010,50,AL,669,699,-30
2010,50,AR,150,142,8
2010,50,AZ,243,267,-24
2010,50,CA,4734,5242,-508
2010,50,CO,184,168,16
2010,50,CT,533,544,-11
2010,50,DC,21,16,5
2010,50,DE,302,296,6
2010,50,FL,25753,26455,-702
2010,50,GA,1130,1192,-62
2010,50,GU,2,1,1
2010,50,HI,1202,1213,-11
2010,50,IA,114,97,17
2010,50,ID,55,53,2
2010,50,IL,327,318,9
2010,50,IN,209,212,-3
2010,50,KS,96,92,4
2010,50,KY,216,210,6
2010,50,LA,5469,5568,-99
2010,50,MA,587,574,13
2010,50,MD,945,947,-2
2010,50,ME,118,110,8
2010,50,MI,182,181,1
2010,50,MN,70,69,1
2010,50,MO,194,187,7
2010,50,MS,794,836,-42
2010,50,MT,35,37,-2
2010,50,NC,1639,1668,-29
2010,50,ND,74,76,-2
2010,50,NE,76,79,-3
2010,50,NH,77,87,-10
2010,50,NJ,3004,3034,-30
2010,50,NM,151,105,46
2010,50,NV,140,147,-7
2010,50,NY,2040,2109,-69
2010,50,OH,474,468,6
2010,50,OK,131,131,0
2010,50,OR,532,521,11
2010,50,PA,705,735,-30
2010,50,PR,217,276,-59
2010,50,RI,139,132,7
2010,50,SC,2336,2360,-24
2010,50,SD,76,73,3
2010,50,TN,306,267,39
2010,50,TX,6753,7022,-269
2010,50,UT,34,33,1
2010,50,VA,1351,1393,-42
2010,50,VI,103,103,0
2010,50,VT,36,35,1
2010,50,WA,872,910,-38
2010,50,WI,115,107,8
2010,50,WV,159,170,-11
2010,50,WY,24,24,0
2010,51,AK,27,28,-1
2010,51,AL,566,580,-14
2010,51,AR,117,125,-8
2010,51,AZ,237,242,-5
2010,51,CA,3709,4239,-530
2010,51,CO,207,224,-17
2010,51,CT,258,270,-12
2010,51,DC,18,18,0
2010,51,DE,220,232,-12
2010,51,FL,21699,22542,-843
2010,51,GA,921,971,-50
2010,51,GU,1,1,0
2010,51,HI,1167,1175,-8
2010,51,IA,93,85,8
2010,51,ID,145,144,1
2010,51,IL,340,341,-1
2010,51,IN,216,208,8
2010,51,KS,69,77,-8
2010,51,KY,213,219,-6
2010,51,LA,4229,4272,-43
2010,51,MA,517,515,2
2010,51,MD,613,604,9
2010,51,ME,96,96,0
2010,51,MI,118,139,-21
2010,51,MN,82,78,4
2010,51,MO,163,167,-4
2010,51,MS,841,893,-52
2010,51,MT,29,30,-1
2010,51,NC,1349,1360,-11
2010,51,ND,47,47,0
2010,51,NE,86,75,11
2010,51,NH,68,68,0
2010,51,NJ,2342,2408,-66
2010,51,NM,97,86,11
2010,51,NV,96,102,-6
2010,51,NY,1587,1651,-64
2010,51,OH,261,265,-4
2010,51,OK,119,122,-3
2010,51,OR,426,408,18
2010,51,PA,608,627,-19
2010,51,PR,178,150,28
2010,51,RI,116,114,2
2010,51,SC,1710,1724,-14
2010,51,SD,52,28,24
2010,51,TN,392,394,-2
2010,51,TX,5761,6007,-246
2010,51,UT,41,34,7
2010,51,VA,1159,1151,8
2010,51,VI,5,4,1
2010,51,VT,27,30,-3
2010,51,WA,736,816,-80
2010,51,WI,86,85,1
2010,51,WV,159,166,-7
2010,51,WY,19,24,-5
2010,52,AK,17,15,2
2010,52,AL,541,530,11
2010,52,AR,104,105,-1
2010,52,AZ,210,216,-6
2010,52,CA,3086,3509,-423
2010,52,CO,155,163,-8
2010,52,CT,309,316,-7
2010,52,DC,14,8,6
2010,52,DE,170,176,-6
2010,52,FL,26831,27667,-836
2010,52,GA,810,799,11
2010,52,GU,1,0,1
2010,52,HI,599,606,-7
2010,52,IA,59,56,3
2010,52,ID,50,55,-5
2010,52,IL,226,227,-1
2010,52,IN,179,176,3
2010,52,KS,51,50,1
2010,52,KY,141,136,5
2010,52,LA,4816,4854,-38
2010,52,MA,451,418,33
2010,52,MD,849,867,-18
2010,52,ME,78,76,2
2010,52,MI,108,113,-5
2010,52,MN,55,54,1
2010,52,MO,155,142,13
2010,52,MS,668,731,-63
2010,52,MT,29,23,6
2010,52,NC,1121,1140,-19
2010,52,ND,44,47,-3
2010,52,NE,130,134,-4
2010,52,NH,57,59,-2
2010,52,NJ,1597,1616,-19
2010,52,NM,80,76,4
2010,52,NV,91,96,-5
2010,52,NY,1255,1305,-50
2010,52,OH,237,229,8
2010,52,OK,99,100,-1
2010,52,OR,371,359,12
2010,52,PA,514,523,-9
2010,52,PR,207,227,-20
2010,52,RI,96,102,-6
2010,52,SC,2033,2014,19
2010,52,SD,38,42,-4
2010,52,TN,241,211,30
2010,52,TX,5129,5437,-308
2010,52,UN,1,1,0
2010,52,UT,38,36,2
2010,52,VA,930,943,-13
2010,52,VI,41,39,2
2010,52,VT,19,17,2
2010,52,WA,481,481,0
2010,52,WI,69,88,-19
2010,52,WV,123,128,-5
2010,52,WY,23,22,1
2011,0,AK,3,3,0
2011,0,AL,75,74,1
2011,0,AR,10,5,5
2011,0,AZ,55,54,1
2011,0,CA,1439,1237,202
2011,0,CO,28,27,1
2011,0,CT,43,35,8
2011,0,DC,1,0,1
2011,0,DE,118,118,0
2011,0,FL,13406,13470,-64
2011,0,GA,118,120,-2
2011,0,HI,140,141,-1
2011,0,IA,25,20,5
2011,0,ID,15,14,1
2011,0,IL,65,61,4
2011,0,IN,36,37,-1
2011,0,KS,9,7,2
2011,0,KY,33,29,4
2011,0,LA,935,915,20
2011,0,MA,78,85,-7
2011,0,MD,104,90,14
2011,0,ME,12,13,-1
2011,0,MI,19,22,-3
2011,0,MN,14,15,-1
2011,0,MO,30,30,0
2011,0,MS,136,123,13
2011,0,MT,5,4,1
2011,0,NC,350,344,6
2011,0,ND,9,9,0
2011,0,NE,15,13,2
2011,0,NH,10,9,1
2011,0,NJ,304,289,15
2011,0,NM,23,13,10
2011,0,NV,19,18,1
2011,0,NY,280,273,7
2011,0,OH,46,45,1
2011,0,OK,13,9,4
2011,0,OR,86,61,25
2011,0,PA,122,120,2
2011,0,PR,9,9,0
2011,0,RI,78,78,0
2011,0,SC,469,452,17
2011,0,SD,21,21,0
2011,0,TN,49,42,7
2011,0,TX,847,900,-53
2011,0,UT,4,12,-8
2011,0,VA,248,249,-1
2011,0,VI,2,2,0
2011,0,VT,3,3,0
2011,0,WA,97,112,-15
2011,0,WI,90,89,1
2011,0,WV,19,19,0
2011,0,WY,1,1,0
2011,1,AK,16,14,2
2011,1,AL,364,348,16
2011,1,AR,94,99,-5
2011,1,AZ,226,209,17
2011,1,CA,5132,5548,-416
2011,1,CO,151,139,12
2011,1,CT,510,460,50
2011,1,DC,23,19,4
2011,1,DE,465,475,-10
2011,1,FL,20724,21107,-383
2011,1,GA,858,903,-45
2011,1,GU,1,1,0
2011,1,HI,332,337,-5
2011,1,IA,95,92,3
2011,1,ID,55,55,0
2011,1,IL,571,578,-7
2011,1,IN,164,159,5
2011,1,KS,111,80,31
2011,1,KY,157,140,17
2011,1,LA,3985,3938,47
2011,1,MA,476,471,5
2011,1,MD,600,606,-6
2011,1,ME,94,87,7
2011,1,MI,130,158,-28
2011,1,MN,62,54,8
2011,1,MO,167,180,-13
2011,1,MS,798,817,-19
2011,1,MT,31,29,2
2011,1,NC,1379,1373,6
2011,1,ND,37,29,8
2011,1,NE,79,59,20
2011,1,NH,87,87,0
2011,1,NJ,1952,1944,8
2011,1,NM,111,73,38
2011,1,NV,140,143,-3
2011,1,NY,1589,1590,-1
2011,1,OH,282,277,5
2011,1,OK,113,103,10
2011,1,OR,518,495,23
2011,1,PA,585,593,-8
2011,1,PR,161,166,-5
2011,1,RI,121,115,6
2011,1,SC,1620,1591,29
2011,1,SD,40,33,7
2011,1,TN,339,302,37
2011,1,TX,5267,5331,-64
2011,1,UT,32,36,-4
2011,1,VA,949,965,-16
2011,1,VI,11,10,1
2011,1,VT,32,33,-1
2011,1,WA,577,546,31
2011,1,WI,106,94,12
2011,1,WV,193,197,-4
2011,1,WY,12,13,-1
2011,2,AK,45,45,0
2011,2,AL,519,526,-7
2011,2,AR,95,99,-4
2011,2,AZ,217,226,-9
2011,2,CA,3450,3800,-350
2011,2,CO,181,170,11
2011,2,CT,359,377,-18
2011,2,DC,12,15,-3
2011,2,DE,224,234,-10
2011,2,FL,24222,24403,-181
2011,2,GA,957,971,-14
2011,2,GU,2,2,0
2011,2,HI,758,752,6
2011,2,IA,104,94,10
2011,2,ID,47,44,3
2011,2,IL,364,407,-43
2011,2,IN,188,188,0
2011,2,KS,86,78,8
2011,2,KY,165,160,5
2011,2,LA,4783,4856,-73
2011,2,MA,417,416,1
2011,2,MD,597,606,-9
2011,2,ME,99,100,-1
2011,2,MI,130,176,-46
2011,2,MN,89,87,2
2011,2,MO,164,182,-18
2011,2,MS,932,965,-33
2011,2,MT,39,33,6
2011,2,NC,1346,1385,-39
2011,2,ND,31,33,-2
2011,2,NE,84,67,17
2011,2,NH,101,109,-8
2011,2,NJ,2167,2166,1
2011,2,NM,139,80,59
2011,2,NV,140,149,-9
2011,2,NY,1902,1922,-20
2011,2,OH,502,515,-13
2011,2,OK,141,121,20
2011,2,OR,485,433,52
2011,2,PA,683,703,-20
2011,2,PR,75,694,-619
2011,2,RI,301,301,0
2011,2,SC,2232,2234,-2
2011,2,SD,38,45,-7
2011,2,TN,282,259,23
2011,2,TX,5326,5540,-214
2011,2,UT,32,36,-4
2011,2,VA,1103,1118,-15
2011,2,VI,33,33,0
2011,2,VT,34,31,3
2011,2,WA,740,831,-91
2011,2,WI,128,124,4
2011,2,WV,156,152,4
2011,2,WY,18,16,2
2011,3,AK,36,36,0
2011,3,AL,440,414,26
2011,3,AR,107,102,5
2011,3,AZ,253,247,6
2011,3,CA,3573,4006,-433
2011,3,CO,257,269,-12
2011,3,CT,338,342,-4
2011,3,DC,20,14,6
2011,3,DE,358,366,-8
2011,3,FL,22917,23624,-707
2011,3,GA,905,857,48
2011,3,GU,1,2,-1
2011,3,HI,1333,1706,-373
2011,3,IA,71,67,4
2011,3,ID,67,64,3
2011,3,IL,285,275,10
2011,3,IN,176,176,0
2011,3,KS,80,81,-1
2011,3,KY,135,141,-6
2011,3,LA,4504,4487,17
2011,3,MA,499,483,16
2011,3,MD,963,976,-13
2011,3,ME,87,86,1
2011,3,MI,134,178,-44
2011,3,MN,72,70,2
2011,3,MO,175,208,-33
2011,3,MS,800,803,-3
2011,3,MT,44,36,8
2011,3,NC,1684,1711,-27
2011,3,ND,46,45,1
2011,3,NE,63,54,9
2011,3,NH,70,77,-7
2011,3,NJ,1793,1825,-32
2011,3,NM,94,66,28
2011,3,NV,135,147,-12
2011,3,NY,1586,1682,-96
2011,3,OH,234,217,17
2011,3,OK,91,81,10
2011,3,OR,408,359,49
2011,3,PA,721,741,-20
2011,3,PR,125,133,-8
2011,3,RI,110,107,3
2011,3,SC,2061,2041,20
2011,3,SD,47,46,1
2011,3,TN,228,220,8
2011,3,TX,5388,5434,-46
2011,3,UT,36,45,-9
2011,3,VA,1068,1081,-13
2011,3,VI,23,23,0
2011,3,VT,30,26,4
2011,3,WA,580,570,10
2011,3,WI,110,91,19
2011,3,WV,160,165,-5
2011,3,WY,12,11,1
2011,4,AK,17,19,-2
2011,4,AL,380,389,-9
2011,4,AR,118,132,-14
2011,4,AZ,254,233,21
2011,4,CA,3362,3504,-142
2011,4,CO,124,148,-24
2011,4,CT,219,216,3
2011,4,DC,18,16,2
2011,4,DE,205,206,-1
2011,4,FL,24263,24699,-436
2011,4,GA,824,817,7
2011,4,HI,223,238,-15
2011,4,IA,84,85,-1
2011,4,ID,59,50,9
2011,4,IL,381,390,-9
2011,4,IN,165,174,-9
2011,4,KS,76,62,14
2011,4,KY,160,157,3
2011,4,LA,4675,4772,-97
2011,4,MA,415,430,-15
2011,4,MD,564,583,-19
2011,4,ME,78,73,5
2011,4,MI,136,149,-13
2011,4,MN,107,77,30
2011,4,MO,155,165,-10
2011,4,MS,726,784,-58
2011,4,MT,31,28,3
2011,4,NC,1197,1206,-9
2011,4,ND,65,50,15
2011,4,NE,99,68,31
2011,4,NH,61,60,1
2011,4,NJ,1877,1886,-9
2011,4,NM,112,73,39
2011,4,NV,140,152,-12
2011,4,NY,1559,1560,-1
2011,4,OH,267,258,9
2011,4,OK,95,95,0
2011,4,OR,411,408,3
2011,4,PA,665,689,-24
2011,4,PR,491,488,3
2011,4,RI,95,91,4
2011,4,SC,1829,1816,13
2011,4,SD,34,27,7
2011,4,TN,235,202,33
2011,4,TX,5063,5221,-158
2011,4,UT,38,38,0
2011,4,VA,922,927,-5
2011,4,VI,8,9,-1
2011,4,VT,33,31,2
2011,4,WA,468,477,-9
2011,4,WI,73,68,5
2011,4,WV,124,129,-5
2011,4,WY,17,19,-2
2011,5,AK,15,15,0
2011,5,AL,751,722,29
2011,5,AR,162,218,-56
2011,5,AZ,235,207,28
2011,5,CA,3863,3756,107
2011,5,CO,201,192,9
2011,5,CT,368,369,-1
2011,5,DC,9,5,4
2011,5,DE,189,192,-3
2011,5,FL,27104,27925,-821
2011,5,GA,1030,1038,-8
2011,5,HI,1614,1628,-14
2011,5,IA,125,119,6
2011,5,ID,78,82,-4
2011,5,IL,339,343,-4
2011,5,IN,204,200,4
2011,5,KS,119,115,4
2011,5,KY,176,168,8
2011,5,LA,5847,5914,-67
2011,5,MA,494,455,39
2011,5,MD,534,556,-22
2011,5,ME,75,69,6
2011,5,MI,142,147,-5
2011,5,MN,137,91,46
2011,5,MO,217,208,9
2011,5,MS,1079,1162,-83
2011,5,MT,51,49,2
2011,5,NC,1399,1421,-22
2011,5,ND,99,55,44
2011,5,NE,84,79,5
2011,5,NH,89,84,5
2011,5,NJ,2776,2790,-14
2011,5,NM,93,97,-4
2011,5,NV,161,170,-9
2011,5,NY,1694,1750,-56
2011,5,OH,315,312,3
2011,5,OK,120,119,1
2011,5,OR,439,421,18
2011,5,PA,957,965,-8
2011,5,PR,110,118,-8
2011,5,RI,117,111,6
2011,5,SC,1942,1894,48
2011,5,SD,69,56,13
2011,5,TN,288,229,59
2011,5,TX,5553,5751,-198
2011,5,UT,37,29,8
2011,5,VA,944,964,-20
2011,5,VI,15,14,1
2011,5,VT,33,31,2
2011,5,WA,754,737,17
2011,5,WI,110,96,14
2011,5,WV,203,206,-3
2011,5,WY,8,6,2
2011,6,AK,13,19,-6
2011,6,AL,537,531,6
2011,6,AR,206,189,17
2011,6,AZ,291,276,15
2011,6,CA,4532,4490,42
2011,6,CO,143,133,10
2011,6,CT,333,323,10
2011,6,DC,18,15,3
2011,6,DE,200,202,-2
2011,6,FL,22028,22346,-318
2011,6,GA,944,933,11
2011,6,HI,597,681,-84
2011,6,IA,123,127,-4
2011,6,ID,114,123,-9
2011,6,IL,485,483,2
2011,6,IN,238,241,-3
2011,6,KS,91,87,4
2011,6,KY,228,233,-5
2011,6,LA,5139,5174,-35
2011,6,MA,488,474,14
2011,6,MD,507,505,2
2011,6,ME,127,127,0
2011,6,MI,167,157,10
2011,6,MN,172,115,57
2011,6,MO,187,164,23
2011,6,MS,957,983,-26
2011,6,MT,62,52,10
2011,6,NC,1466,1465,1
2011,6,ND,209,138,71
2011,6,NE,114,108,6
2011,6,NH,84,83,1
2011,6,NJ,1796,1776,20
2011,6,NM,104,95,9
2011,6,NV,219,235,-16
2011,6,NY,1600,1570,30
2011,6,OH,388,377,11
2011,6,OK,134,125,9
2011,6,OR,445,448,-3
2011,6,PA,830,870,-40
2011,6,PR,106,104,2
2011,6,RI,134,125,9
2011,6,SC,1802,1807,-5
2011,6,SD,54,44,10
2011,6,TN,256,245,11
2011,6,TX,6073,6099,-26
2011,6,UN,1,1,0
2011,6,UT,115,113,2
2011,6,VA,963,954,9
2011,6,VI,5,3,2
2011,6,VT,24,24,0
2011,6,WA,624,640,-16
2011,6,WI,116,100,16
2011,6,WV,260,279,-19
2011,6,WY,25,22,3
2011,7,AK,24,31,-7
2011,7,AL,958,962,-4
2011,7,AR,144,138,6
2011,7,AZ,261,261,0
2011,7,CA,4108,3948,160
2011,7,CO,194,169,25
2011,7,CT,347,320,27
2011,7,DC,28,16,12
2011,7,DE,266,270,-4
2011,7,FL,25967,26216,-249
2011,7,GA,989,974,15
2011,7,GU,1,1,0
2011,7,HI,387,310,77
2011,7,IA,139,147,-8
2011,7,ID,115,105,10
2011,7,IL,709,709,0
2011,7,IN,224,231,-7
2011,7,KS,98,94,4
2011,7,KY,230,203,27
2011,7,LA,5606,5624,-18
2011,7,MA,429,420,9
2011,7,MD,564,564,0
2011,7,ME,77,79,-2
2011,7,MI,182,167,15
2011,7,MN,276,138,138
2011,7,MO,191,186,5
2011,7,MS,938,945,-7
2011,7,MT,88,63,25
2011,7,NC,1558,1539,19
2011,7,ND,362,192,170
2011,7,NE,130,134,-4
2011,7,NH,70,61,9
2011,7,NJ,1933,1918,15
2011,7,NM,112,84,28
2011,7,NV,195,226,-31
2011,7,NY,1736,1594,142
2011,7,OH,429,404,25
2011,7,OK,131,125,6
2011,7,OR,408,388,20
2011,7,PA,1102,1121,-19
2011,7,PR,84,90,-6
2011,7,RI,112,101,11
2011,7,SC,1761,1923,-162
2011,7,SD,56,53,3
2011,7,TN,268,230,38
2011,7,TX,5931,6146,-215
2011,7,UT,58,52,6
2011,7,VA,1104,1097,7
2011,7,VI,51,53,-2
2011,7,VT,36,40,-4
2011,7,WA,557,545,12
2011,7,WI,144,126,18
2011,7,WV,237,241,-4
2011,7,WY,22,24,-2
2011,8,AK,24,23,1
2011,8,AL,487,480,7
2011,8,AR,174,165,9
2011,8,AZ,281,288,-7
2011,8,CA,3725,3663,62
2011,8,CO,176,179,-3
2011,8,CT,333,298,35
2011,8,DC,15,9,6
2011,8,DE,217,220,-3
2011,8,FL,24614,25093,-479
2011,8,GA,1102,1109,-7
2011,8,GU,1,0,1
2011,8,HI,2074,2074,0
2011,8,IA,197,208,-11
2011,8,ID,77,80,-3
2011,8,IL,452,449,3
2011,8,IN,270,265,5
2011,8,KS,105,100,5
2011,8,KY,234,228,6
2011,8,LA,6434,6428,6
2011,8,MA,441,430,11
2011,8,MD,648,645,3
2011,8,ME,80,78,2
2011,8,MI,203,203,0
2011,8,MN,385,163,222
2011,8,MO,226,217,9
2011,8,MS,1113,1110,3
2011,8,MT,98,67,31
2011,8,NC,1684,1685,-1
2011,8,ND,796,277,519
2011,8,NE,120,116,4
2011,8,NH,87,91,-4
2011,8,NJ,1938,1909,29
2011,8,NM,163,145,18
2011,8,NV,200,199,1
2011,8,NY,1671,1507,164
2011,8,OH,403,384,19
2011,8,OK,143,136,7
2011,8,OR,374,359,15
2011,8,PA,1144,1189,-45
2011,8,PR,124,135,-11
2011,8,RI,133,123,10
2011,8,SC,1964,1953,11
2011,8,SD,126,120,6
2011,8,TN,384,358,26
2011,8,TX,6915,7030,-115
2011,8,UT,70,63,7
2011,8,VA,1113,1106,7
2011,8,VI,7,7,0
2011,8,VT,31,30,1
2011,8,WA,530,522,8
2011,8,WI,114,103,11
2011,8,WV,262,268,-6
2011,8,WY,26,28,-2
2011,9,AK,33,33,0
2011,9,AL,548,559,-11
2011,9,AR,156,149,7
2011,9,AZ,329,335,-6
2011,9,CA,3564,3407,157
2011,9,CO,220,228,-8
2011,9,CT,894,420,474
2011,9,DC,30,17,13
2011,9,DE,254,251,3
2011,9,FL,39512,39416,96
2011,9,GA,1356,1339,17
2011,9,GU,2,1,1
2011,9,HI,1033,1036,-3
2011,9,IA,254,249,5
2011,9,ID,130,132,-2
2011,9,IL,550,557,-7
2011,9,IN,277,275,2
2011,9,KS,119,125,-6
2011,9,KY,239,211,28
2011,9,LA,7324,7528,-204
2011,9,MA,567,473,94
2011,9,MD,1369,1364,5
2011,9,ME,146,137,9
2011,9,MI,283,275,8
2011,9,MN,1228,307,921
2011,9,MO,250,250,0
2011,9,MS,1171,1280,-109
2011,9,MT,127,88,39
2011,9,NC,2192,2199,-7
2011,9,ND,1464,606,858
2011,9,NE,110,109,1
2011,9,NH,76,81,-5
2011,9,NJ,2760,2363,397
2011,9,NM,117,114,3
2011,9,NV,197,223,-26
2011,9,NY,2133,1949,184
2011,9,OH,468,434,34
2011,9,OK,178,165,13
2011,9,OR,470,440,30
2011,9,PA,1134,1150,-16
2011,9,PR,251,153,98
2011,9,RI,394,361,33
2011,9,SC,2732,2720,12
2011,9,SD,135,105,30
2011,9,TN,590,563,27
2011,9,TX,7626,7867,-241
2011,9,UT,86,89,-3
2011,9,VA,1745,1670,75
2011,9,VI,12,11,1
2011,9,VT,44,41,3
2011,9,WA,674,656,18
2011,9,WI,192,156,36
2011,9,WV,257,285,-28
2011,9,WY,29,26,3
2011,10,AK,28,24,4
2011,10,AL,474,488,-14
2011,10,AR,163,157,6
2011,10,AZ,227,230,-3
2011,10,CA,2866,2725,141
2011,10,CO,215,209,6
2011,10,CT,836,298,538
2011,10,DC,15,13,2
2011,10,DE,217,227,-10
2011,10,FL,26873,27377,-504
2011,10,GA,1169,1116,53
2011,10,GU,1,1,0
2011,10,HI,852,848,4
2011,10,IA,331,336,-5
2011,10,ID,161,169,-8
2011,10,IL,663,615,48
2011,10,IN,268,261,7
2011,10,KS,117,119,-2
2011,10,KY,218,225,-7
2011,10,LA,6235,6418,-183
2011,10,MA,560,476,84
2011,10,MD,556,568,-12
2011,10,ME,118,114,4
2011,10,MI,175,173,2
2011,10,MN,1515,514,1001
2011,10,MO,255,227,28
2011,10,MS,1110,1111,-1
2011,10,MT,169,95,74
2011,10,NC,1535,1542,-7
2011,10,ND,1878,964,914
2011,10,NE,103,112,-9
2011,10,NH,128,122,6
2011,10,NJ,2069,2055,14
2011,10,NM,134,108,26
2011,10,NV,235,255,-20
2011,10,NY,1862,1512,350
2011,10,OH,419,394,25
2011,10,OK,167,162,5
2011,10,OR,353,342,11
2011,10,PA,961,953,8
2011,10,PR,84,103,-19
2011,10,RI,130,110,20
2011,10,SC,2052,2038,14
2011,10,SD,195,127,68
2011,10,TN,451,448,3
2011,10,TX,7092,7248,-156
2011,10,UT,61,54,7
2011,10,VA,1385,1394,-9
2011,10,VI,22,19,3
2011,10,VT,54,49,5
2011,10,WA,541,563,-22
2011,10,WI,223,156,67
2011,10,WV,236,256,-20
2011,10,WY,30,26,4
2011,11,AK,33,33,0
2011,11,AL,498,491,7
2011,11,AR,149,145,4
2011,11,AZ,284,292,-8
2011,11,CA,2660,2446,214
2011,11,CO,223,223,0
2011,11,CT,609,306,303
2011,11,DC,19,16,3
2011,11,DE,226,227,-1
2011,11,FL,25154,25736,-582
2011,11,GA,1009,1007,2
2011,11,HI,919,572,347
2011,11,IA,332,360,-28
2011,11,ID,97,96,1
2011,11,IL,444,390,54
2011,11,IN,292,283,9
2011,11,KS,123,117,6
2011,11,KY,237,230,7
2011,11,LA,6320,6484,-164
2011,11,MA,523,437,86
2011,11,MD,932,945,-13
2011,11,ME,116,104,12
2011,11,MI,164,160,4
2011,11,MN,1605,767,838
2011,11,MO,275,250,25
2011,11,MS,1325,1370,-45
2011,11,MT,177,98,79
2011,11,NC,1687,1700,-13
2011,11,ND,2116,1376,740
2011,11,NE,99,107,-8
2011,11,NH,94,83,11
2011,11,NJ,2049,2052,-3
2011,11,NM,135,99,36
2011,11,NV,154,155,-1
2011,11,NY,1619,1407,212
2011,11,OH,471,449,22
2011,11,OK,166,163,3
2011,11,OR,357,328,29
2011,11,PA,921,963,-42
2011,11,PR,76,69,7
2011,11,RI,117,100,17
2011,11,SC,2877,2901,-24
2011,11,SD,260,190,70
2011,11,TN,594,558,36
2011,11,TX,6760,6827,-67
2011,11,UT,63,63,0
2011,11,VA,1143,1123,20
2011,11,VI,41,40,1
2011,11,VT,47,45,2
2011,11,WA,538,547,-9
2011,11,WI,212,309,-97
2011,11,WV,245,248,-3
2011,11,WY,24,25,-1
2011,12,AK,25,28,-3
2011,12,AL,739,741,-2
2011,12,AR,164,158,6
2011,12,AZ,249,247,2
2011,12,CA,3061,2932,129
2011,12,CO,223,230,-7
2011,12,CT,389,287,102
2011,12,DC,16,13,3
2011,12,DE,274,272,2
2011,12,FL,27748,28136,-388
2011,12,GA,1105,1098,7
2011,12,HI,206,190,16
2011,12,IA,447,536,-89
2011,12,ID,155,156,-1
2011,12,IL,646,558,88
2011,12,IN,366,337,29
2011,12,KS,133,127,6
2011,12,KY,270,247,23
2011,12,LA,6922,7077,-155
2011,12,MA,602,572,30
2011,12,MD,830,841,-11
2011,12,ME,107,116,-9
2011,12,MI,220,216,4
2011,12,MN,1958,1061,897
2011,12,MO,341,294,47
2011,12,MS,1325,1365,-40
2011,12,MT,171,133,38
2011,12,NC,1686,1694,-8
2011,12,ND,2304,2068,236
2011,12,NE,108,110,-2
2011,12,NH,96,87,9
2011,12,NJ,1994,2028,-34
2011,12,NM,143,105,38
2011,12,NV,172,181,-9
2011,12,NY,1833,1787,46
2011,12,OH,460,416,44
2011,12,OK,151,149,2
2011,12,OR,324,311,13
2011,12,PA,957,1021,-64
2011,12,PR,167,158,9
2011,12,RI,123,106,17
2011,12,SC,2293,2255,38
2011,12,SD,401,409,-8
2011,12,TN,474,428,46
2011,12,TX,7181,7415,-234
2011,12,UT,78,73,5
2011,12,VA,1673,1663,10
2011,12,VI,306,309,-3
2011,12,VT,40,40,0
2011,12,WA,445,459,-14
2011,12,WI,242,159,83
2011,12,WV,252,267,-15
2011,12,WY,30,31,-1
2011,13,AK,39,34,5
2011,13,AL,944,919,25
2011,13,AR,259,183,76
2011,13,AZ,294,274,20
2011,13,CA,2883,2803,80
2011,13,CO,280,278,2
2011,13,CT,421,361,60
2011,13,DC,19,15,4
2011,13,DE,257,268,-11
2011,13,FL,39014,40028,-1014
2011,13,GA,1421,1358,63
2011,13,GU,1,1,0
2011,13,HI,449,464,-15
2011,13,IA,426,486,-60
2011,13,ID,130,121,9
2011,13,IL,795,717,78
2011,13,IN,337,291,46
2011,13,KS,167,162,5
2011,13,KY,255,218,37
2011,13,LA,8588,8712,-124
2011,13,MA,560,532,28
2011,13,MD,774,796,-22
2011,13,ME,141,143,-2
2011,13,MI,180,179,1
2011,13,MN,1828,694,1134
2011,13,MO,390,368,22
2011,13,MS,1280,1317,-37
2011,13,MT,204,71,133
2011,13,NC,2144,2143,1
2011,13,ND,1495,1293,202
2011,13,NE,120,115,5
2011,13,NH,120,119,1
2011,13,NJ,2473,2452,21
2011,13,NM,145,100,45
2011,13,NV,146,156,-10
2011,13,NY,1794,1781,13
2011,13,OH,512,380,132
2011,13,OK,204,189,15
2011,13,OR,415,384,31
2011,13,PA,1091,1115,-24
2011,13,PR,318,359,-41
2011,13,RI,340,323,17
2011,13,SC,3402,3639,-237
2011,13,SD,379,459,-80
2011,13,TN,539,422,117
2011,13,TX,8879,9042,-163
2011,13,UN,2,0,2
2011,13,UT,82,82,0
2011,13,VA,1361,1354,7
2011,13,VI,13,11,2
2011,13,VT,46,45,1
2011,13,WA,691,690,1
2011,13,WI,313,229,84
2011,13,WV,282,297,-15
2011,13,WY,49,37,12
2011,14,AK,34,35,-1
2011,14,AL,595,566,29
2011,14,AR,172,162,10
2011,14,AZ,223,219,4
2011,14,CA,2733,2620,113
2011,14,CO,258,244,14
2011,14,CT,364,286,78
2011,14,DC,19,15,4
2011,14,DE,240,236,4
2011,14,FL,25854,25989,-135
2011,14,GA,1043,1004,39
2011,14,GU,2,2,0
2011,14,HI,479,477,2
2011,14,IA,572,585,-13
2011,14,ID,114,97,17
2011,14,IL,634,525,109
2011,14,IN,355,265,90
2011,14,KS,154,139,15
2011,14,KY,229,204,25
2011,14,LA,7125,7263,-138
2011,14,MA,419,397,22
2011,14,MD,756,727,29
2011,14,ME,176,169,7
2011,14,MI,177,166,11
2011,14,MN,1955,569,1386
2011,14,MO,416,376,40
2011,14,MS,1308,1340,-32
2011,14,MT,288,97,191
2011,14,NC,1787,1778,9
2011,14,ND,1112,1043,69
2011,14,NE,83,82,1
2011,14,NH,181,183,-2
2011,14,NJ,1994,1958,36
2011,14,NM,132,103,29
2011,14,NV,124,132,-8
2011,14,NY,1717,1651,66
2011,14,OH,479,375,104
2011,14,OK,185,163,22
2011,14,OR,303,281,22
2011,14,PA,815,792,23
2011,14,PR,179,173,6
2011,14,RI,201,186,15
2011,14,SC,2312,2282,30
2011,14,SD,283,267,16
2011,14,TN,690,337,353
2011,14,TX,7640,7647,-7
2011,14,UT,90,87,3
2011,14,VA,1196,1129,67
2011,14,VI,2,2,0
2011,14,VT,42,37,5
2011,14,WA,434,421,13
2011,14,WI,394,209,185
2011,14,WV,251,257,-6
2011,14,WY,59,48,11
2011,15,AK,40,36,4
2011,15,AL,1070,1175,-105
2011,15,AR,181,166,15
2011,15,AZ,267,264,3
2011,15,CA,2520,2265,255
2011,15,CO,274,251,23
2011,15,CT,489,377,112
2011,15,DC,14,16,-2
2011,15,DE,264,263,1
2011,15,FL,36093,36413,-320
2011,15,GA,1186,1151,35
2011,15,GU,2,2,0
2011,15,HI,476,440,36
2011,15,IA,400,371,29
2011,15,ID,98,92,6
2011,15,IL,896,757,139
2011,15,IN,335,286,49
2011,15,KS,174,176,-2
2011,15,KY,265,236,29
2011,15,LA,8233,8138,95
2011,15,MA,580,578,2
2011,15,MD,852,827,25
2011,15,ME,171,162,9
2011,15,MI,180,175,5
2011,15,MN,783,382,401
2011,15,MO,404,386,18
2011,15,MS,1433,1467,-34
2011,15,MT,243,100,143
2011,15,NC,1884,1887,-3
2011,15,ND,909,947,-38
2011,15,NE,137,104,33
2011,15,NH,108,112,-4
2011,15,NJ,2258,2234,24
2011,15,NM,129,102,27
2011,15,NV,152,143,9
2011,15,NY,1863,1831,32
2011,15,OH,469,377,92
2011,15,OK,215,189,26
2011,15,OR,363,285,78
2011,15,PA,927,903,24
2011,15,PR,110,106,4
2011,15,RI,142,129,13
2011,15,SC,2314,2401,-87
2011,15,SD,179,127,52
2011,15,TN,458,346,112
2011,15,TX,8163,8207,-44
2011,15,UT,97,80,17
2011,15,VA,1256,1202,54
2011,15,VI,84,77,7
2011,15,VT,53,39,14
2011,15,WA,550,534,16
2011,15,WI,412,282,130
2011,15,WV,228,225,3
2011,15,WY,76,62,14
2011,16,AK,40,34,6
2011,16,AL,743,769,-26
2011,16,AR,164,164,0
2011,16,AZ,226,234,-8
2011,16,CA,3042,2333,709
2011,16,CO,249,233,16
2011,16,CT,363,346,17
2011,16,DC,17,14,3
2011,16,DE,252,256,-4
2011,16,FL,30453,31056,-603
2011,16,GA,1241,1199,42
2011,16,GU,1,2,-1
2011,16,HI,1185,1136,49
2011,16,IA,420,277,143
2011,16,ID,105,103,2
2011,16,IL,875,655,220
2011,16,IN,331,298,33
2011,16,KS,193,197,-4
2011,16,KY,252,248,4
2011,16,LA,8491,8552,-61
2011,16,MA,554,538,16
2011,16,MD,622,641,-19
2011,16,ME,116,118,-2
2011,16,MI,172,169,3
2011,16,MN,259,168,91
2011,16,MO,423,393,30
2011,16,MS,1528,1546,-18
2011,16,MT,208,106,102
2011,16,NC,1800,1782,18
2011,16,ND,207,209,-2
2011,16,NE,154,108,46
2011,16,NH,98,98,0
2011,16,NJ,2256,2285,-29
2011,16,NM,118,94,24
2011,16,NV,120,132,-12
2011,16,NY,2437,2434,3
2011,16,OH,458,414,44
2011,16,OK,202,201,1
2011,16,OR,362,282,80
2011,16,PA,799,799,0
2011,16,PR,286,285,1
2011,16,RI,140,140,0
2011,16,SC,2536,2494,42
2011,16,SD,91,75,16
2011,16,TN,419,323,96
2011,16,TX,9041,9203,-162
2011,16,UT,133,120,13
2011,16,VA,1244,1185,59
2011,16,VI,21,19,2
2011,16,VT,43,44,-1
2011,16,WA,515,503,12
2011,16,WI,353,297,56
2011,16,WV,208,204,4
2011,16,WY,68,51,17
2011,17,AK,46,42,4
2011,17,AL,1529,1505,24
2011,17,AR,217,202,15
2011,17,AZ,280,282,-2
2011,17,CA,3240,2692,548
2011,17,CO,354,353,1
2011,17,CT,443,450,-7
2011,17,DC,29,27,2
2011,17,DE,299,308,-9
2011,17,FL,44537,45405,-868
2011,17,GA,1588,1569,19
2011,17,GU,2,2,0
2011,17,HI,1558,1512,46
2011,17,IA,303,268,35
2011,17,ID,92,86,6
2011,17,IL,736,697,39
2011,17,IN,338,308,30
2011,17,KS,215,224,-9
2011,17,KY,324,309,15
2011,17,LA,11877,11907,-30
2011,17,MA,652,707,-55
2011,17,MD,779,788,-9
2011,17,ME,183,182,1
2011,17,MI,191,191,0
2011,17,MN,185,174,11
2011,17,MO,521,486,35
2011,17,MS,1654,1644,10
2011,17,MT,177,100,77
2011,17,NC,2445,2440,5
2011,17,ND,122,118,4
2011,17,NE,149,98,51
2011,17,NH,124,120,4
2011,17,NJ,3113,3104,9
2011,17,NM,151,145,6
2011,17,NV,174,161,13
2011,17,NY,2034,2033,1
2011,17,OH,460,435,25
2011,17,OK,248,234,14
2011,17,OR,632,305,327
2011,17,PA,923,953,-30
2011,17,PR,523,564,-41
2011,17,RI,269,272,-3
2011,17,SC,3383,3331,52
2011,17,SD,85,69,16
2011,17,TN,443,395,48
2011,17,TX,11059,11403,-344
2011,17,UT,80,54,26
2011,17,VA,1792,1789,3
2011,17,VI,13,12,1
2011,17,VT,41,39,2
2011,17,WA,514,485,29
2011,17,WI,256,216,40
2011,17,WV,238,235,3
2011,17,WY,66,48,18
2011,18,AK,30,29,1
2011,18,AL,726,738,-12
2011,18,AR,231,192,39
2011,18,AZ,265,237,28
2011,18,CA,2814,2674,140
2011,18,CO,399,374,25
2011,18,CT,348,330,18
2011,18,DC,13,12,1
2011,18,DE,273,278,-5
2011,18,FL,34854,35100,-246
2011,18,GA,1282,1279,3
2011,18,GU,1,1,0
2011,18,HI,1024,1141,-117
2011,18,IA,165,140,25
2011,18,ID,365,169,196
2011,18,IL,595,617,-22
2011,18,IN,267,256,11
2011,18,KS,128,159,-31
2011,18,KY,244,233,11
2011,18,LA,8988,8370,618
2011,18,MA,461,449,12
2011,18,MD,593,585,8
2011,18,ME,111,107,4
2011,18,MI,161,159,2
2011,18,MN,171,168,3
2011,18,MO,318,287,31
2011,18,MS,1638,1530,108
2011,18,MT,171,82,89
2011,18,NC,2146,2092,54
2011,18,ND,56,67,-11
2011,18,NE,146,107,39
2011,18,NH,78,94,-16
2011,18,NJ,2181,2104,77
2011,18,NM,159,139,20
2011,18,NV,124,124,0
2011,18,NY,2033,1942,91
2011,18,OH,404,349,55
2011,18,OK,187,175,12
2011,18,OR,325,330,-5
2011,18,PA,734,737,-3
2011,18,PR,282,275,7
2011,18,RI,251,247,4
2011,18,SC,2653,2595,58
2011,18,SD,77,68,9
2011,18,TN,423,341,82
2011,18,TX,11276,10850,426
2011,18,UN,2,4,-2
2011,18,UT,209,185,24
2011,18,VA,1255,1226,29
2011,18,VI,9,8,1
2011,18,VT,39,38,1
2011,18,WA,516,498,18
2011,18,WI,178,159,19
2011,18,WV,188,189,-1
2011,18,WY,62,36,26
2011,19,AK,37,32,5
2011,19,AL,683,691,-8
2011,19,AR,209,199,10
2011,19,AZ,222,206,16
2011,19,CA,2278,2045,233
2011,19,CO,247,221,26
2011,19,CT,381,367,14
2011,19,DC,13,9,4
2011,19,DE,236,342,-106
2011,19,FL,33292,33589,-297
2011,19,GA,1254,1181,73
2011,19,HI,508,651,-143
2011,19,IA,152,138,14
2011,19,ID,95,81,14
2011,19,IL,420,403,17
2011,19,IN,218,200,18
2011,19,KS,153,148,5
2011,19,KY,226,224,2
2011,19,LA,9450,8075,1375
2011,19,MA,426,416,10
2011,19,MD,604,577,27
2011,19,ME,87,92,-5
2011,19,MI,149,143,6
2011,19,MN,99,104,-5
2011,19,MO,289,262,27
2011,19,MS,1459,1387,72
2011,19,MT,168,71,97
2011,19,NC,1841,1802,39
2011,19,ND,56,64,-8
2011,19,NE,80,65,15
2011,19,NH,67,63,4
2011,19,NJ,2429,2446,-17
2011,19,NM,105,88,17
2011,19,NV,116,107,9
2011,19,NY,1615,1575,40
2011,19,OH,348,317,31
2011,19,OK,189,178,11
2011,19,OR,276,237,39
2011,19,PA,755,770,-15
2011,19,PR,253,257,-4
2011,19,RI,124,116,8
2011,19,SC,2526,2466,60
2011,19,SD,59,52,7
2011,19,TN,398,324,74
2011,19,TX,9431,9418,13
2011,19,UT,147,60,87
2011,19,VA,1598,1574,24
2011,19,VI,15,12,3
2011,19,VT,35,31,4
2011,19,WA,405,398,7
2011,19,WI,166,140,26
2011,19,WV,199,207,-8
2011,19,WY,88,45,43
2011,20,AK,26,23,3
2011,20,AL,1184,1192,-8
2011,20,AR,192,180,12
2011,20,AZ,234,230,4
2011,20,CA,2190,2135,55
2011,20,CO,321,266,55
2011,20,CT,374,371,3
2011,20,DC,16,14,2
2011,20,DE,292,297,-5
2011,20,FL,34337,35768,-1431
2011,20,GA,1393,1354,39
2011,20,GU,1,2,-1
2011,20,HI,834,812,22
2011,20,IA,246,227,19
2011,20,ID,119,108,11
2011,20,IL,558,552,6
2011,20,IN,266,242,24
2011,20,KS,142,141,1
2011,20,KY,252,240,12
2011,20,LA,10293,9575,718
2011,20,MA,516,477,39
2011,20,MD,684,717,-33
2011,20,ME,78,84,-6
2011,20,MI,172,159,13
2011,20,MN,96,95,1
2011,20,MO,270,233,37
2011,20,MS,1717,1713,4
2011,20,MT,309,77,232
2011,20,NC,2396,2378,18
2011,20,ND,83,71,12
2011,20,NE,111,104,7
2011,20,NH,101,104,-3
2011,20,NJ,2620,2674,-54
2011,20,NM,155,137,18
2011,20,NV,133,127,6
2011,20,NY,2112,2022,90
2011,20,OH,348,305,43
2011,20,OK,210,204,6
2011,20,OR,344,316,28
2011,20,PA,690,683,7
2011,20,PR,159,383,-224
2011,20,RI,176,174,2
2011,20,SC,3332,3308,24
2011,20,SD,90,79,11
2011,20,TN,340,281,59
2011,20,TX,11608,11703,-95
2011,20,UN,1,1,0
2011,20,UT,162,54,108
2011,20,VA,1510,1494,16
2011,20,VI,11,11,0
2011,20,VT,30,28,2
2011,20,WA,392,378,14
2011,20,WI,161,150,11
2011,20,WV,182,196,-14
2011,20,WY,86,43,43
2011,21,AK,29,24,5
2011,21,AL,1009,1005,4
2011,21,AR,322,170,152
2011,21,AZ,269,264,5
2011,21,CA,2269,2343,-74
2011,21,CO,402,375,27
2011,21,CT,372,368,4
2011,21,DC,15,13,2
2011,21,DE,279,287,-8
2011,21,FL,37237,38630,-1393
2011,21,GA,1429,1395,34
2011,21,GU,3,3,0
2011,21,HI,1100,1080,20
2011,21,IA,162,153,9
2011,21,ID,96,75,21
2011,21,IL,446,437,9
2011,21,IN,305,240,65
2011,21,KS,156,154,2
2011,21,KY,255,197,58
2011,21,LA,11232,10533,699
2011,21,MA,476,472,4
2011,21,MD,684,668,16
2011,21,ME,99,99,0
2011,21,MI,183,165,18
2011,21,MN,96,100,-4
2011,21,MO,361,269,92
2011,21,MS,2061,1844,217
2011,21,MT,327,100,227
2011,21,NC,2321,2286,35
2011,21,ND,150,82,68
2011,21,NE,140,113,27
2011,21,NH,64,65,-1
2011,21,NJ,2665,2670,-5
2011,21,NM,138,112,26
2011,21,NV,139,146,-7
2011,21,NY,2383,2342,41
2011,21,OH,460,395,65
2011,21,OK,178,166,12
2011,21,OR,350,284,66
2011,21,PA,873,868,5
2011,21,PR,359,360,-1
2011,21,RI,203,235,-32
2011,21,SC,3734,3718,16
2011,21,SD,109,70,39
2011,21,TN,611,343,268
2011,21,TX,13212,13509,-297
2011,21,UT,97,45,52
2011,21,VA,1595,1548,47
2011,21,VI,5,6,-1
2011,21,VT,37,28,9
2011,21,WA,533,437,96
2011,21,WI,227,208,19
2011,21,WV,212,208,4
2011,21,WY,99,47,52
2011,22,AK,41,37,4
2011,22,AL,922,965,-43
2011,22,AR,624,227,397
2011,22,AZ,316,284,32
2011,22,CA,2539,2583,-44
2011,22,CO,318,256,62
2011,22,CT,490,482,8
2011,22,DC,16,16,0
2011,22,DE,395,392,3
2011,22,FL,44419,46068,-1649
2011,22,GA,1975,1994,-19
2011,22,HI,825,803,22
2011,22,IA,213,160,53
2011,22,ID,82,76,6
2011,22,IL,482,421,61
2011,22,IN,289,242,47
2011,22,KS,172,176,-4
2011,22,KY,299,284,15
2011,22,LA,14211,12009,2202
2011,22,MA,595,572,23
2011,22,MD,824,822,2
2011,22,ME,91,97,-6
2011,22,MI,150,143,7
2011,22,MN,116,118,-2
2011,22,MO,376,303,73
2011,22,MS,2745,2173,572
2011,22,MT,412,116,296
2011,22,NC,2563,2565,-2
2011,22,ND,106,94,12
2011,22,NE,195,87,108
2011,22,NH,113,112,1
2011,22,NJ,2911,2913,-2
2011,22,NM,143,126,17
2011,22,NV,121,138,-17
2011,22,NY,2340,2263,77
2011,22,OH,393,362,31
2011,22,OK,259,243,16
2011,22,OR,370,344,26
2011,22,PA,777,754,23
2011,22,PR,115,168,-53
2011,22,RI,201,209,-8
2011,22,SC,3477,3449,28
2011,22,SD,360,59,301
2011,22,TN,1269,848,421
2011,22,TX,15870,16221,-351
2011,22,UT,161,108,53
2011,22,VA,2333,2336,-3
2011,22,VI,11,13,-2
2011,22,VT,37,35,2
2011,22,WA,474,457,17
2011,22,WI,153,130,23
2011,22,WV,167,171,-4
2011,22,WY,126,42,84
2011,23,AK,26,27,-1
2011,23,AL,1167,1191,-24
2011,23,AR,429,218,211
2011,23,AZ,343,292,51
2011,23,CA,2136,2092,44
2011,23,CO,343,263,80
2011,23,CT,369,348,21
2011,23,DC,258,254,4
2011,23,DE,270,272,-2
2011,23,FL,33882,34160,-278
2011,23,GA,1473,1466,7
2011,23,GU,2,2,0
2011,23,HI,542,517,25
2011,23,IA,193,166,27
2011,23,ID,101,64,37
2011,23,IL,469,395,74
2011,23,IN,282,255,27
2011,23,KS,183,194,-11
2011,23,KY,313,314,-1
2011,23,LA,13454,10565,2889
2011,23,MA,569,509,60
2011,23,MD,622,627,-5
2011,23,ME,120,116,4
2011,23,MI,140,149,-9
2011,23,MN,93,101,-8
2011,23,MO,331,296,35
2011,23,MS,2017,1769,248
2011,23,MT,328,116,212
2011,23,NC,2335,2326,9
2011,23,ND,70,65,5
2011,23,NE,139,92,47
2011,23,NH,79,81,-2
2011,23,NJ,2378,2377,1
2011,23,NM,109,100,9
2011,23,NV,129,138,-9
2011,23,NY,1932,1888,44
2011,23,OH,372,351,21
2011,23,OK,257,239,18
2011,23,OR,298,261,37
2011,23,PA,695,698,-3
2011,23,PR,134,131,3
2011,23,RI,171,170,1
2011,23,SC,3245,3173,72
2011,23,SD,172,45,127
2011,23,TN,1146,1007,139
2011,23,TX,14879,14916,-37
2011,23,UT,115,81,34
2011,23,VA,1627,1598,29
2011,23,VI,18,19,-1
2011,23,VT,25,19,6
2011,23,WA,453,432,21
2011,23,WI,130,104,26
2011,23,WV,163,160,3
2011,23,WY,101,26,75
2011,24,AK,26,27,-1
2011,24,AL,1048,1040,8
2011,24,AR,286,199,87
2011,24,AZ,301,254,47
2011,24,CA,2338,2346,-8
2011,24,CO,541,391,150
2011,24,CT,570,554,16
2011,24,DC,25,21,4
2011,24,DE,322,326,-4
2011,24,FL,39887,40211,-324
2011,24,GA,1667,1675,-8
2011,24,GU,3,2,1
2011,24,HI,1313,1292,21
2011,24,IA,159,133,26
2011,24,ID,89,56,33
2011,24,IL,556,565,-9
2011,24,IN,265,257,8
2011,24,KS,202,209,-7
2011,24,KY,302,283,19
2011,24,LA,12872,11384,1488
2011,24,MA,563,553,10
2011,24,MD,811,791,20
2011,24,ME,107,110,-3
2011,24,MI,191,178,13
2011,24,MN,106,108,-2
2011,24,MO,323,302,21
2011,24,MS,1937,1873,64
2011,24,MT,202,84,118
2011,24,NC,2421,2371,50
2011,24,ND,114,83,31
2011,24,NE,122,84,38
2011,24,NH,77,85,-8
2011,24,NJ,2814,2835,-21
2011,24,NM,147,139,8
2011,24,NV,113,105,8
2011,24,NY,2181,2165,16
2011,24,OH,423,328,95
2011,24,OK,222,209,13
2011,24,OR,281,255,26
2011,24,PA,722,713,9
2011,24,PR,144,153,-9
2011,24,RI,225,222,3
2011,24,SC,3680,3627,53
2011,24,SD,61,52,9
2011,24,TN,837,847,-10
2011,24,TX,17145,17425,-280
2011,24,UN,1,0,1
2011,24,UT,88,65,23
2011,24,VA,1985,1956,29
2011,24,VI,103,105,-2
2011,24,VT,33,34,-1
2011,24,WA,418,399,19
2011,24,WI,199,177,22
2011,24,WV,217,232,-15
2011,24,WY,97,33,64
2011,25,AK,18,15,3
2011,25,AL,1037,1001,36
2011,25,AR,229,166,63
2011,25,AZ,404,376,28
2011,25,CA,2002,1905,97
2011,25,CO,280,199,81
2011,25,CT,387,373,14
2011,25,DC,34,30,4
2011,25,DE,316,305,11
2011,25,FL,41130,41454,-324
2011,25,GA,1707,1679,28
2011,25,GU,1,1,0
2011,25,HI,1087,1069,18
2011,25,IA,149,121,28
2011,25,ID,89,77,12
2011,25,IL,477,430,47
2011,25,IN,255,221,34
2011,25,KS,190,169,21
2011,25,KY,233,231,2
2011,25,LA,11554,11079,475
2011,25,MA,537,522,15
2011,25,MD,853,761,92
2011,25,ME,101,103,-2
2011,25,MI,191,159,32
2011,25,MN,105,103,2
2011,25,MO,293,264,29
2011,25,MS,1798,1786,12
2011,25,MT,190,92,98
2011,25,NC,3039,3051,-12
2011,25,ND,653,92,561
2011,25,NE,146,81,65
2011,25,NH,76,82,-6
2011,25,NJ,3017,3019,-2
2011,25,NM,145,111,34
2011,25,NV,112,117,-5
2011,25,NY,3722,3691,31
2011,25,OH,386,331,55
2011,25,OK,191,167,24
2011,25,OR,322,281,41
2011,25,PA,716,699,17
2011,25,PR,156,190,-34
2011,25,RI,218,223,-5
2011,25,SC,3803,3641,162
2011,25,SD,106,51,55
2011,25,TN,732,731,1
2011,25,TX,19365,19154,211
2011,25,UT,82,57,25
2011,25,VA,2224,2143,81
2011,25,VI,16,12,4
2011,25,VT,24,26,-2
2011,25,WA,351,350,1
2011,25,WI,124,122,2
2011,25,WV,195,196,-1
2011,25,WY,79,29,50
2011,26,AK,37,36,1
2011,26,AL,1178,1153,25
2011,26,AR,235,206,29
2011,26,AZ,370,324,46
2011,26,CA,2197,2263,-66
2011,26,CO,328,326,2
2011,26,CT,563,564,-1
2011,26,DC,24,25,-1
2011,26,DE,504,510,-6
2011,26,FL,56248,57565,-1317
2011,26,GA,2378,2407,-29
2011,26,HI,763,1111,-348
2011,26,IA,1070,366,704
2011,26,ID,84,67,17
2011,26,IL,544,548,-4
2011,26,IN,315,279,36
2011,26,KS,287,207,80
2011,26,KY,268,263,5
2011,26,LA,16717,16730,-13
2011,26,MA,792,781,11
2011,26,MD,1781,1788,-7
2011,26,ME,133,138,-5
2011,26,MI,195,158,37
2011,26,MN,121,118,3
2011,26,MO,403,303,100
2011,26,MS,1953,1971,-18
2011,26,MT,277,203,74
2011,26,NC,3374,3396,-22
2011,26,ND,1067,98,969
2011,26,NE,563,133,430
2011,26,NH,103,110,-7
2011,26,NJ,3337,3351,-14
2011,26,NM,157,148,9
2011,26,NV,129,144,-15
2011,26,NY,2849,2868,-19
2011,26,OH,452,421,31
2011,26,OK,205,193,12
2011,26,OR,308,305,3
2011,26,PA,1028,1026,2
2011,26,PR,174,160,14
2011,26,RI,259,266,-7
2011,26,SC,5033,5027,6
2011,26,SD,550,70,480
2011,26,TN,696,699,-3
2011,26,TX,26358,26708,-350
2011,26,UT,82,48,34
2011,26,VA,2956,2945,11
2011,26,VI,14,18,-4
2011,26,VT,47,45,2
2011,26,WA,394,380,14
2011,26,WI,153,142,11
2011,26,WV,252,258,-6
2011,26,WY,52,25,27
2011,27,AK,24,31,-7
2011,27,AL,1026,1019,7
2011,27,AR,152,129,23
2011,27,AZ,319,240,79
2011,27,CA,1859,1770,89
2011,27,CO,272,209,63
2011,27,CT,424,417,7
2011,27,DC,28,28,0
2011,27,DE,376,386,-10
2011,27,FL,37574,37917,-343
2011,27,GA,2044,2033,11
2011,27,HI,523,518,5
2011,27,IA,871,156,715
2011,27,ID,61,40,21
2011,27,IL,392,371,21
2011,27,IN,241,212,29
2011,27,KS,215,134,81
2011,27,KY,191,201,-10
2011,27,LA,11578,11416,162
2011,27,MA,591,576,15
2011,27,MD,751,750,1
2011,27,ME,84,93,-9
2011,27,MI,170,143,27
2011,27,MN,98,93,5
2011,27,MO,402,241,161
2011,27,MS,1452,1417,35
2011,27,MT,100,52,48
2011,27,NC,2568,2508,60
2011,27,ND,93,51,42
2011,27,NE,428,100,328
2011,27,NH,92,89,3
2011,27,NJ,2177,2176,1
2011,27,NM,165,159,6
2011,27,NV,100,96,4
2011,27,NY,2072,2055,17
2011,27,OH,341,316,25
2011,27,OK,183,171,12
2011,27,OR,268,254,14
2011,27,PA,599,609,-10
2011,27,PR,177,279,-102
2011,27,RI,208,207,1
2011,27,SC,3872,3715,157
2011,27,SD,186,51,135
2011,27,TN,457,441,16
2011,27,TX,23821,23448,373
2011,27,UT,73,55,18
2011,27,VA,2258,2195,63
2011,27,VI,14,14,0
2011,27,VT,21,18,3
2011,27,WA,414,398,16
2011,27,WI,113,119,-6
2011,27,WV,171,182,-11
2011,27,WY,52,34,18
2011,28,AK,29,26,3
2011,28,AL,860,838,22
2011,28,AR,183,165,18
2011,28,AZ,411,289,122
2011,28,CA,2725,2671,54
2011,28,CO,378,360,18
2011,28,CT,436,428,8
2011,28,DC,16,14,2
2011,28,DE,325,326,-1
2011,28,FL,41017,41631,-614
2011,28,GA,1944,1942,2
2011,28,GU,1,1,0
2011,28,HI,500,486,14
2011,28,IA,402,207,195
2011,28,ID,349,334,15
2011,28,IL,477,446,31
2011,28,IN,418,422,-4
2011,28,KS,194,180,14
2011,28,KY,322,316,6
2011,28,LA,12332,12378,-46
2011,28,MA,593,600,-7
2011,28,MD,936,955,-19
2011,28,ME,117,127,-10
2011,28,MI,248,213,35
2011,28,MN,108,119,-11
2011,28,MO,455,352,103
2011,28,MS,1499,1487,12
2011,28,MT,144,120,24
2011,28,NC,3147,3139,8
2011,28,ND,109,86,23
2011,28,NE,177,129,48
2011,28,NH,106,93,13
2011,28,NJ,3633,3264,369
2011,28,NM,135,128,7
2011,28,NV,112,119,-7
2011,28,NY,2885,2608,277
2011,28,OH,400,387,13
2011,28,OK,249,271,-22
2011,28,OR,379,353,26
2011,28,PA,768,741,27
2011,28,PR,346,348,-2
2011,28,RI,243,236,7
2011,28,SC,3794,3721,73
2011,28,SD,68,51,17
2011,28,TN,513,507,6
2011,28,TX,26560,26846,-286
2011,28,UT,65,51,14
2011,28,VA,2266,2230,36
2011,28,VI,10,12,-2
2011,28,VT,39,36,3
2011,28,WA,377,389,-12
2011,28,WI,213,230,-17
2011,28,WV,210,243,-33
2011,28,WY,35,30,5
2011,29,AK,31,30,1
2011,29,AL,1020,1050,-30
2011,29,AR,204,188,16
2011,29,AZ,537,345,192
2011,29,CA,2111,2035,76
2011,29,CO,239,223,16
2011,29,CT,459,452,7
2011,29,DC,23,20,3
2011,29,DE,324,334,-10
2011,29,FL,37256,37478,-222
2011,29,GA,1842,1813,29
2011,29,HI,900,858,42
2011,29,IA,282,220,62
2011,29,ID,58,53,5
2011,29,IL,562,535,27
2011,29,IN,420,407,13
2011,29,KS,189,193,-4
2011,29,KY,264,268,-4
2011,29,LA,10917,10882,35
2011,29,MA,724,745,-21
2011,29,MD,993,981,12
2011,29,ME,112,103,9
2011,29,MI,225,213,12
2011,29,MN,119,118,1
2011,29,MO,323,279,44
2011,29,MS,1317,1296,21
2011,29,MT,153,159,-6
2011,29,NC,2835,2810,25
2011,29,ND,167,109,58
2011,29,NE,139,110,29
2011,29,NH,160,157,3
2011,29,NJ,2670,2694,-24
2011,29,NM,146,124,22
2011,29,NV,160,166,-6
2011,29,NY,2345,2424,-79
2011,29,OH,425,398,27
2011,29,OK,257,253,4
2011,29,OR,320,299,21
2011,29,PA,758,782,-24
2011,29,PR,154,738,-584
2011,29,RI,289,239,50
2011,29,SC,3944,3938,6
2011,29,SD,61,51,10
2011,29,TN,466,446,20
2011,29,TX,23194,23755,-561
2011,29,UT,46,43,3
2011,29,VA,2467,2369,98
2011,29,VI,12,38,-26
2011,29,VT,37,40,-3
2011,29,WA,406,415,-9
2011,29,WI,208,202,6
2011,29,WV,208,217,-9
2011,29,WY,45,33,12
2011,30,AK,39,36,3
2011,30,AL,961,943,18
2011,30,AR,196,159,37
2011,30,AZ,526,386,140
2011,30,CA,2257,2122,135
2011,30,CO,266,269,-3
2011,30,CT,505,479,26
2011,30,DC,24,22,2
2011,30,DE,440,439,1
2011,30,FL,44151,44873,-722
2011,30,GA,2095,2073,22
2011,30,HI,775,759,16
2011,30,IA,259,227,32
2011,30,ID,78,67,11
2011,30,IL,515,546,-31
2011,30,IN,414,405,9
2011,30,KS,271,251,20
2011,30,KY,286,275,11
2011,30,LA,12042,12113,-71
2011,30,MA,723,710,13
2011,30,MD,1156,1135,21
2011,30,ME,118,114,4
2011,30,MI,207,183,24
2011,30,MN,105,111,-6
2011,30,MO,372,318,54
2011,30,MS,1356,1341,15
2011,30,MT,92,84,8
2011,30,NC,3035,2960,75
2011,30,ND,124,72,52
2011,30,NE,151,124,27
2011,30,NH,106,108,-2
2011,30,NJ,3162,2996,166
2011,30,NM,184,177,7
2011,30,NV,131,148,-17
2011,30,NY,2475,2460,15
2011,30,OH,449,414,35
2011,30,OK,254,253,1
2011,30,OR,373,366,7
2011,30,PA,949,969,-20
2011,30,PR,293,311,-18
2011,30,RI,282,281,1
2011,30,SC,4071,3979,92
2011,30,SD,69,58,11
2011,30,TN,463,442,21
2011,30,TX,22666,23061,-395
2011,30,UT,47,42,5
2011,30,VA,3009,2942,67
2011,30,VI,6,10,-4
2011,30,VT,37,32,5
2011,30,WA,399,417,-18
2011,30,WI,220,201,19
2011,30,WV,227,240,-13
2011,30,WY,40,39,1
2011,31,AK,32,30,2
2011,31,AL,1085,1069,16
2011,31,AR,181,166,15
2011,31,AZ,420,359,61
2011,31,CA,2391,2333,58
2011,31,CO,174,174,0
2011,31,CT,465,466,-1
2011,31,DC,25,24,1
2011,31,DE,326,333,-7
2011,31,FL,37032,38025,-993
2011,31,GA,2281,2232,49
2011,31,GU,1,0,1
2011,31,HI,451,511,-60
2011,31,IA,219,215,4
2011,31,ID,50,42,8
2011,31,IL,536,529,7
2011,31,IN,329,317,12
2011,31,KS,172,182,-10
2011,31,KY,241,228,13
2011,31,LA,10099,10182,-83
2011,31,MA,750,748,2
2011,31,MD,984,966,18
2011,31,ME,95,92,3
2011,31,MI,184,168,16
2011,31,MN,86,88,-2
2011,31,MO,338,291,47
2011,31,MS,2062,2105,-43
2011,31,MT,45,45,0
2011,31,NC,2548,2516,32
2011,31,ND,92,62,30
2011,31,NE,115,99,16
2011,31,NH,78,78,0
2011,31,NJ,2649,2656,-7
2011,31,NM,165,149,16
2011,31,NV,143,137,6
2011,31,NY,2103,2124,-21
2011,31,OH,441,401,40
2011,31,OK,267,280,-13
2011,31,OR,305,299,6
2011,31,PA,941,967,-26
2011,31,PR,10182,10421,-239
2011,31,RI,263,257,6
2011,31,SC,3736,3695,41
2011,31,SD,62,49,13
2011,31,TN,719,708,11
2011,31,TX,19557,20667,-1110
2011,31,UT,68,88,-20
2011,31,VA,2272,2251,21
2011,31,VI,18,31,-13
2011,31,VT,28,29,-1
2011,31,WA,380,391,-11
2011,31,WI,145,150,-5
2011,31,WV,189,201,-12
2011,31,WY,36,37,-1
2011,32,AK,33,29,4
2011,32,AL,911,905,6
2011,32,AR,210,199,11
2011,32,AZ,693,671,22
2011,32,CA,1943,1917,26
2011,32,CO,302,265,37
2011,32,CT,517,502,15
2011,32,DC,276,271,5
2011,32,DE,385,391,-6
2011,32,FL,35379,35012,367
2011,32,GA,2045,2043,2
2011,32,HI,1250,1249,1
2011,32,IA,197,165,32
2011,32,ID,69,65,4
2011,32,IL,561,468,93
2011,32,IN,362,354,8
2011,32,KS,171,171,0
2011,32,KY,234,223,11
2011,32,LA,10672,10830,-158
2011,32,MA,751,727,24
2011,32,MD,905,901,4
2011,32,ME,134,136,-2
2011,32,MI,190,172,18
2011,32,MN,165,158,7
2011,32,MO,480,449,31
2011,32,MS,1336,1333,3
2011,32,MT,81,73,8
2011,32,NC,3216,3212,4
2011,32,ND,152,93,59
2011,32,NE,150,111,39
2011,32,NH,72,69,3
2011,32,NJ,3450,3337,113
2011,32,NM,180,168,12
2011,32,NV,152,169,-17
2011,32,NY,2576,2557,19
2011,32,OH,435,399,36
2011,32,OK,295,331,-36
2011,32,OR,353,339,14
2011,32,PA,872,889,-17
2011,32,PR,157,159,-2
2011,32,RI,302,297,5
2011,32,SC,3929,3802,127
2011,32,SD,73,56,17
2011,32,TN,560,540,20
2011,32,TX,18609,19448,-839
2011,32,UT,55,45,10
2011,32,VA,2547,2461,86
2011,32,VI,18,19,-1
2011,32,VT,43,35,8
2011,32,WA,500,498,2
2011,32,WI,166,162,4
2011,32,WV,201,226,-25
2011,32,WY,23,24,-1
2011,33,AK,28,26,2
2011,33,AL,803,789,14
2011,33,AR,191,193,-2
2011,33,AZ,496,497,-1
2011,33,CA,1894,1911,-17
2011,33,CO,245,230,15
2011,33,CT,669,665,4
2011,33,DC,20,17,3
2011,33,DE,346,351,-5
2011,33,FL,35940,36585,-645
2011,33,GA,2049,2056,-7
2011,33,GU,1,1,0
2011,33,HI,1424,1419,5
2011,33,IA,210,196,14
2011,33,ID,59,54,5
2011,33,IL,421,411,10
2011,33,IN,311,300,11
2011,33,KS,144,150,-6
2011,33,KY,243,238,5
2011,33,LA,9784,9783,1
2011,33,MA,754,749,5
2011,33,MD,881,886,-5
2011,33,ME,122,129,-7
2011,33,MI,197,182,15
2011,33,MN,112,99,13
2011,33,MO,257,240,17
2011,33,MS,1340,1356,-16
2011,33,MT,109,112,-3
2011,33,NC,2972,2949,23
2011,33,ND,141,73,68
2011,33,NE,115,101,14
2011,33,NH,78,80,-2
2011,33,NJ,2928,2929,-1
2011,33,NM,171,155,16
2011,33,NV,168,173,-5
2011,33,NY,2757,2767,-10
2011,33,OH,410,408,2
2011,33,OK,275,300,-25
2011,33,OR,309,307,2
2011,33,PA,1231,1220,11
2011,33,PR,329,333,-4
2011,33,RI,345,342,3
2011,33,SC,3762,3792,-30
2011,33,SD,120,127,-7
2011,33,TN,492,503,-11
2011,33,TX,18484,19125,-641
2011,33,UT,37,39,-2
2011,33,VA,2502,2472,30
2011,33,VI,37,39,-2
2011,33,VT,27,26,1
2011,33,WA,421,444,-23
2011,33,WI,195,202,-7
2011,33,WV,209,236,-27
2011,33,WY,29,25,4
2011,34,AK,42,40,2
2011,34,AL,1189,1174,15
2011,34,AR,208,185,23
2011,34,AZ,567,642,-75
2011,34,CA,2205,2204,1
2011,34,CO,285,279,6
2011,34,CT,515,495,20
2011,34,DC,29,29,0
2011,34,DE,364,367,-3
2011,34,FL,35926,36218,-292
2011,34,GA,1882,1907,-25
2011,34,GU,3,3,0
2011,34,HI,2170,2160,10
2011,34,IA,226,210,16
2011,34,ID,66,53,13
2011,34,IL,708,663,45
2011,34,IN,329,313,16
2011,34,KS,145,134,11
2011,34,KY,249,245,4
2011,34,LA,9868,9814,54
2011,34,MA,814,785,29
2011,34,MD,922,888,34
2011,34,ME,121,116,5
2011,34,MI,179,171,8
2011,34,MN,93,94,-1
2011,34,MO,241,215,26
2011,34,MS,2627,2634,-7
2011,34,MT,38,35,3
2011,34,NC,3186,3122,64
2011,34,ND,189,77,112
2011,34,NE,120,119,1
2011,34,NH,79,83,-4
2011,34,NJ,2931,2860,71
2011,34,NM,169,166,3
2011,34,NV,153,158,-5
2011,34,NY,3165,3201,-36
2011,34,OH,453,418,35
2011,34,OK,192,209,-17
2011,34,OR,410,408,2
2011,34,PA,881,855,26
2011,34,PR,178,178,0
2011,34,RI,336,340,-4
2011,34,SC,4002,3905,97
2011,34,SD,102,106,-4
2011,34,TN,437,404,33
2011,34,TX,17133,17607,-474
2011,34,UT,47,46,1
2011,34,VA,2581,2525,56
2011,34,VI,24,25,-1
2011,34,VT,45,44,1
2011,34,WA,379,628,-249
2011,34,WI,227,231,-4
2011,34,WV,214,238,-24
2011,34,WY,57,55,2
2011,35,AK,51,54,-3
2011,35,AL,983,967,16
2011,35,AR,193,176,17
2011,35,AZ,452,476,-24
2011,35,CA,2391,2435,-44
2011,35,CO,335,327,8
2011,35,CT,640,622,18
2011,35,DC,100,93,7
2011,35,DE,398,393,5
2011,35,FL,39689,39936,-247
2011,35,GA,2192,2211,-19
2011,35,GU,2,2,0
2011,35,HI,2257,2321,-64
2011,35,IA,204,191,13
2011,35,ID,77,65,12
2011,35,IL,565,521,44
2011,35,IN,358,339,19
2011,35,KS,165,164,1
2011,35,KY,275,291,-16
2011,35,LA,11753,11793,-40
2011,35,MA,985,959,26
2011,35,MD,1191,1179,12
2011,35,ME,137,142,-5
2011,35,MI,185,179,6
2011,35,MN,142,118,24
2011,35,MO,264,255,9
2011,35,MS,2335,2386,-51
2011,35,MT,43,44,-1
2011,35,NC,3361,3365,-4
2011,35,ND,265,86,179
2011,35,NE,103,104,-1
2011,35,NH,164,159,5
2011,35,NJ,3821,3820,1
2011,35,NM,174,189,-15
2011,35,NV,158,164,-6
2011,35,NY,3486,3519,-33
2011,35,OH,511,481,30
2011,35,OK,231,232,-1
2011,35,OR,591,588,3
2011,35,PA,1040,1055,-15
2011,35,PR,291,279,12
2011,35,RI,365,376,-11
2011,35,SC,4002,3951,51
2011,35,SD,155,204,-49
2011,35,TN,532,551,-19
2011,35,TX,18167,18471,-304
2011,35,UT,54,44,10
2011,35,VA,3194,3184,10
2011,35,VI,12,13,-1
2011,35,VT,33,32,1
2011,35,WA,543,583,-40
2011,35,WI,212,246,-34
2011,35,WV,268,283,-15
2011,35,WY,24,29,-5
2011,36,AK,32,30,2
2011,36,AL,659,647,12
2011,36,AR,161,146,15
2011,36,AZ,319,317,2
2011,36,CA,1978,1963,15
2011,36,CO,249,233,16
2011,36,CT,486,498,-12
2011,36,DC,16,19,-3
2011,36,DE,382,406,-24
2011,36,FL,29203,29644,-441
2011,36,GA,1740,1724,16
2011,36,GU,1,1,0
2011,36,HI,386,380,6
2011,36,IA,182,167,15
2011,36,ID,43,32,11
2011,36,IL,506,414,92
2011,36,IN,263,259,4
2011,36,KS,134,120,14
2011,36,KY,236,231,5
2011,36,LA,7414,7450,-36
2011,36,MA,643,657,-14
2011,36,MD,704,693,11
2011,36,ME,116,113,3
2011,36,MI,152,139,13
2011,36,MN,106,91,15
2011,36,MO,240,213,27
2011,36,MS,1071,1100,-29
2011,36,MT,48,44,4
2011,36,NC,2426,2408,18
2011,36,ND,287,51,236
2011,36,NE,63,67,-4
2011,36,NH,92,88,4
2011,36,NJ,2959,2976,-17
2011,36,NM,158,163,-5
2011,36,NV,117,130,-13
2011,36,NY,2888,2827,61
2011,36,OH,425,390,35
2011,36,OK,178,168,10
2011,36,OR,547,540,7
2011,36,PA,857,890,-33
2011,36,PR,290,279,11
2011,36,RI,325,326,-1
2011,36,SC,3075,3044,31
2011,36,SD,63,69,-6
2011,36,TN,398,426,-28
2011,36,TX,12887,13157,-270
2011,36,UT,49,91,-42
2011,36,VA,2284,2294,-10
2011,36,VI,13,18,-5
2011,36,VT,32,27,5
2011,36,WA,367,407,-40
2011,36,WI,187,184,3
2011,36,WV,213,234,-21
2011,36,WY,32,33,-1
2011,37,AK,35,34,1
2011,37,AL,1119,1003,116
2011,37,AR,203,178,25
2011,37,AZ,352,357,-5
2011,37,CA,2314,2359,-45
2011,37,CO,260,258,2
2011,37,CT,556,544,12
2011,37,DC,31,36,-5
2011,37,DE,369,377,-8
2011,37,FL,31544,32318,-774
2011,37,GA,1687,1672,15
2011,37,HI,1215,1187,28
2011,37,IA,192,181,11
2011,37,ID,62,60,2
2011,37,IL,433,419,14
2011,37,IN,299,286,13
2011,37,KS,125,128,-3
2011,37,KY,280,272,8
2011,37,LA,8539,8621,-82
2011,37,MA,779,769,10
2011,37,MD,851,834,17
2011,37,ME,144,152,-8
2011,37,MI,161,162,-1
2011,37,MN,111,102,9
2011,37,MO,244,226,18
2011,37,MS,1825,1816,9
2011,37,MT,57,53,4
2011,37,NC,2480,2507,-27
2011,37,ND,322,71,251
2011,37,NE,96,87,9
2011,37,NH,136,138,-2
2011,37,NJ,3134,3117,17
2011,37,NM,177,192,-15
2011,37,NV,112,122,-10
2011,37,NY,3448,3437,11
2011,37,OH,437,400,37
2011,37,OK,234,221,13
2011,37,OR,764,740,24
2011,37,PA,900,927,-27
2011,37,PR,240,309,-69
2011,37,RI,288,285,3
2011,37,SC,3342,3296,46
2011,37,SD,68,71,-3
2011,37,TN,397,389,8
2011,37,TX,12964,13438,-474
2011,37,UT,45,46,-1
2011,37,VA,2163,2223,-60
2011,37,VI,20,21,-1
2011,37,VT,37,40,-3
2011,37,WA,491,594,-103
2011,37,WI,172,191,-19
2011,37,WV,244,255,-11
2011,37,WY,21,22,-1
2011,38,AK,38,39,-1
2011,38,AL,715,709,6
2011,38,AR,175,180,-5
2011,38,AZ,397,387,10
2011,38,CA,2266,2289,-23
2011,38,CO,213,199,14
2011,38,CT,574,490,84
2011,38,DC,80,58,22
2011,38,DE,468,414,54
2011,38,FL,32479,32319,160
2011,38,GA,1785,1633,152
2011,38,GU,5,5,0
2011,38,HI,542,537,5
2011,38,IA,152,145,7
2011,38,ID,67,61,6
2011,38,IL,471,449,22
2011,38,IN,293,295,-2
2011,38,KS,147,140,7
2011,38,KY,263,258,5
2011,38,LA,7801,7845,-44
2011,38,MA,1038,755,283
2011,38,MD,1115,867,248
2011,38,ME,137,125,12
2011,38,MI,285,273,12
2011,38,MN,126,120,6
2011,38,MO,279,213,66
2011,38,MS,1068,1091,-23
2011,38,MT,40,37,3
2011,38,NC,2677,2457,220
2011,38,ND,244,81,163
2011,38,NE,90,83,7
2011,38,NH,149,146,3
2011,38,NJ,3685,3495,190
2011,38,NM,153,159,-6
2011,38,NV,157,170,-13
2011,38,NY,3375,3168,207
2011,38,OH,484,444,40
2011,38,OK,237,237,0
2011,38,OR,491,521,-30
2011,38,PA,1025,946,79
2011,38,PR,225,300,-75
2011,38,RI,361,334,27
2011,38,SC,3710,3397,313
2011,38,SD,86,80,6
2011,38,TN,672,674,-2
2011,38,TX,12638,12984,-346
2011,38,UT,48,42,6
2011,38,VA,2540,2075,465
2011,38,VI,17,18,-1
2011,38,VT,41,41,0
2011,38,WA,528,738,-210
2011,38,WI,184,198,-14
2011,38,WV,223,258,-35
2011,38,WY,28,29,-1
2011,39,AK,47,49,-2
2011,39,AL,1072,1065,7
2011,39,AR,246,225,21
2011,39,AZ,479,451,28
2011,39,CA,2829,2790,39
2011,39,CO,217,213,4
2011,39,CT,872,773,99
2011,39,DC,297,273,24
2011,39,DE,540,443,97
2011,39,FL,47887,48330,-443
2011,39,GA,2388,2285,103
2011,39,GU,2,1,1
2011,39,HI,2481,2536,-55
2011,39,IA,348,349,-1
2011,39,ID,64,57,7
2011,39,IL,552,510,42
2011,39,IN,365,352,13
2011,39,KS,153,141,12
2011,39,KY,355,338,17
2011,39,LA,9788,9848,-60
2011,39,MA,1041,935,106
2011,39,MD,1705,1412,293
2011,39,ME,158,151,7
2011,39,MI,212,225,-13
2011,39,MN,159,172,-13
2011,39,MO,350,322,28
2011,39,MS,1150,1201,-51
2011,39,MT,59,54,5
2011,39,NC,3353,3223,130
2011,39,ND,271,84,187
2011,39,NE,129,117,12
2011,39,NH,172,151,21
2011,39,NJ,5476,4809,667
2011,39,NM,152,151,1
2011,39,NV,161,166,-5
2011,39,NY,5614,5039,575
2011,39,OH,540,479,61
2011,39,OK,287,286,1
2011,39,OR,739,754,-15
2011,39,PA,1269,1147,122
2011,39,PR,230,216,14
2011,39,RI,341,310,31
2011,39,SC,5251,5133,118
2011,39,SD,107,103,4
2011,39,TN,580,594,-14
2011,39,TX,15710,15719,-9
2011,39,UT,69,60,9
2011,39,VA,3728,3326,402
2011,39,VI,14,14,0
2011,39,VT,58,35,23
2011,39,WA,886,1068,-182
2011,39,WI,237,226,11
2011,39,WV,190,199,-9
2011,39,WY,24,24,0
2011,40,AK,34,29,5
2011,40,AL,795,750,45
2011,40,AR,143,138,5
2011,40,AZ,302,299,3
2011,40,CA,2775,2742,33
2011,40,CO,164,156,8
2011,40,CT,551,469,82
2011,40,DC,33,24,9
2011,40,DE,407,358,49
2011,40,FL,28103,28572,-469
2011,40,GA,1620,1579,41
2011,40,HI,1164,1162,2
2011,40,IA,156,134,22
2011,40,ID,50,49,1
2011,40,IL,506,481,25
2011,40,IN,255,246,9
2011,40,KS,97,91,6
2011,40,KY,218,217,1
2011,40,LA,5707,5625,82
2011,40,MA,859,826,33
2011,40,MD,1070,895,175
2011,40,ME,163,158,5
2011,40,MI,152,130,22
2011,40,MN,96,111,-15
2011,40,MO,208,204,4
2011,40,MS,890,861,29
2011,40,MT,34,29,5
2011,40,NC,2475,2424,51
2011,40,ND,187,57,130
2011,40,NE,64,65,-1
2011,40,NH,89,85,4
2011,40,NJ,2984,2495,489
2011,40,NM,117,110,7
2011,40,NV,116,125,-9
2011,40,NY,3530,3101,429
2011,40,OH,396,359,37
2011,40,OK,250,254,-4
2011,40,OR,392,386,6
2011,40,PA,1067,867,200
2011,40,PR,773,787,-14
2011,40,RI,219,213,6
2011,40,SC,2822,2779,43
2011,40,SD,43,37,6
2011,40,TN,411,369,42
2011,40,TX,10537,10532,5
2011,40,UT,50,52,-2
2011,40,VA,2134,1952,182
2011,40,VI,12,9,3
2011,40,VT,77,37,40
2011,40,WA,578,744,-166
2011,40,WI,132,139,-7
2011,40,WV,243,243,0
2011,40,WY,23,25,-2
2011,41,AK,22,21,1
2011,41,AL,607,586,21
2011,41,AR,164,146,18
2011,41,AZ,363,341,22
2011,41,CA,3204,3161,43
2011,41,CO,205,190,15
2011,41,CT,544,485,59
2011,41,DC,44,37,7
2011,41,DE,414,367,47
2011,41,FL,28938,28958,-20
2011,41,GA,1531,1494,37
2011,41,HI,294,269,25
2011,41,IA,172,144,28
2011,41,ID,66,57,9
2011,41,IL,436,430,6
2011,41,IN,310,280,30
2011,41,KS,131,122,9
2011,41,KY,246,230,16
2011,41,LA,7212,7275,-63
2011,41,MA,875,825,50
2011,41,MD,1007,853,154
2011,41,ME,158,159,-1
2011,41,MI,179,160,19
2011,41,MN,124,127,-3
2011,41,MO,268,238,30
2011,41,MS,901,893,8
2011,41,MT,38,31,7
2011,41,NC,2739,2677,62
2011,41,ND,261,71,190
2011,41,NE,66,58,8
2011,41,NH,90,76,14
2011,41,NJ,3237,2807,430
2011,41,NM,144,141,3
2011,41,NV,169,163,6
2011,41,NY,3842,3483,359
2011,41,OH,480,406,74
2011,41,OK,251,239,12
2011,41,OR,452,445,7
2011,41,PA,1260,854,406
2011,41,PR,123,328,-205
2011,41,RI,231,238,-7
2011,41,SC,2850,2792,58
2011,41,SD,66,50,16
2011,41,TN,468,458,10
2011,41,TX,10702,10828,-126
2011,41,UT,44,44,0
2011,41,VA,2357,2078,279
2011,41,VI,19,19,0
2011,41,VT,66,34,32
2011,41,WA,845,1244,-399
2011,41,WI,170,159,11
2011,41,WV,221,215,6
2011,41,WY,23,21,2
2011,42,AK,37,37,0
2011,42,AL,591,555,36
2011,42,AR,208,194,14
2011,42,AZ,420,404,16
2011,42,CA,3917,4029,-112
2011,42,CO,188,168,20
2011,42,CT,563,514,49
2011,42,DC,86,26,60
2011,42,DE,351,332,19
2011,42,FL,28782,28914,-132
2011,42,GA,1804,1821,-17
2011,42,GU,2,2,0
2011,42,HI,647,639,8
2011,42,IA,206,196,10
2011,42,ID,72,71,1
2011,42,IL,424,435,-11
2011,42,IN,330,299,31
2011,42,KS,157,136,21
2011,42,KY,234,221,13
2011,42,LA,6503,6534,-31
2011,42,MA,833,763,70
2011,42,MD,938,880,58
2011,42,ME,173,176,-3
2011,42,MI,174,154,20
2011,42,MN,116,122,-6
2011,42,MO,255,228,27
2011,42,MS,909,904,5
2011,42,MT,40,37,3
2011,42,NC,2092,2061,31
2011,42,ND,276,77,199
2011,42,NE,96,86,10
2011,42,NH,83,76,7
2011,42,NJ,2918,2685,233
2011,42,NM,126,141,-15
2011,42,NV,139,131,8
2011,42,NY,2902,2622,280
2011,42,OH,485,410,75
2011,42,OK,229,220,9
2011,42,OR,500,461,39
2011,42,PA,1137,861,276
2011,42,PR,226,221,5
2011,42,RI,214,201,13
2011,42,SC,2746,2752,-6
2011,42,SD,59,47,12
2011,42,TN,398,403,-5
2011,42,TX,11267,11572,-305
2011,42,UT,52,55,-3
2011,42,VA,2263,2174,89
2011,42,VI,10,11,-1
2011,42,VT,71,43,28
2011,42,WA,931,1501,-570
2011,42,WI,144,145,-1
2011,42,WV,198,212,-14
2011,42,WY,22,22,0
2011,43,AK,38,29,9
2011,43,AL,789,812,-23
2011,43,AR,208,186,22
2011,43,AZ,453,732,-279
2011,43,CA,4231,4226,5
2011,43,CO,218,206,12
2011,43,CT,533,510,23
2011,43,DC,41,31,10
2011,43,DE,565,557,8
2011,43,FL,29877,30344,-467
2011,43,GA,2100,2230,-130
2011,43,GU,1,1,0
2011,43,HI,578,572,6
2011,43,IA,152,134,18
2011,43,ID,66,67,-1
2011,43,IL,468,448,20
2011,43,IN,343,329,14
2011,43,KS,168,147,21
2011,43,KY,264,255,9
2011,43,LA,6662,6775,-113
2011,43,MA,857,817,40
2011,43,MD,967,874,93
2011,43,ME,142,133,9
2011,43,MI,229,229,0
2011,43,MN,118,134,-16
2011,43,MO,245,259,-14
2011,43,MS,1529,1520,9
2011,43,MT,57,45,12
2011,43,NC,2192,2142,50
2011,43,ND,358,82,276
2011,43,NE,98,98,0
2011,43,NH,167,95,72
2011,43,NJ,3080,2852,228
2011,43,NM,129,128,1
2011,43,NV,151,150,1
2011,43,NY,2878,2586,292
2011,43,OH,513,437,76
2011,43,OK,255,254,1
2011,43,OR,485,476,9
2011,43,PA,1328,1030,298
2011,43,PR,202,207,-5
2011,43,RI,242,233,9
2011,43,SC,2946,2886,60
2011,43,SD,74,75,-1
2011,43,TN,539,523,16
2011,43,TX,11738,12261,-523
2011,43,UT,59,62,-3
2011,43,VA,2000,1912,88
2011,43,VI,5,13,-8
2011,43,VT,71,36,35
2011,43,WA,1008,1481,-473
2011,43,WI,180,191,-11
2011,43,WV,184,210,-26
2011,43,WY,25,27,-2
2011,44,AK,37,34,3
2011,44,AL,914,898,16
2011,44,AR,183,166,17
2011,44,AZ,335,351,-16
2011,44,CA,4135,4230,-95
2011,44,CO,391,215,176
2011,44,CT,599,545,54
2011,44,DC,21,15,6
2011,44,DE,365,355,10
2011,44,FL,32665,33195,-530
2011,44,GA,1898,1940,-42
2011,44,HI,1220,1472,-252
2011,44,IA,178,138,40
2011,44,ID,75,68,7
2011,44,IL,463,463,0
2011,44,IN,324,315,9
2011,44,KS,139,128,11
2011,44,KY,272,252,20
2011,44,LA,7255,7460,-205
2011,44,MA,716,690,26
2011,44,MD,909,885,24
2011,44,ME,147,142,5
2011,44,MI,162,150,12
2011,44,MN,116,130,-14
2011,44,MO,271,260,11
2011,44,MS,945,971,-26
2011,44,MT,48,46,2
2011,44,NC,2093,2066,27
2011,44,ND,230,100,130
2011,44,NE,68,75,-7
2011,44,NH,101,103,-2
2011,44,NJ,3613,3452,161
2011,44,NM,106,108,-2
2011,44,NV,167,155,12
2011,44,NY,3240,2993,247
2011,44,OH,475,392,83
2011,44,OK,242,240,2
2011,44,OR,521,556,-35
2011,44,PA,1201,1051,150
2011,44,PR,126,185,-59
2011,44,RI,224,227,-3
2011,44,SC,2965,2951,14
2011,44,SD,57,54,3
2011,44,TN,438,418,20
2011,44,TX,11404,11678,-274
2011,44,UT,47,45,2
2011,44,VA,1961,1846,115
2011,44,VI,13,19,-6
2011,44,VT,79,47,32
2011,44,WA,1202,1553,-351
2011,44,WI,176,176,0
2011,44,WV,220,236,-16
2011,44,WY,33,31,2
2011,45,AK,17,15,2
2011,45,AL,714,702,12
2011,45,AR,166,156,10
2011,45,AZ,268,264,4
2011,45,CA,4313,4602,-289
2011,45,CO,161,153,8
2011,45,CT,342,338,4
2011,45,DC,25,21,4
2011,45,DE,261,258,3
2011,45,FL,23499,24112,-613
2011,45,GA,1360,1430,-70
2011,45,HI,738,738,0
2011,45,IA,112,106,6
2011,45,ID,72,73,-1
2011,45,IL,382,376,6
2011,45,IN,275,270,5
2011,45,KS,99,90,9
2011,45,KY,207,207,0
2011,45,LA,4961,4993,-32
2011,45,MA,591,544,47
2011,45,MD,723,708,15
2011,45,ME,133,135,-2
2011,45,MI,185,176,9
2011,45,MN,89,99,-10
2011,45,MO,273,270,3
2011,45,MS,869,876,-7
2011,45,MT,30,26,4
2011,45,NC,1625,1619,6
2011,45,ND,116,55,61
2011,45,NE,62,56,6
2011,45,NH,129,124,5
2011,45,NJ,3120,2986,134
2011,45,NM,104,99,5
2011,45,NV,121,119,2
2011,45,NY,2249,2039,210
2011,45,OH,389,335,54
2011,45,OK,190,181,9
2011,45,OR,484,488,-4
2011,45,PA,907,787,120
2011,45,PR,129,134,-5
2011,45,RI,152,154,-2
2011,45,SC,2243,2240,3
2011,45,SD,59,49,10
2011,45,TN,351,340,11
2011,45,TX,7559,7740,-181
2011,45,UN,1,1,0
2011,45,UT,50,42,8
2011,45,VA,1572,1484,88
2011,45,VI,9,12,-3
2011,45,VT,46,27,19
2011,45,WA,1023,1451,-428
2011,45,WI,128,115,13
2011,45,WV,169,177,-8
2011,45,WY,26,22,4
2011,46,AK,18,19,-1
2011,46,AL,500,505,-5
2011,46,AR,161,149,12
2011,46,AZ,325,305,20
2011,46,CA,5146,5318,-172
2011,46,CO,274,269,5
2011,46,CT,626,550,76
2011,46,DC,23,20,3
2011,46,DE,308,305,3
2011,46,FL,25497,25995,-498
2011,46,GA,1380,1395,-15
2011,46,GU,1,1,0
2011,46,HI,863,856,7
2011,46,IA,123,110,13
2011,46,ID,60,54,6
2011,46,IL,613,585,28
2011,46,IN,263,253,10
2011,46,KS,129,122,7
2011,46,KY,239,223,16
2011,46,LA,5972,5925,47
2011,46,MA,702,690,12
2011,46,MD,956,947,9
2011,46,ME,133,134,-1
2011,46,MI,141,136,5
2011,46,MN,103,89,14
2011,46,MO,225,209,16
2011,46,MS,1132,1176,-44
2011,46,MT,38,36,2
2011,46,NC,2134,2123,11
2011,46,ND,112,63,49
2011,46,NE,73,70,3
2011,46,NH,76,77,-1
2011,46,NJ,3436,3305,131
2011,46,NM,144,141,3
2011,46,NV,185,182,3
2011,46,NY,2454,2194,260
2011,46,OH,441,365,76
2011,46,OK,197,206,-9
2011,46,OR,531,563,-32
2011,46,PA,1019,921,98
2011,46,PR,922,966,-44
2011,46,RI,173,167,6
2011,46,SC,2735,2713,22
2011,46,SD,46,43,3
2011,46,TN,398,391,7
2011,46,TX,8310,8505,-195
2011,46,UT,61,52,9
2011,46,VA,1589,1527,62
2011,46,VI,19,26,-7
2011,46,VT,70,53,17
2011,46,WA,1071,1412,-341
2011,46,WI,143,134,9
2011,46,WV,225,226,-1
2011,46,WY,28,24,4
2011,47,AK,29,29,0
2011,47,AL,488,478,10
2011,47,AR,158,155,3
2011,47,AZ,259,249,10
2011,47,CA,3932,4013,-81
2011,47,CO,145,122,23
2011,47,CT,606,601,5
2011,47,DC,18,13,5
2011,47,DE,251,249,2
2011,47,FL,22853,23213,-360
2011,47,GA,1120,1131,-11
2011,47,HI,809,807,2
2011,47,IA,115,106,9
2011,47,ID,55,52,3
2011,47,IL,412,391,21
2011,47,IN,246,241,5
2011,47,KS,123,117,6
2011,47,KY,230,221,9
2011,47,LA,5218,5312,-94
2011,47,MA,625,597,28
2011,47,MD,865,843,22
2011,47,ME,117,119,-2
2011,47,MI,149,139,10
2011,47,MN,92,96,-4
2011,47,MO,260,260,0
2011,47,MS,800,820,-20
2011,47,MT,32,29,3
2011,47,NC,1627,1616,11
2011,47,ND,103,57,46
2011,47,NE,71,70,1
2011,47,NH,75,80,-5
2011,47,NJ,2910,2826,84
2011,47,NM,89,87,2
2011,47,NV,129,133,-4
2011,47,NY,2357,2217,140
2011,47,OH,579,532,47
2011,47,OK,163,157,6
2011,47,OR,545,565,-20
2011,47,PA,799,728,71
2011,47,PR,125,110,15
2011,47,RI,205,196,9
2011,47,SC,1912,1902,10
2011,47,SD,43,40,3
2011,47,TN,322,320,2
2011,47,TX,7108,7236,-128
2011,47,UT,41,44,-3
2011,47,VA,1447,1421,26
2011,47,VI,8,9,-1
2011,47,VT,56,47,9
2011,47,WA,896,1124,-228
2011,47,WI,111,114,-3
2011,47,WV,185,180,5
2011,47,WY,13,13,0
2011,48,AK,33,33,0
2011,48,AL,980,932,48
2011,48,AR,162,145,17
2011,48,AZ,341,350,-9
2011,48,CA,4717,4818,-101
2011,48,CO,160,155,5
2011,48,CT,848,832,16
2011,48,DC,25,20,5
2011,48,DE,299,290,9
2011,48,FL,29383,29765,-382
2011,48,GA,1302,1311,-9
2011,48,GU,2,2,0
2011,48,HI,1202,1200,2
2011,48,IA,145,119,26
2011,48,ID,62,57,5
2011,48,IL,430,421,9
2011,48,IN,275,275,0
2011,48,KS,122,97,25
2011,48,KY,207,206,1
2011,48,LA,6547,6704,-157
2011,48,MA,650,621,29
2011,48,MD,955,916,39
2011,48,ME,126,120,6
2011,48,MI,370,357,13
2011,48,MN,105,121,-16
2011,48,MO,236,225,11
2011,48,MS,1049,1104,-55
2011,48,MT,84,53,31
2011,48,NC,2153,2154,-1
2011,48,ND,104,60,44
2011,48,NE,86,88,-2
2011,48,NH,188,182,6
2011,48,NJ,2949,2871,78
2011,48,NM,141,132,9
2011,48,NV,128,117,11
2011,48,NY,2274,2092,182
2011,48,OH,446,377,69
2011,48,OK,146,132,14
2011,48,OR,619,651,-32
2011,48,PA,882,806,76
2011,48,PR,315,184,131
2011,48,RI,183,180,3
2011,48,SC,2839,2834,5
2011,48,SD,46,44,2
2011,48,TN,374,364,10
2011,48,TX,8503,8783,-280
2011,48,UT,60,51,9
2011,48,VA,1696,1632,64
2011,48,VI,37,44,-7
2011,48,VT,60,42,18
2011,48,WA,910,1237,-327
2011,48,WI,133,127,6
2011,48,WV,185,187,-2
2011,48,WY,16,14,2
2011,49,AK,27,23,4
2011,49,AL,1689,1684,5
2011,49,AR,171,156,15
2011,49,AZ,238,251,-13
2011,49,CA,4564,4615,-51
2011,49,CO,147,141,6
2011,49,CT,382,360,22
2011,49,DC,20,19,1
2011,49,DE,282,271,11
2011,49,FL,22000,22381,-381
2011,49,GA,1038,1071,-33
2011,49,GU,2,0,2
2011,49,HI,292,291,1
2011,49,IA,129,95,34
2011,49,ID,65,60,5
2011,49,IL,360,355,5
2011,49,IN,224,200,24
2011,49,KS,129,107,22
2011,49,KY,196,201,-5
2011,49,LA,4674,4710,-36
2011,49,MA,529,493,36
2011,49,MD,806,780,26
2011,49,ME,115,117,-2
2011,49,MI,138,123,15
2011,49,MN,78,84,-6
2011,49,MO,210,185,25
2011,49,MS,825,821,4
2011,49,MT,42,43,-1
2011,49,NC,1470,1466,4
2011,49,ND,111,68,43
2011,49,NE,70,58,12
2011,49,NH,86,82,4
2011,49,NJ,2463,2356,107
2011,49,NM,114,105,9
2011,49,NV,115,105,10
2011,49,NY,2424,2222,202
2011,49,OH,345,310,35
2011,49,OK,251,140,111
2011,49,OR,499,518,-19
2011,49,PA,767,723,44
2011,49,PR,205,220,-15
2011,49,RI,194,198,-4
2011,49,SC,1840,1816,24
2011,49,SD,50,51,-1
2011,49,TN,316,311,5
2011,49,TX,5997,6131,-134
2011,49,UT,44,38,6
2011,49,VA,1197,1148,49
2011,49,VI,10,9,1
2011,49,VT,37,21,16
2011,49,WA,733,1020,-287
2011,49,WI,117,110,7
2011,49,WV,165,167,-2
2011,49,WY,21,19,2
2011,50,AK,26,22,4
2011,50,AL,473,437,36
2011,50,AR,146,135,11
2011,50,AZ,246,237,9
2011,50,CA,4554,4610,-56
2011,50,CO,167,178,-11
2011,50,CT,435,429,6
2011,50,DC,26,25,1
2011,50,DE,293,289,4
2011,50,FL,25030,25579,-549
2011,50,GA,1169,1179,-10
2011,50,GU,1,1,0
2011,50,HI,865,860,5
2011,50,IA,155,118,37
2011,50,ID,62,58,4
2011,50,IL,339,335,4
2011,50,IN,215,190,25
2011,50,KS,136,110,26
2011,50,KY,197,188,9
2011,50,LA,5393,5410,-17
2011,50,MA,599,562,37
2011,50,MD,688,683,5
2011,50,ME,101,105,-4
2011,50,MI,198,192,6
2011,50,MN,62,63,-1
2011,50,MO,239,211,28
2011,50,MS,798,828,-30
2011,50,MT,30,28,2
2011,50,NC,1664,1652,12
2011,50,ND,96,63,33
2011,50,NE,80,82,-2
2011,50,NH,82,85,-3
2011,50,NJ,3043,2863,180
2011,50,NM,139,142,-3
2011,50,NV,134,145,-11
2011,50,NY,2365,2051,314
2011,50,OH,514,476,38
2011,50,OK,148,120,28
2011,50,OR,524,524,0
2011,50,PA,798,773,25
2011,50,PR,93,126,-33
2011,50,RI,129,122,7
2011,50,SC,2262,2216,46
2011,50,SD,57,57,0
2011,50,TN,331,310,21
2011,50,TX,6538,6607,-69
2011,50,UT,43,30,13
2011,50,VA,1410,1358,52
2011,50,VI,11,12,-1
2011,50,VT,44,33,11
2011,50,WA,761,843,-82
2011,50,WI,123,108,15
2011,50,WV,165,165,0
2011,50,WY,24,22,2
2011,51,AK,24,27,-3
2011,51,AL,504,525,-21
2011,51,AR,141,122,19
2011,51,AZ,225,224,1
2011,51,CA,3399,3421,-22
2011,51,CO,200,193,7
2011,51,CT,355,285,70
2011,51,DC,20,17,3
2011,51,DE,248,245,3
2011,51,FL,21226,22074,-848
2011,51,GA,961,966,-5
2011,51,GU,1,2,-1
2011,51,HI,417,422,-5
2011,51,IA,128,120,8
2011,51,ID,44,43,1
2011,51,IL,345,337,8
2011,51,IN,219,212,7
2011,51,KS,98,75,23
2011,51,KY,242,233,9
2011,51,LA,4633,4832,-199
2011,51,MA,540,517,23
2011,51,MD,581,571,10
2011,51,ME,105,102,3
2011,51,MI,149,137,12
2011,51,MN,79,85,-6
2011,51,MO,214,198,16
2011,51,MP,1,0,1
2011,51,MS,782,798,-16
2011,51,MT,28,24,4
2011,51,NC,1423,1442,-19
2011,51,ND,97,72,25
2011,51,NE,83,79,4
2011,51,NH,69,62,7
2011,51,NJ,2901,2828,73
2011,51,NM,107,102,5
2011,51,NV,104,101,3
2011,51,NY,1880,1755,125
2011,51,OH,330,286,44
2011,51,OK,138,114,24
2011,51,OR,458,448,10
2011,51,PA,733,675,58
2011,51,PR,235,283,-48
2011,51,RI,119,122,-3
2011,51,SC,1942,1900,42
2011,51,SD,50,58,-8
2011,51,TN,302,297,5
2011,51,TX,5902,5975,-73
2011,51,UT,86,80,6
2011,51,VA,1132,1129,3
2011,51,VI,9,8,1
2011,51,VT,39,32,7
2011,51,WA,777,759,18
2011,51,WI,87,86,1
2011,51,WV,159,162,-3
2011,51,WY,17,17,0
2011,52,AK,23,20,3
2011,52,AL,529,505,24
2011,52,AR,123,102,21
2011,52,AZ,241,227,14
2011,52,CA,3372,3481,-109
2011,52,CO,182,170,12
2011,52,CT,290,291,-1
2011,52,DC,22,17,5
2011,52,DE,190,194,-4
2011,52,FL,25752,25783,-31
2011,52,GA,1378,1380,-2
2011,52,HI,1110,1114,-4
2011,52,IA,87,63,24
2011,52,ID,47,54,-7
2011,52,IL,273,250,23
2011,52,IN,208,202,6
2011,52,KS,86,57,29
2011,52,KY,187,172,15
2011,52,LA,5287,5355,-68
2011,52,MA,670,654,16
2011,52,MD,953,925,28
2011,52,ME,82,88,-6
2011,52,MI,141,122,19
2011,52,MN,67,62,5
2011,52,MO,177,169,8
2011,52,MS,683,684,-1
2011,52,MT,29,29,0
2011,52,NC,1212,1205,7
2011,52,ND,96,63,33
2011,52,NE,132,145,-13
2011,52,NH,56,59,-3
2011,52,NJ,1838,1771,67
2011,52,NM,93,86,7
2011,52,NV,97,98,-1
2011,52,NY,1506,1372,134
2011,52,OH,295,260,35
2011,52,OK,130,110,20
2011,52,OR,372,379,-7
2011,52,PA,607,567,40
2011,52,PR,252,218,34
2011,52,RI,96,103,-7
2011,52,SC,2213,2182,31
2011,52,SD,44,42,2
2011,52,TN,334,320,14
2011,52,TX,5575,5644,-69
2011,52,UN,1,1,0
2011,52,UT,42,42,0
2011,52,VA,1057,1020,37
2011,52,VI,41,42,-1
2011,52,VT,31,25,6
2011,52,WA,513,545,-32
2011,52,WI,82,82,0
2011,52,WV,147,142,5
2011,52,WY,18,20,-2
2012,1,AK,15,16,-1
2012,1,AL,399,398,1
2012,1,AR,154,117,37
2012,1,AZ,300,278,22
2012,1,CA,5463,5884,-421
2012,1,CO,155,148,7
2012,1,CT,568,556,12
2012,1,DC,48,49,-1
2012,1,DE,557,558,-1
2012,1,FL,29572,29644,-72
2012,1,GA,1497,1486,11
2012,1,GU,1,1,0
2012,1,HI,402,405,-3
2012,1,IA,147,115,32
2012,1,ID,60,63,-3
2012,1,IL,664,652,12
2012,1,IN,204,187,17
2012,1,KS,121,107,14
2012,1,KY,186,176,10
2012,1,LA,5607,5605,2
2012,1,MA,511,495,16
2012,1,MD,653,633,20
2012,1,ME,89,96,-7
2012,1,MI,141,129,12
2012,1,MN,96,99,-3
2012,1,MO,182,168,14
2012,1,MS,847,861,-14
2012,1,MT,47,32,15
2012,1,NC,1607,1580,27
2012,1,ND,85,44,41
2012,1,NE,93,91,2
2012,1,NH,64,54,10
2012,1,NJ,2005,1997,8
2012,1,NM,138,129,9
2012,1,NV,146,133,13
2012,1,NY,1755,1641,114
2012,1,OH,366,320,46
2012,1,OK,128,102,26
2012,1,OR,525,523,2
2012,1,PA,697,651,46
2012,1,PR,68,112,-44
2012,1,RI,110,116,-6
2012,1,SC,1887,1903,-16
2012,1,SD,61,55,6
2012,1,TN,396,353,43
2012,1,TX,7377,7338,39
2012,1,UT,38,32,6
2012,1,VA,1207,1178,29
2012,1,VI,10,8,2
2012,1,VT,45,35,10
2012,1,WA,581,612,-31
2012,1,WI,191,179,12
2012,1,WV,208,199,9
2012,1,WY,11,11,0
2012,2,AK,33,31,2
2012,2,AL,515,507,8
2012,2,AR,136,108,28
2012,2,AZ,222,220,2
2012,2,CA,3194,3274,-80
2012,2,CO,179,183,-4
2012,2,CT,385,369,16
2012,2,DC,20,18,2
2012,2,DE,215,209,6
2012,2,FL,21318,21609,-291
2012,2,GA,912,919,-7
2012,2,HI,671,670,1
2012,2,IA,132,105,27
2012,2,ID,48,53,-5
2012,2,IL,323,305,18
2012,2,IN,220,198,22
2012,2,KS,119,97,22
2012,2,KY,182,162,20
2012,2,LA,4682,4669,13
2012,2,MA,403,409,-6
2012,2,MD,652,634,18
2012,2,ME,102,100,2
2012,2,MI,131,128,3
2012,2,MN,88,94,-6
2012,2,MO,176,166,10
2012,2,MS,939,967,-28
2012,2,MT,38,34,4
2012,2,NC,1337,1336,1
2012,2,ND,77,41,36
2012,2,NE,79,78,1
2012,2,NH,70,68,2
2012,2,NJ,2119,2046,73
2012,2,NM,118,133,-15
2012,2,NV,143,131,12
2012,2,NY,2001,1904,97
2012,2,OH,421,387,34
2012,2,OK,143,122,21
2012,2,OR,448,467,-19
2012,2,PA,745,703,42
2012,2,PR,89,125,-36
2012,2,RI,314,308,6
2012,2,SC,2124,2093,31
2012,2,SD,41,38,3
2012,2,TN,304,282,22
2012,2,TX,5896,5914,-18
2012,2,UT,40,31,9
2012,2,VA,978,928,50
2012,2,VI,11,12,-1
2012,2,VT,42,36,6
2012,2,WA,567,723,-156
2012,2,WI,116,114,2
2012,2,WV,155,154,1
2012,2,WY,22,18,4
2012,3,AK,36,35,1
2012,3,AL,492,374,118
2012,3,AR,140,108,32
2012,3,AZ,244,248,-4
2012,3,CA,3426,3764,-338
2012,3,CO,257,259,-2
2012,3,CT,343,335,8
2012,3,DC,21,19,2
2012,3,DE,367,363,4
2012,3,FL,21889,22690,-801
2012,3,GA,880,873,7
2012,3,GU,3,3,0
2012,3,HI,1363,1422,-59
2012,3,IA,129,101,28
2012,3,ID,47,46,1
2012,3,IL,357,347,10
2012,3,IN,216,184,32
2012,3,KS,93,71,22
2012,3,KY,156,140,16
2012,3,LA,4849,4848,1
2012,3,MA,483,464,19
2012,3,MD,1060,1035,25
2012,3,ME,93,97,-4
2012,3,MI,135,123,12
2012,3,MN,65,65,0
2012,3,MO,192,183,9
2012,3,MS,777,783,-6
2012,3,MT,39,45,-6
2012,3,NC,1735,1718,17
2012,3,ND,107,74,33
2012,3,NE,74,78,-4
2012,3,NH,93,88,5
2012,3,NJ,2091,2033,58
2012,3,NM,107,108,-1
2012,3,NV,173,150,23
2012,3,NY,1777,1667,110
2012,3,OH,314,294,20
2012,3,OK,112,112,0
2012,3,OR,398,413,-15
2012,3,PA,714,731,-17
2012,3,PR,121,121,0
2012,3,RI,117,111,6
2012,3,SC,2089,2063,26
2012,3,SD,49,44,5
2012,3,TN,251,231,20
2012,3,TX,5629,5600,29
2012,3,UT,26,37,-11
2012,3,VA,1104,1082,22
2012,3,VI,13,9,4
2012,3,VT,44,35,9
2012,3,WA,545,624,-79
2012,3,WI,110,109,1
2012,3,WV,151,152,-1
2012,3,WY,16,13,3
2012,4,AK,17,14,3
2012,4,AL,438,432,6
2012,4,AR,133,129,4
2012,4,AZ,246,236,10
2012,4,CA,2893,3081,-188
2012,4,CO,134,121,13
2012,4,CT,328,304,24
2012,4,DC,16,14,2
2012,4,DE,221,217,4
2012,4,FL,21714,21928,-214
2012,4,GA,955,914,41
2012,4,GU,1,0,1
2012,4,HI,340,342,-2
2012,4,IA,116,106,10
2012,4,ID,75,76,-1
2012,4,IL,330,341,-11
2012,4,IN,163,166,-3
2012,4,KS,94,78,16
2012,4,KY,166,151,15
2012,4,LA,4271,4332,-61
2012,4,MA,421,417,4
2012,4,MD,508,492,16
2012,4,ME,78,77,1
2012,4,MI,134,129,5
2012,4,MN,69,94,-25
2012,4,MO,177,160,17
2012,4,MS,681,694,-13
2012,4,MT,40,32,8
2012,4,NC,1245,1226,19
2012,4,ND,94,60,34
2012,4,NE,83,85,-2
2012,4,NH,83,79,4
2012,4,NJ,1888,1817,71
2012,4,NM,108,113,-5
2012,4,NV,122,108,14
2012,4,NY,1556,1499,57
2012,4,OH,284,265,19
2012,4,OK,121,103,18
2012,4,OR,431,416,15
2012,4,PA,658,639,19
2012,4,PR,196,185,11
2012,4,RI,92,88,4
2012,4,SC,1594,1564,30
2012,4,SD,40,39,1
2012,4,TN,222,220,2
2012,4,TX,4678,4710,-32
2012,4,UT,31,36,-5
2012,4,VA,902,907,-5
2012,4,VI,25,24,1
2012,4,VT,36,30,6
2012,4,WA,439,449,-10
2012,4,WI,89,90,-1
2012,4,WV,131,137,-6
2012,4,WY,19,18,1
2012,5,AK,18,18,0
2012,5,AL,799,768,31
2012,5,AR,169,171,-2
2012,5,AZ,271,265,6
2012,5,CA,3568,3820,-252
2012,5,CO,184,175,9
2012,5,CT,392,393,-1
2012,5,DC,17,14,3
2012,5,DE,186,192,-6
2012,5,FL,26068,26522,-454
2012,5,GA,1001,1029,-28
2012,5,HI,1319,1328,-9
2012,5,IA,137,131,6
2012,5,ID,86,90,-4
2012,5,IL,373,383,-10
2012,5,IN,229,212,17
2012,5,KS,114,113,1
2012,5,KY,193,177,16
2012,5,LA,5553,5635,-82
2012,5,MA,441,458,-17
2012,5,MD,660,590,70
2012,5,ME,75,80,-5
2012,5,MI,184,174,10
2012,5,MN,114,133,-19
2012,5,MO,228,223,5
2012,5,MS,958,955,3
2012,5,MT,44,44,0
2012,5,NC,1418,1437,-19
2012,5,ND,95,101,-6
2012,5,NE,96,98,-2
2012,5,NH,56,57,-1
2012,5,NJ,3174,2589,585
2012,5,NM,105,93,12
2012,5,NV,207,184,23
2012,5,NY,1606,1563,43
2012,5,OH,348,321,27
2012,5,OK,144,133,11
2012,5,OR,475,443,32
2012,5,PA,996,959,37
2012,5,PR,382,400,-18
2012,5,RI,109,111,-2
2012,5,SC,2490,2488,2
2012,5,SD,65,66,-1
2012,5,TN,289,290,-1
2012,5,TX,6407,6460,-53
2012,5,UT,39,44,-5
2012,5,VA,1047,992,55
2012,5,VI,11,9,2
2012,5,VT,31,27,4
2012,5,WA,519,549,-30
2012,5,WI,116,119,-3
2012,5,WV,220,207,13
2012,5,WY,15,14,1
2012,6,AK,18,14,4
2012,6,AL,557,550,7
2012,6,AR,222,198,24
2012,6,AZ,283,277,6
2012,6,CA,4365,4549,-184
2012,6,CO,157,140,17
2012,6,CT,282,278,4
2012,6,DC,16,17,-1
2012,6,DE,230,220,10
2012,6,FL,21051,21305,-254
2012,6,GA,991,936,55
2012,6,HI,496,489,7
2012,6,IA,140,127,13
2012,6,ID,103,109,-6
2012,6,IL,435,443,-8
2012,6,IN,255,245,10
2012,6,KS,142,99,43
2012,6,KY,216,227,-11
2012,6,LA,5563,5528,35
2012,6,MA,494,481,13
2012,6,MD,473,458,15
2012,6,ME,127,129,-2
2012,6,MI,159,161,-2
2012,6,MN,124,171,-47
2012,6,MO,199,195,4
2012,6,MS,932,945,-13
2012,6,MT,62,66,-4
2012,6,NC,1459,1395,64
2012,6,ND,178,204,-26
2012,6,NE,103,109,-6
2012,6,NH,84,76,8
2012,6,NJ,2156,2072,84
2012,6,NM,111,130,-19
2012,6,NV,242,217,25
2012,6,NY,1697,1650,47
2012,6,OH,406,401,5
2012,6,OK,142,136,6
2012,6,OR,566,433,133
2012,6,PA,849,832,17
2012,6,PR,98,94,4
2012,6,RI,137,132,5
2012,6,SC,1776,1788,-12
2012,6,SD,45,45,0
2012,6,TN,290,267,23
2012,6,TX,6144,5870,274
2012,6,UT,115,109,6
2012,6,VA,964,932,32
2012,6,VI,7,7,0
2012,6,VT,47,28,19
2012,6,WA,569,593,-24
2012,6,WI,113,119,-6
2012,6,WV,246,253,-7
2012,6,WY,29,32,-3
2012,7,AK,25,23,2
2012,7,AL,952,926,26
2012,7,AR,138,135,3
2012,7,AZ,284,282,2
2012,7,CA,3696,4029,-333
2012,7,CO,155,163,-8
2012,7,CT,335,334,1
2012,7,DC,31,27,4
2012,7,DE,208,204,4
2012,7,FL,24488,24813,-325
2012,7,GA,1006,1026,-20
2012,7,GU,1,1,0
2012,7,HI,447,451,-4
2012,7,IA,173,158,15
2012,7,ID,112,113,-1
2012,7,IL,736,734,2
2012,7,IN,283,249,34
2012,7,KS,110,96,14
2012,7,KY,225,217,8
2012,7,LA,6980,7032,-52
2012,7,MA,446,431,15
2012,7,MD,537,525,12
2012,7,ME,69,71,-2
2012,7,MI,207,195,12
2012,7,MN,150,239,-89
2012,7,MO,185,175,10
2012,7,MS,853,895,-42
2012,7,MT,70,87,-17
2012,7,NC,1630,1589,41
2012,7,ND,214,291,-77
2012,7,NE,114,129,-15
2012,7,NH,71,76,-5
2012,7,NJ,2155,1942,213
2012,7,NM,109,107,2
2012,7,NV,232,209,23
2012,7,NY,1735,1835,-100
2012,7,OH,522,407,115
2012,7,OK,133,136,-3
2012,7,OR,419,391,28
2012,7,PA,1067,1093,-26
2012,7,PR,96,99,-3
2012,7,RI,133,132,1
2012,7,SC,1960,1908,52
2012,7,SD,52,55,-3
2012,7,TN,277,262,15
2012,7,TX,6125,6119,6
2012,7,UN,1,1,0
2012,7,UT,60,60,0
2012,7,VA,1118,1119,-1
2012,7,VI,48,51,-3
2012,7,VT,41,36,5
2012,7,WA,532,562,-30
2012,7,WI,137,130,7
2012,7,WV,222,236,-14
2012,7,WY,28,30,-2
2012,8,AK,25,25,0
2012,8,AL,622,598,24
2012,8,AR,187,176,11
2012,8,AZ,304,296,8
2012,8,CA,3536,3747,-211
2012,8,CO,183,175,8
2012,8,CT,312,304,8
2012,8,DC,20,18,2
2012,8,DE,319,317,2
2012,8,FL,22842,23049,-207
2012,8,GA,1097,1056,41
2012,8,GU,1,1,0
2012,8,HI,1675,1679,-4
2012,8,IA,198,180,18
2012,8,ID,70,67,3
2012,8,IL,429,446,-17
2012,8,IN,271,252,19
2012,8,KS,128,112,16
2012,8,KY,243,235,8
2012,8,LA,6062,6102,-40
2012,8,MA,407,399,8
2012,8,MD,570,547,23
2012,8,ME,79,84,-5
2012,8,MI,179,183,-4
2012,8,MN,190,349,-159
2012,8,MO,239,221,18
2012,8,MS,1053,1071,-18
2012,8,MT,81,102,-21
2012,8,NC,1472,1447,25
2012,8,ND,326,659,-333
2012,8,NE,122,123,-1
2012,8,NH,89,82,7
2012,8,NJ,2006,1926,80
2012,8,NM,139,157,-18
2012,8,NV,207,199,8
2012,8,NY,1732,1665,67
2012,8,OH,419,409,10
2012,8,OK,150,138,12
2012,8,OR,459,379,80
2012,8,PA,1117,1112,5
2012,8,PR,167,142,25
2012,8,RI,112,115,-3
2012,8,SC,2125,2099,26
2012,8,SD,98,115,-17
2012,8,TN,391,378,13
2012,8,TX,6729,6454,275
2012,8,UT,69,68,1
2012,8,VA,1102,1078,24
2012,8,VI,7,7,0
2012,8,VT,33,33,0
2012,8,WA,516,493,23
2012,8,WI,119,124,-5
2012,8,WV,232,251,-19
2012,8,WY,25,25,0
2012,9,AK,33,30,3
2012,9,AL,525,510,15
2012,9,AR,176,161,15
2012,9,AZ,315,308,7
2012,9,CA,2920,3015,-95
2012,9,CO,212,194,18
2012,9,CT,474,596,-122
2012,9,DC,33,29,4
2012,9,DE,233,227,6
2012,9,FL,30728,30435,293
2012,9,GA,1266,1252,14
2012,9,GU,2,2,0
2012,9,HI,934,934,0
2012,9,IA,241,226,15
2012,9,ID,118,125,-7
2012,9,IL,539,534,5
2012,9,IN,267,254,13
2012,9,KS,124,103,21
2012,9,KY,183,197,-14
2012,9,LA,6774,6797,-23
2012,9,MA,456,451,5
2012,9,MD,1016,986,30
2012,9,ME,111,108,3
2012,9,MI,289,272,17
2012,9,MN,325,849,-524
2012,9,MO,253,257,-4
2012,9,MS,985,968,17
2012,9,MT,92,111,-19
2012,9,NC,2306,2325,-19
2012,9,ND,550,1034,-484
2012,9,NE,111,107,4
2012,9,NH,74,69,5
2012,9,NJ,2434,2681,-247
2012,9,NM,106,101,5
2012,9,NV,308,147,161
2012,9,NY,1848,1734,114
2012,9,OH,403,379,24
2012,9,OK,173,168,5
2012,9,OR,423,417,6
2012,9,PA,1043,1034,9
2012,9,PR,186,188,-2
2012,9,RI,353,357,-4
2012,9,SC,2213,2447,-234
2012,9,SD,83,108,-25
2012,9,TN,471,467,4
2012,9,TX,9248,8884,364
2012,9,UT,69,76,-7
2012,9,VA,1419,1387,32
2012,9,VI,13,14,-1
2012,9,VT,52,39,13
2012,9,WA,470,531,-61
2012,9,WI,135,151,-16
2012,9,WV,234,241,-7
2012,9,WY,25,25,0
2012,10,AK,35,29,6
2012,10,AL,486,480,6
2012,10,AR,164,168,-4
2012,10,AZ,250,254,-4
2012,10,CA,2743,2840,-97
2012,10,CO,214,219,-5
2012,10,CT,491,920,-429
2012,10,DC,16,16,0
2012,10,DE,219,218,1
2012,10,FL,25302,25579,-277
2012,10,GA,1077,1069,8
2012,10,GU,1,1,0
2012,10,HI,685,685,0
2012,10,IA,244,265,-21
2012,10,ID,155,146,9
2012,10,IL,542,546,-4
2012,10,IN,246,238,8
2012,10,KS,122,112,10
2012,10,KY,214,207,7
2012,10,LA,6191,6233,-42
2012,10,MA,518,566,-48
2012,10,MD,600,569,31
2012,10,ME,116,121,-5
2012,10,MI,229,173,56
2012,10,MN,345,1288,-943
2012,10,MO,230,244,-14
2012,10,MS,1107,1138,-31
2012,10,MT,75,142,-67
2012,10,NC,1493,1450,43
2012,10,ND,743,1503,-760
2012,10,NE,117,116,1
2012,10,NH,75,81,-6
2012,10,NJ,2035,2019,16
2012,10,NM,134,131,3
2012,10,NV,296,264,32
2012,10,NY,2146,1980,166
2012,10,OH,439,430,9
2012,10,OK,186,160,26
2012,10,OR,388,379,9
2012,10,PA,984,967,17
2012,10,PR,84,136,-52
2012,10,RI,119,126,-7
2012,10,SC,2199,2169,30
2012,10,SD,102,163,-61
2012,10,TN,485,484,1
2012,10,TX,6437,6278,159
2012,10,UT,64,64,0
2012,10,VA,1254,1256,-2
2012,10,VI,10,10,0
2012,10,VT,60,61,-1
2012,10,WA,564,582,-18
2012,10,WI,167,199,-32
2012,10,WV,226,239,-13
2012,10,WY,28,26,2
2012,11,AK,29,28,1
2012,11,AL,521,513,8
2012,11,AR,158,145,13
2012,11,AZ,250,263,-13
2012,11,CA,2615,2742,-127
2012,11,CO,224,221,3
2012,11,CT,565,819,-254
2012,11,DC,23,21,2
2012,11,DE,239,229,10
2012,11,FL,24687,24736,-49
2012,11,GA,1049,1050,-1
2012,11,HI,751,739,12
2012,11,IA,311,333,-22
2012,11,ID,113,108,5
2012,11,IL,470,475,-5
2012,11,IN,357,340,17
2012,11,KS,139,134,5
2012,11,KY,254,253,1
2012,11,LA,6378,6375,3
2012,11,MA,541,558,-17
2012,11,MD,529,522,7
2012,11,ME,101,111,-10
2012,11,MI,213,199,14
2012,11,MN,478,1670,-1192
2012,11,MO,245,268,-23
2012,11,MS,1269,1277,-8
2012,11,MT,96,163,-67
2012,11,NC,1708,1697,11
2012,11,ND,999,2131,-1132
2012,11,NE,109,103,6
2012,11,NH,132,132,0
2012,11,NJ,2129,2035,94
2012,11,NM,132,148,-16
2012,11,NV,193,172,21
2012,11,NY,1622,1572,50
2012,11,OH,509,440,69
2012,11,OK,188,158,30
2012,11,OR,374,343,31
2012,11,PA,961,954,7
2012,11,PR,90,90,0
2012,11,RI,125,125,0
2012,11,SC,2731,2658,73
2012,11,SD,106,216,-110
2012,11,TN,518,516,2
2012,11,TX,7300,7049,251
2012,11,UT,57,56,1
2012,11,VA,1232,1186,46
2012,11,VI,34,38,-4
2012,11,VT,45,42,3
2012,11,WA,539,566,-27
2012,11,WI,163,201,-38
2012,11,WV,203,222,-19
2012,11,WY,23,26,-3
2012,12,AK,33,34,-1
2012,12,AL,574,533,41
2012,12,AR,156,136,20
2012,12,AZ,256,242,14
2012,12,CA,2716,2843,-127
2012,12,CO,213,206,7
2012,12,CT,339,361,-22
2012,12,DC,24,22,2
2012,12,DE,295,290,5
2012,12,FL,23835,24293,-458
2012,12,GA,1086,1072,14
2012,12,HI,376,375,1
2012,12,IA,320,361,-41
2012,12,ID,384,386,-2
2012,12,IL,487,537,-50
2012,12,IN,278,288,-10
2012,12,KS,130,121,9
2012,12,KY,254,242,12
2012,12,LA,6539,6635,-96
2012,12,MA,582,588,-6
2012,12,MD,1234,1198,36
2012,12,ME,98,106,-8
2012,12,MI,211,181,30
2012,12,MN,541,1720,-1179
2012,12,MO,266,288,-22
2012,12,MS,1292,1318,-26
2012,12,MT,124,178,-54
2012,12,NC,1655,1627,28
2012,12,ND,964,2218,-1254
2012,12,NE,121,96,25
2012,12,NH,93,102,-9
2012,12,NJ,1955,1895,60
2012,12,NM,132,127,5
2012,12,NV,148,141,7
2012,12,NY,1970,1864,106
2012,12,OH,452,428,24
2012,12,OK,175,158,17
2012,12,OR,337,331,6
2012,12,PA,981,966,15
2012,12,PR,90,94,-4
2012,12,RI,108,111,-3
2012,12,SC,2403,2386,17
2012,12,SD,165,343,-178
2012,12,TN,458,456,2
2012,12,TX,7543,7366,177
2012,12,UT,70,84,-14
2012,12,VA,1713,1684,29
2012,12,VI,5,319,-314
2012,12,VT,44,37,7
2012,12,WA,404,406,-2
2012,12,WI,190,223,-33
2012,12,WV,258,272,-14
2012,12,WY,27,24,3
2012,13,AK,25,21,4
2012,13,AL,893,860,33
2012,13,AR,234,225,9
2012,13,AZ,314,328,-14
2012,13,CA,2782,2870,-88
2012,13,CO,234,248,-14
2012,13,CT,424,469,-45
2012,13,DC,26,25,1
2012,13,DE,253,251,2
2012,13,FL,32966,33667,-701
2012,13,GA,1400,1421,-21
2012,13,HI,309,304,5
2012,13,IA,389,464,-75
2012,13,ID,165,168,-3
2012,13,IL,642,697,-55
2012,13,IN,347,374,-27
2012,13,KS,148,149,-1
2012,13,KY,285,271,14
2012,13,LA,8478,8595,-117
2012,13,MA,542,554,-12
2012,13,MD,781,722,59
2012,13,ME,126,123,3
2012,13,MI,271,219,52
2012,13,MN,572,1794,-1222
2012,13,MO,327,356,-29
2012,13,MS,1230,1229,1
2012,13,MT,125,168,-43
2012,13,NC,2133,2131,2
2012,13,ND,825,1629,-804
2012,13,NE,124,120,4
2012,13,NH,105,108,-3
2012,13,NJ,2699,2591,108
2012,13,NM,147,151,-4
2012,13,NV,174,165,9
2012,13,NY,1716,1652,64
2012,13,OH,452,436,16
2012,13,OK,190,199,-9
2012,13,OR,394,368,26
2012,13,PA,1277,1039,238
2012,13,PR,310,321,-11
2012,13,RI,156,158,-2
2012,13,SC,2808,2752,56
2012,13,SD,187,377,-190
2012,13,TN,543,543,0
2012,13,TX,8677,8710,-33
2012,13,UN,2,2,0
2012,13,UT,65,74,-9
2012,13,VA,1442,1393,49
2012,13,VI,12,14,-2
2012,13,VT,53,49,4
2012,13,WA,639,676,-37
2012,13,WI,236,269,-33
2012,13,WV,255,260,-5
2012,13,WY,31,37,-6
2012,14,AK,51,38,13
2012,14,AL,729,729,0
2012,14,AR,232,229,3
2012,14,AZ,232,220,12
2012,14,CA,2381,2399,-18
2012,14,CO,278,279,-1
2012,14,CT,326,352,-26
2012,14,DC,23,27,-4
2012,14,DE,244,223,21
2012,14,FL,31788,32249,-461
2012,14,GA,1130,1111,19
2012,14,HI,669,602,67
2012,14,IA,447,555,-108
2012,14,ID,85,117,-32
2012,14,IL,688,721,-33
2012,14,IN,363,361,2
2012,14,KS,182,184,-2
2012,14,KY,245,235,10
2012,14,LA,8720,8868,-148
2012,14,MA,454,452,2
2012,14,MD,857,825,32
2012,14,ME,184,185,-1
2012,14,MI,212,165,47
2012,14,MN,661,2154,-1493
2012,14,MO,382,439,-57
2012,14,MS,1247,1307,-60
2012,14,MT,141,279,-138
2012,14,NC,1911,1933,-22
2012,14,ND,674,1312,-638
2012,14,NE,106,103,3
2012,14,NH,127,130,-3
2012,14,NJ,2099,2055,44
2012,14,NM,130,130,0
2012,14,NV,140,136,4
2012,14,NY,2066,1956,110
2012,14,OH,566,537,29
2012,14,OK,204,213,-9
2012,14,OR,372,369,3
2012,14,PA,898,852,46
2012,14,PR,219,230,-11
2012,14,RI,137,138,-1
2012,14,SC,3203,3160,43
2012,14,SD,174,339,-165
2012,14,TN,736,731,5
2012,14,TX,8623,8454,169
2012,14,UT,99,94,5
2012,14,VA,1131,1106,25
2012,14,VI,5,6,-1
2012,14,VT,46,42,4
2012,14,WA,447,444,3
2012,14,WI,246,355,-109
2012,14,WV,274,272,2
2012,14,WY,52,67,-15
2012,15,AK,66,55,11
2012,15,AL,811,848,-37
2012,15,AR,222,200,22
2012,15,AZ,286,289,-3
2012,15,CA,2428,2480,-52
2012,15,CO,274,299,-25
2012,15,CT,428,504,-76
2012,15,DC,28,24,4
2012,15,DE,290,294,-4
2012,15,FL,28914,29189,-275
2012,15,GA,1166,1185,-19
2012,15,GU,3,3,0
2012,15,HI,341,329,12
2012,15,IA,359,456,-97
2012,15,ID,113,109,4
2012,15,IL,620,896,-276
2012,15,IN,348,341,7
2012,15,KS,192,186,6
2012,15,KY,261,250,11
2012,15,LA,7828,7781,47
2012,15,MA,456,465,-9
2012,15,MD,881,863,18
2012,15,ME,135,158,-23
2012,15,MI,225,194,31
2012,15,MN,403,1024,-621
2012,15,MO,357,406,-49
2012,15,MS,1341,1373,-32
2012,15,MT,131,243,-112
2012,15,NC,1751,1710,41
2012,15,ND,665,949,-284
2012,15,NE,109,114,-5
2012,15,NH,128,127,1
2012,15,NJ,2181,2129,52
2012,15,NM,147,141,6
2012,15,NV,149,158,-9
2012,15,NY,1789,1757,32
2012,15,OH,482,505,-23
2012,15,OK,248,225,23
2012,15,OR,358,354,4
2012,15,PA,900,905,-5
2012,15,PR,115,108,7
2012,15,RI,188,198,-10
2012,15,SC,2439,2387,52
2012,15,SD,127,198,-71
2012,15,TN,474,463,11
2012,15,TX,8165,8015,150
2012,15,UT,77,106,-29
2012,15,VA,1420,1373,47
2012,15,VI,71,69,2
2012,15,VT,72,62,10
2012,15,WA,463,493,-30
2012,15,WI,298,421,-123
2012,15,WV,238,254,-16
2012,15,WY,54,65,-11
2012,16,AK,74,35,39
2012,16,AL,982,948,34
2012,16,AR,192,183,9
2012,16,AZ,259,238,21
2012,16,CA,2545,2759,-214
2012,16,CO,285,269,16
2012,16,CT,362,364,-2
2012,16,DC,17,13,4
2012,16,DE,279,272,7
2012,16,FL,33168,33227,-59
2012,16,GA,1245,1259,-14
2012,16,GU,1,2,-1
2012,16,HI,788,794,-6
2012,16,IA,290,393,-103
2012,16,ID,98,102,-4
2012,16,IL,631,839,-208
2012,16,IN,353,342,11
2012,16,KS,192,176,16
2012,16,KY,244,227,17
2012,16,LA,8618,8458,160
2012,16,MA,562,574,-12
2012,16,MD,684,721,-37
2012,16,ME,128,133,-5
2012,16,MI,243,185,58
2012,16,MN,230,373,-143
2012,16,MO,411,453,-42
2012,16,MS,1485,1543,-58
2012,16,MT,130,224,-94
2012,16,NC,1994,1973,21
2012,16,ND,311,400,-89
2012,16,NE,140,140,0
2012,16,NH,117,124,-7
2012,16,NJ,2491,2395,96
2012,16,NM,125,119,6
2012,16,NV,149,143,6
2012,16,NY,2484,2418,66
2012,16,OH,529,486,43
2012,16,OK,249,211,38
2012,16,OR,370,379,-9
2012,16,PA,831,788,43
2012,16,PR,121,122,-1
2012,16,RI,150,151,-1
2012,16,SC,2602,2589,13
2012,16,SD,78,101,-23
2012,16,TN,422,413,9
2012,16,TX,8848,8717,131
2012,16,UT,77,103,-26
2012,16,VA,1416,1307,109
2012,16,VI,21,26,-5
2012,16,VT,54,51,3
2012,16,WA,526,554,-28
2012,16,WI,262,308,-46
2012,16,WV,212,202,10
2012,16,WY,60,81,-21
2012,17,AK,67,48,19
2012,17,AL,1346,1352,-6
2012,17,AR,182,185,-3
2012,17,AZ,264,257,7
2012,17,CA,2858,3217,-359
2012,17,CO,328,354,-26
2012,17,CT,440,438,2
2012,17,DC,18,22,-4
2012,17,DE,294,280,14
2012,17,FL,33813,34318,-505
2012,17,GA,1364,1362,2
2012,17,GU,1,1,0
2012,17,HI,1192,1130,62
2012,17,IA,238,296,-58
2012,17,ID,151,146,5
2012,17,IL,654,715,-61
2012,17,IN,369,354,15
2012,17,KS,186,204,-18
2012,17,KY,316,311,5
2012,17,LA,9961,9963,-2
2012,17,MA,611,596,15
2012,17,MD,781,747,34
2012,17,ME,142,149,-7
2012,17,MI,544,192,352
2012,17,MN,181,206,-25
2012,17,MO,436,484,-48
2012,17,MS,1434,1465,-31
2012,17,MT,124,188,-64
2012,17,NC,2070,2065,5
2012,17,ND,147,155,-8
2012,17,NE,140,156,-16
2012,17,NH,93,101,-8
2012,17,NJ,2548,2480,68
2012,17,NM,149,140,9
2012,17,NV,151,143,8
2012,17,NY,2470,2381,89
2012,17,OH,467,434,33
2012,17,OK,257,234,23
2012,17,OR,320,333,-13
2012,17,PA,869,835,34
2012,17,PR,167,249,-82
2012,17,RI,222,219,3
2012,17,SC,2654,2629,25
2012,17,SD,71,85,-14
2012,17,TN,424,427,-3
2012,17,TX,10281,10354,-73
2012,17,UT,68,76,-8
2012,17,VA,1459,1464,-5
2012,17,VI,9,11,-2
2012,17,VT,40,39,1
2012,17,WA,455,483,-28
2012,17,WI,285,354,-69
2012,17,WV,233,228,5
2012,17,WY,48,56,-8
2012,18,AK,46,40,6
2012,18,AL,1181,1191,-10
2012,18,AR,230,247,-17
2012,18,AZ,301,313,-12
2012,18,CA,2911,3050,-139
2012,18,CO,367,360,7
2012,18,CT,424,432,-8
2012,18,DC,23,21,2
2012,18,DE,346,331,15
2012,18,FL,43677,44192,-515
2012,18,GA,1516,1544,-28
2012,18,GU,1,1,0
2012,18,HI,1005,1013,-8
2012,18,IA,223,223,0
2012,18,ID,379,372,7
2012,18,IL,657,686,-29
2012,18,IN,300,287,13
2012,18,KS,184,181,3
2012,18,KY,297,306,-9
2012,18,LA,10629,10792,-163
2012,18,MA,593,542,51
2012,18,MD,806,772,34
2012,18,ME,114,114,0
2012,18,MI,261,182,79
2012,18,MN,144,145,-1
2012,18,MO,317,358,-41
2012,18,MS,1643,1727,-84
2012,18,MT,125,192,-67
2012,18,NC,2606,2635,-29
2012,18,ND,92,93,-1
2012,18,NE,154,159,-5
2012,18,NH,96,96,0
2012,18,NJ,3087,3020,67
2012,18,NM,154,148,6
2012,18,NV,145,154,-9
2012,18,NY,2212,2111,101
2012,18,OH,452,446,6
2012,18,OK,220,228,-8
2012,18,OR,693,689,4
2012,18,PA,950,935,15
2012,18,PR,259,217,42
2012,18,RI,156,156,0
2012,18,SC,3715,3594,121
2012,18,SD,69,82,-13
2012,18,TN,434,425,9
2012,18,TX,12992,13544,-552
2012,18,UT,166,170,-4
2012,18,VA,1798,1719,79
2012,18,VI,9,13,-4
2012,18,VT,52,38,14
2012,18,WA,524,586,-62
2012,18,WI,179,177,2
2012,18,WV,204,210,-6
2012,18,WY,42,66,-24
2012,19,AK,40,37,3
2012,19,AL,706,707,-1
2012,19,AR,193,209,-16
2012,19,AZ,242,236,6
2012,19,CA,2292,2301,-9
2012,19,CO,273,271,2
2012,19,CT,315,311,4
2012,19,DC,21,17,4
2012,19,DE,257,234,23
2012,19,FL,31738,32042,-304
2012,19,GA,1194,1192,2
2012,19,HI,405,383,22
2012,19,IA,141,148,-7
2012,19,ID,88,88,0
2012,19,IL,403,426,-23
2012,19,IN,240,219,21
2012,19,KS,133,141,-8
2012,19,KY,224,209,15
2012,19,LA,8470,9260,-790
2012,19,MA,450,425,25
2012,19,MD,629,602,27
2012,19,ME,96,91,5
2012,19,MI,207,153,54
2012,19,MN,122,125,-3
2012,19,MO,270,303,-33
2012,19,MS,1410,1490,-80
2012,19,MT,81,157,-76
2012,19,NC,1815,1800,15
2012,19,ND,81,68,13
2012,19,NE,100,98,2
2012,19,NH,68,76,-8
2012,19,NJ,2117,2043,74
2012,19,NM,95,97,-2
2012,19,NV,108,109,-1
2012,19,NY,1691,1617,74
2012,19,OH,336,335,1
2012,19,OK,226,196,30
2012,19,OR,270,268,2
2012,19,PA,763,757,6
2012,19,PR,149,158,-9
2012,19,RI,124,133,-9
2012,19,SC,2409,2347,62
2012,19,SD,57,58,-1
2012,19,TN,341,327,14
2012,19,TX,9317,9371,-54
2012,19,UT,68,124,-56
2012,19,VA,1851,1808,43
2012,19,VI,12,13,-1
2012,19,VT,46,42,4
2012,19,WA,387,416,-29
2012,19,WI,156,164,-8
2012,19,WV,198,208,-10
2012,19,WY,49,77,-28
2012,20,AK,32,32,0
2012,20,AL,904,889,15
2012,20,AR,175,176,-1
2012,20,AZ,240,224,16
2012,20,CA,2159,2201,-42
2012,20,CO,300,298,2
2012,20,CT,362,360,2
2012,20,DC,22,19,3
2012,20,DE,304,301,3
2012,20,FL,33740,34051,-311
2012,20,GA,1423,1413,10
2012,20,GU,1,1,0
2012,20,HI,699,698,1
2012,20,IA,143,147,-4
2012,20,ID,100,96,4
2012,20,IL,550,554,-4
2012,20,IN,251,246,5
2012,20,KS,147,149,-2
2012,20,KY,246,223,23
2012,20,LA,9455,10051,-596
2012,20,MA,477,496,-19
2012,20,MD,654,619,35
2012,20,ME,91,86,5
2012,20,MI,236,179,57
2012,20,MN,114,98,16
2012,20,MO,237,250,-13
2012,20,MS,1634,1671,-37
2012,20,MT,107,249,-142
2012,20,NC,2240,2206,34
2012,20,ND,84,78,6
2012,20,NE,101,101,0
2012,20,NH,97,98,-1
2012,20,NJ,2499,2464,35
2012,20,NM,134,119,15
2012,20,NV,137,136,1
2012,20,NY,2126,2041,85
2012,20,OH,377,364,13
2012,20,OK,228,209,19
2012,20,OR,337,328,9
2012,20,PA,710,671,39
2012,20,PR,157,174,-17
2012,20,RI,153,152,1
2012,20,SC,3270,3236,34
2012,20,SD,65,65,0
2012,20,TN,347,343,4
2012,20,TX,10905,10907,-2
2012,20,UN,1,1,0
2012,20,UT,86,176,-90
2012,20,VA,1587,1568,19
2012,20,VI,7,9,-2
2012,20,VT,34,31,3
2012,20,WA,361,365,-4
2012,20,WI,153,150,3
2012,20,WV,215,203,12
2012,20,WY,52,86,-34
2012,21,AK,29,28,1
2012,21,AL,964,971,-7
2012,21,AR,243,271,-28
2012,21,AZ,292,274,18
2012,21,CA,2220,2187,33
2012,21,CO,377,368,9
2012,21,CT,379,379,0
2012,21,DC,14,14,0
2012,21,DE,308,260,48
2012,21,FL,34331,34497,-166
2012,21,GA,1372,1381,-9
2012,21,GU,3,3,0
2012,21,HI,924,1019,-95
2012,21,IA,244,245,-1
2012,21,ID,112,124,-12
2012,21,IL,395,400,-5
2012,21,IN,281,278,3
2012,21,KS,143,140,3
2012,21,KY,219,228,-9
2012,21,LA,9931,10230,-299
2012,21,MA,565,563,2
2012,21,MD,781,755,26
2012,21,ME,86,77,9
2012,21,MI,217,180,37
2012,21,MN,114,104,10
2012,21,MO,284,311,-27
2012,21,MS,1587,1680,-93
2012,21,MT,121,332,-211
2012,21,NC,2267,2234,33
2012,21,ND,124,128,-4
2012,21,NE,110,119,-9
2012,21,NH,74,77,-3
2012,21,NJ,2675,2631,44
2012,21,NM,141,136,5
2012,21,NV,131,133,-2
2012,21,NY,2460,2385,75
2012,21,OH,405,413,-8
2012,21,OK,218,195,23
2012,21,OR,327,332,-5
2012,21,PA,903,883,20
2012,21,PR,125,132,-7
2012,21,RI,177,188,-11
2012,21,SC,3222,3169,53
2012,21,SD,122,126,-4
2012,21,TN,404,425,-21
2012,21,TX,11886,12106,-220
2012,21,UT,50,87,-37
2012,21,VA,1516,1487,29
2012,21,VI,9,9,0
2012,21,VT,32,26,6
2012,21,WA,407,472,-65
2012,21,WI,217,209,8
2012,21,WV,188,193,-5
2012,21,WY,45,77,-32
2012,22,AK,41,42,-1
2012,22,AL,989,991,-2
2012,22,AR,367,477,-110
2012,22,AZ,305,310,-5
2012,22,CA,2333,2423,-90
2012,22,CO,290,318,-28
2012,22,CT,434,422,12
2012,22,DC,38,31,7
2012,22,DE,374,375,-1
2012,22,FL,46305,47031,-726
2012,22,GA,2181,2217,-36
2012,22,GU,1,1,0
2012,22,HI,1594,1535,59
2012,22,IA,210,220,-10
2012,22,ID,82,85,-3
2012,22,IL,605,605,0
2012,22,IN,336,328,8
2012,22,KS,169,177,-8
2012,22,KY,262,283,-21
2012,22,LA,12761,13862,-1101
2012,22,MA,654,639,15
2012,22,MD,1019,970,49
2012,22,ME,116,119,-3
2012,22,MI,193,156,37
2012,22,MN,137,130,7
2012,22,MO,348,382,-34
2012,22,MS,2241,2573,-332
2012,22,MT,133,384,-251
2012,22,NC,2529,2540,-11
2012,22,ND,126,147,-21
2012,22,NE,154,191,-37
2012,22,NH,117,111,6
2012,22,NJ,3286,3232,54
2012,22,NM,134,122,12
2012,22,NV,132,126,6
2012,22,NY,2032,1936,96
2012,22,OH,428,423,5
2012,22,OK,254,245,9
2012,22,OR,402,406,-4
2012,22,PA,893,884,9
2012,22,PR,322,331,-9
2012,22,RI,211,213,-2
2012,22,SC,4335,4287,48
2012,22,SD,122,222,-100
2012,22,TN,784,1029,-245
2012,22,TX,16408,16822,-414
2012,22,UN,1,0,1
2012,22,UT,100,161,-61
2012,22,VA,2445,2479,-34
2012,22,VI,9,9,0
2012,22,VT,38,46,-8
2012,22,WA,478,493,-15
2012,22,WI,174,178,-4
2012,22,WV,228,213,15
2012,22,WY,60,123,-63
2012,23,AK,22,23,-1
2012,23,AL,1261,1249,12
2012,23,AR,352,496,-144
2012,23,AZ,334,358,-24
2012,23,CA,2003,2040,-37
2012,23,CO,248,300,-52
2012,23,CT,333,331,2
2012,23,DC,261,261,0
2012,23,DE,307,292,15
2012,23,FL,32149,32265,-116
2012,23,GA,1698,1701,-3
2012,23,GU,2,2,0
2012,23,HI,2340,2339,1
2012,23,IA,182,193,-11
2012,23,ID,96,107,-11
2012,23,IL,388,430,-42
2012,23,IN,274,271,3
2012,23,KS,151,159,-8
2012,23,KY,281,287,-6
2012,23,LA,11161,12893,-1732
2012,23,MA,433,405,28
2012,23,MD,872,749,123
2012,23,ME,93,99,-6
2012,23,MI,219,166,53
2012,23,MN,115,100,15
2012,23,MO,320,366,-46
2012,23,MS,1830,2237,-407
2012,23,MT,125,343,-218
2012,23,NC,2458,2437,21
2012,23,ND,91,83,8
2012,23,NE,115,173,-58
2012,23,NH,73,72,1
2012,23,NJ,2360,2252,108
2012,23,NM,125,115,10
2012,23,NV,118,120,-2
2012,23,NY,2113,2013,100
2012,23,OH,377,372,5
2012,23,OK,269,245,24
2012,23,OR,307,294,13
2012,23,PA,734,694,40
2012,23,PR,111,125,-14
2012,23,RI,171,175,-4
2012,23,SC,3482,3108,374
2012,23,SD,168,309,-141
2012,23,TN,1042,1298,-256
2012,23,TX,13949,14199,-250
2012,23,UT,76,142,-66
2012,23,VA,1760,1648,112
2012,23,VI,8,7,1
2012,23,VT,33,27,6
2012,23,WA,411,422,-11
2012,23,WI,160,155,5
2012,23,WV,180,180,0
2012,23,WY,55,104,-49
2012,24,AK,32,31,1
2012,24,AL,1025,1026,-1
2012,24,AR,286,333,-47
2012,24,AZ,299,312,-13
2012,24,CA,2224,2250,-26
2012,24,CO,378,436,-58
2012,24,CT,446,448,-2
2012,24,DC,19,23,-4
2012,24,DE,315,302,13
2012,24,FL,39340,39425,-85
2012,24,GA,1597,1609,-12
2012,24,GU,1,0,1
2012,24,HI,1437,1457,-20
2012,24,IA,161,162,-1
2012,24,ID,76,92,-16
2012,24,IL,564,564,0
2012,24,IN,279,278,1
2012,24,KS,195,196,-1
2012,24,KY,329,348,-19
2012,24,LA,12401,13456,-1055
2012,24,MA,701,681,20
2012,24,MD,857,837,20
2012,24,ME,95,118,-23
2012,24,MI,248,191,57
2012,24,MN,113,97,16
2012,24,MO,308,331,-23
2012,24,MS,1766,1901,-135
2012,24,MT,126,221,-95
2012,24,NC,2424,2409,15
2012,24,ND,109,111,-2
2012,24,NE,98,114,-16
2012,24,NH,84,80,4
2012,24,NJ,2607,2533,74
2012,24,NM,157,142,15
2012,24,NV,136,133,3
2012,24,NY,2226,2102,124
2012,24,OH,398,402,-4
2012,24,OK,248,231,17
2012,24,OR,334,325,9
2012,24,PA,782,725,57
2012,24,PR,131,148,-17
2012,24,RI,208,210,-2
2012,24,SC,3657,3624,33
2012,24,SD,51,57,-6
2012,24,TN,810,895,-85
2012,24,TX,16722,17074,-352
2012,24,UT,55,77,-22
2012,24,VA,1984,1982,2
2012,24,VI,21,22,-1
2012,24,VT,33,31,2
2012,24,WA,403,459,-56
2012,24,WI,195,186,9
2012,24,WV,202,200,2
2012,24,WY,41,104,-63
2012,25,AK,23,22,1
2012,25,AL,937,962,-25
2012,25,AR,224,235,-11
2012,25,AZ,395,391,4
2012,25,CA,1970,1985,-15
2012,25,CO,448,480,-32
2012,25,CT,405,399,6
2012,25,DC,40,38,2
2012,25,DE,309,307,2
2012,25,FL,39241,39224,17
2012,25,GA,1742,1745,-3
2012,25,GU,4,3,1
2012,25,HI,834,821,13
2012,25,IA,138,143,-5
2012,25,ID,72,81,-9
2012,25,IL,406,443,-37
2012,25,IN,271,288,-17
2012,25,KS,191,186,5
2012,25,KY,213,231,-18
2012,25,LA,11275,11583,-308
2012,25,MA,540,517,23
2012,25,MD,958,935,23
2012,25,ME,96,100,-4
2012,25,MI,196,167,29
2012,25,MN,124,121,3
2012,25,MO,290,292,-2
2012,25,MS,1699,1755,-56
2012,25,MT,110,178,-68
2012,25,NC,3040,2978,62
2012,25,ND,162,231,-69
2012,25,NE,113,129,-16
2012,25,NH,83,86,-3
2012,25,NJ,2973,2949,24
2012,25,NM,129,133,-4
2012,25,NV,107,97,10
2012,25,NY,2271,3589,-1318
2012,25,OH,384,379,5
2012,25,OK,246,220,26
2012,25,OR,266,287,-21
2012,25,PA,748,717,31
2012,25,PR,144,162,-18
2012,25,RI,224,224,0
2012,25,SC,3883,3746,137
2012,25,SD,68,61,7
2012,25,TN,771,829,-58
2012,25,TX,18400,18998,-598
2012,25,UN,1,1,0
2012,25,UT,60,78,-18
2012,25,VA,2152,2146,6
2012,25,VI,158,104,54
2012,25,VT,37,31,6
2012,25,WA,382,376,6
2012,25,WI,136,113,23
2012,25,WV,203,210,-7
2012,25,WY,55,83,-28
2012,26,AK,37,30,7
2012,26,AL,909,956,-47
2012,26,AR,196,201,-5
2012,26,AZ,343,329,14
2012,26,CA,1945,1969,-24
2012,26,CO,311,288,23
2012,26,CT,499,476,23
2012,26,DC,22,20,2
2012,26,DE,383,395,-12
2012,26,FL,49008,49157,-149
2012,26,GA,2147,2075,72
2012,26,GU,1,0,1
2012,26,HI,1162,1213,-51
2012,26,IA,224,341,-117
2012,26,ID,74,82,-8
2012,26,IL,511,527,-16
2012,26,IN,248,272,-24
2012,26,KS,190,197,-7
2012,26,KY,195,200,-5
2012,26,LA,14035,14263,-228
2012,26,MA,769,737,32
2012,26,MD,1325,1198,127
2012,26,ME,108,111,-3
2012,26,MI,215,219,-4
2012,26,MN,127,121,6
2012,26,MO,277,312,-35
2012,26,MS,1723,1750,-27
2012,26,MT,196,284,-88
2012,26,NC,3109,3079,30
2012,26,ND,489,1247,-758
2012,26,NE,160,314,-154
2012,26,NH,91,79,12
2012,26,NJ,3368,3308,60
2012,26,NM,141,155,-14
2012,26,NV,117,121,-4
2012,26,NY,2386,2258,128
2012,26,OH,401,404,-3
2012,26,OK,203,176,27
2012,26,OR,249,243,6
2012,26,PA,821,788,33
2012,26,PR,158,182,-24
2012,26,RI,225,209,16
2012,26,SC,4456,4441,15
2012,26,SD,140,293,-153
2012,26,TN,648,687,-39
2012,26,TX,21273,22281,-1008
2012,26,UT,53,69,-16
2012,26,VA,2543,2515,28
2012,26,VI,7,8,-1
2012,26,VT,51,38,13
2012,26,WA,364,377,-13
2012,26,WI,160,165,-5
2012,26,WV,162,161,1
2012,26,WY,23,49,-26
2012,27,AK,32,31,1
2012,27,AL,1453,1457,-4
2012,27,AR,191,183,8
2012,27,AZ,326,327,-1
2012,27,CA,1994,1983,11
2012,27,CO,323,320,3
2012,27,CT,499,490,9
2012,27,DC,25,22,3
2012,27,DE,374,373,1
2012,27,FL,42324,42973,-649
2012,27,GA,2310,2333,-23
2012,27,GU,1,1,0
2012,27,HI,412,344,68
2012,27,IA,483,1273,-790
2012,27,ID,70,79,-9
2012,27,IL,408,427,-19
2012,27,IN,250,266,-16
2012,27,KS,183,266,-83
2012,27,KY,233,226,7
2012,27,LA,12616,13699,-1083
2012,27,MA,754,639,115
2012,27,MD,1383,1339,44
2012,27,ME,114,100,14
2012,27,MI,196,170,26
2012,27,MN,120,107,13
2012,27,MO,334,435,-101
2012,27,MS,1663,1714,-51
2012,27,MT,74,112,-38
2012,27,NC,3136,3094,42
2012,27,ND,196,303,-107
2012,27,NE,247,621,-374
2012,27,NH,117,105,12
2012,27,NJ,2447,2327,120
2012,27,NM,185,197,-12
2012,27,NV,126,137,-11
2012,27,NY,2747,2724,23
2012,27,OH,407,407,0
2012,27,OK,222,208,14
2012,27,OR,306,305,1
2012,27,PA,784,728,56
2012,27,PR,130,149,-19
2012,27,RI,243,246,-3
2012,27,SC,4554,4555,-1
2012,27,SD,149,438,-289
2012,27,TN,469,500,-31
2012,27,TX,25708,27013,-1305
2012,27,UT,67,89,-22
2012,27,VA,2667,2675,-8
2012,27,VI,15,17,-2
2012,27,VT,45,36,9
2012,27,WA,373,396,-23
2012,27,WI,155,136,19
2012,27,WV,211,219,-8
2012,27,WY,35,55,-20
2012,28,AK,24,21,3
2012,28,AL,838,862,-24
2012,28,AR,189,174,15
2012,28,AZ,375,368,7
2012,28,CA,2299,2351,-52
2012,28,CO,268,239,29
2012,28,CT,393,395,-2
2012,28,DC,15,14,1
2012,28,DE,306,296,10
2012,28,FL,38964,38905,59
2012,28,GA,1904,1905,-1
2012,28,GU,1,1,0
2012,28,HI,379,273,106
2012,28,IA,257,499,-242
2012,28,ID,53,55,-2
2012,28,IL,431,470,-39
2012,28,IN,412,403,9
2012,28,KS,182,196,-14
2012,28,KY,250,270,-20
2012,28,LA,11548,11818,-270
2012,28,MA,617,586,31
2012,28,MD,878,855,23
2012,28,ME,112,111,1
2012,28,MI,270,251,19
2012,28,MN,127,116,11
2012,28,MO,285,375,-90
2012,28,MS,1462,1449,13
2012,28,MT,103,135,-32
2012,28,NC,2674,2678,-4
2012,28,ND,90,103,-13
2012,28,NE,162,210,-48
2012,28,NH,122,126,-4
2012,28,NJ,3447,3368,79
2012,28,NM,140,141,-1
2012,28,NV,106,109,-3
2012,28,NY,2613,2780,-167
2012,28,OH,372,367,5
2012,28,OK,206,208,-2
2012,28,OR,350,357,-7
2012,28,PA,743,716,27
2012,28,PR,174,193,-19
2012,28,RI,219,225,-6
2012,28,SC,3552,3461,91
2012,28,SD,66,78,-12
2012,28,TN,506,484,22
2012,28,TX,24024,25018,-994
2012,28,UT,46,58,-12
2012,28,VA,2249,2230,19
2012,28,VI,12,10,2
2012,28,VT,35,26,9
2012,28,WA,337,343,-6
2012,28,WI,195,198,-3
2012,28,WV,179,185,-6
2012,28,WY,40,48,-8
2012,29,AK,32,28,4
2012,29,AL,853,843,10
2012,29,AR,207,214,-7
2012,29,AZ,445,494,-49
2012,29,CA,2222,2192,30
2012,29,CO,264,263,1
2012,29,CT,463,435,28
2012,29,DC,31,28,3
2012,29,DE,330,330,0
2012,29,FL,39188,39516,-328
2012,29,GA,1882,1893,-11
2012,29,GU,1,0,1
2012,29,HI,1272,1270,2
2012,29,IA,242,274,-32
2012,29,ID,59,57,2
2012,29,IL,525,510,15
2012,29,IN,403,434,-31
2012,29,KS,198,220,-22
2012,29,KY,234,245,-11
2012,29,LA,11673,11652,21
2012,29,MA,826,800,26
2012,29,MD,1053,1033,20
2012,29,ME,109,117,-8
2012,29,MI,233,211,22
2012,29,MN,154,127,27
2012,29,MO,307,364,-57
2012,29,MS,1414,1415,-1
2012,29,MT,142,152,-10
2012,29,NC,3262,3297,-35
2012,29,ND,108,119,-11
2012,29,NE,141,161,-20
2012,29,NH,162,167,-5
2012,29,NJ,2967,2893,74
2012,29,NM,150,136,14
2012,29,NV,125,136,-11
2012,29,NY,2481,2389,92
2012,29,OH,457,467,-10
2012,29,OK,263,271,-8
2012,29,OR,311,307,4
2012,29,PA,809,810,-1
2012,29,PR,174,321,-147
2012,29,RI,274,274,0
2012,29,SC,4017,4139,-122
2012,29,SD,51,61,-10
2012,29,TN,507,498,9
2012,29,TX,23902,24551,-649
2012,29,UT,61,49,12
2012,29,VA,2639,2671,-32
2012,29,VI,6,11,-5
2012,29,VT,50,45,5
2012,29,WA,396,402,-6
2012,29,WI,201,206,-5
2012,29,WV,222,228,-6
2012,29,WY,33,38,-5
2012,30,AK,33,36,-3
2012,30,AL,894,890,4
2012,30,AR,189,184,5
2012,30,AZ,443,525,-82
2012,30,CA,2157,2130,27
2012,30,CO,274,246,28
2012,30,CT,450,450,0
2012,30,DC,25,19,6
2012,30,DE,416,411,5
2012,30,FL,42548,40661,1887
2012,30,GA,1965,1887,78
2012,30,HI,458,445,13
2012,30,IA,216,265,-49
2012,30,ID,63,67,-4
2012,30,IL,501,520,-19
2012,30,IN,415,413,2
2012,30,KS,219,249,-30
2012,30,KY,277,267,10
2012,30,LA,10981,10961,20
2012,30,MA,816,751,65
2012,30,MD,1132,1098,34
2012,30,ME,105,109,-4
2012,30,MI,223,221,2
2012,30,MN,149,110,39
2012,30,MO,301,334,-33
2012,30,MS,1327,1288,39
2012,30,MT,82,103,-21
2012,30,NC,2856,2855,1
2012,30,ND,118,127,-9
2012,30,NE,134,137,-3
2012,30,NH,113,106,7
2012,30,NJ,2570,2481,89
2012,30,NM,195,155,40
2012,30,NV,137,122,15
2012,30,NY,2436,2302,134
2012,30,OH,414,402,12
2012,30,OK,262,257,5
2012,30,OR,329,340,-11
2012,30,PA,855,832,23
2012,30,PR,180,211,-31
2012,30,RI,262,264,-2
2012,30,SC,3562,3532,30
2012,30,SD,62,62,0
2012,30,TN,437,430,7
2012,30,TX,22101,22294,-193
2012,30,UT,49,51,-2
2012,30,VA,2659,2600,59
2012,30,VI,5,6,-1
2012,30,VT,46,34,12
2012,30,WA,370,372,-2
2012,30,WI,220,225,-5
2012,30,WV,202,216,-14
2012,30,WY,36,40,-4
2012,31,AK,47,45,2
2012,31,AL,1174,1162,12
2012,31,AR,167,175,-8
2012,31,AZ,406,426,-20
2012,31,CA,2117,2085,32
2012,31,CO,340,207,133
2012,31,CT,463,468,-5
2012,31,DC,39,31,8
2012,31,DE,369,364,5
2012,31,FL,40248,39848,400
2012,31,GA,2095,2088,7
2012,31,GU,1,1,0
2012,31,HI,983,964,19
2012,31,IA,193,215,-22
2012,31,ID,68,72,-4
2012,31,IL,533,535,-2
2012,31,IN,308,316,-8
2012,31,KS,181,183,-2
2012,31,KY,228,220,8
2012,31,LA,10626,10569,57
2012,31,MA,854,756,98
2012,31,MD,1060,1033,27
2012,31,ME,110,103,7
2012,31,MI,209,189,20
2012,31,MN,132,108,24
2012,31,MO,354,373,-19
2012,31,MS,1285,1285,0
2012,31,MT,54,53,1
2012,31,NC,2667,2672,-5
2012,31,ND,79,92,-13
2012,31,NE,122,131,-9
2012,31,NH,80,82,-2
2012,31,NJ,3261,3206,55
2012,31,NM,186,163,23
2012,31,NV,168,175,-7
2012,31,NY,2293,2227,66
2012,31,OH,446,447,-1
2012,31,OK,268,273,-5
2012,31,OR,269,270,-1
2012,31,PA,981,977,4
2012,31,PR,252,167,85
2012,31,RI,280,282,-2
2012,31,SC,3899,3878,21
2012,31,SD,51,50,1
2012,31,TN,488,503,-15
2012,31,TX,18371,18823,-452
2012,31,UT,58,60,-2
2012,31,VA,2955,2913,42
2012,31,VI,19,18,1
2012,31,VT,31,32,-1
2012,31,WA,385,399,-14
2012,31,WI,181,179,2
2012,31,WV,186,193,-7
2012,31,WY,31,28,3
2012,32,AK,30,35,-5
2012,32,AL,959,949,10
2012,32,AR,191,181,10
2012,32,AZ,543,622,-79
2012,32,CA,2097,2056,41
2012,32,CO,626,249,377
2012,32,CT,551,547,4
2012,32,DC,274,266,8
2012,32,DE,381,383,-2
2012,32,FL,36594,35447,1147
2012,32,GA,2046,2181,-135
2012,32,HI,1207,1204,3
2012,32,IA,170,215,-45
2012,32,ID,64,56,8
2012,32,IL,384,491,-107
2012,32,IN,371,384,-13
2012,32,KS,171,176,-5
2012,32,KY,250,244,6
2012,32,LA,10423,10440,-17
2012,32,MA,725,679,46
2012,32,MD,938,897,41
2012,32,ME,120,120,0
2012,32,MI,215,179,36
2012,32,MN,120,102,18
2012,32,MO,447,451,-4
2012,32,MS,1304,1276,28
2012,32,MT,54,53,1
2012,32,NC,3090,3120,-30
2012,32,ND,105,105,0
2012,32,NE,127,146,-19
2012,32,NH,84,88,-4
2012,32,NJ,2696,2654,42
2012,32,NM,190,181,9
2012,32,NV,150,138,12
2012,32,NY,2632,2541,91
2012,32,OH,403,411,-8
2012,32,OK,288,279,9
2012,32,OR,344,352,-8
2012,32,PA,897,878,19
2012,32,PR,10127,10206,-79
2012,32,RI,314,317,-3
2012,32,SC,3997,3991,6
2012,32,SD,71,77,-6
2012,32,TN,493,491,2
2012,32,TX,19101,19474,-373
2012,32,UT,59,54,5
2012,32,VA,2494,2543,-49
2012,32,VI,10,10,0
2012,32,VT,49,48,1
2012,32,WA,367,391,-24
2012,32,WI,174,177,-3
2012,32,WV,216,208,8
2012,32,WY,33,34,-1
2012,33,AK,28,32,-4
2012,33,AL,838,815,23
2012,33,AR,209,214,-5
2012,33,AZ,485,476,9
2012,33,CA,2008,1995,13
2012,33,CO,576,253,323
2012,33,CT,529,515,14
2012,33,DC,29,21,8
2012,33,DE,386,382,4
2012,33,FL,36315,35634,681
2012,33,GA,2018,2077,-59
2012,33,HI,561,543,18
2012,33,IA,203,220,-17
2012,33,ID,65,64,1
2012,33,IL,444,437,7
2012,33,IN,305,304,1
2012,33,KS,147,136,11
2012,33,KY,253,247,6
2012,33,LA,9581,9538,43
2012,33,MA,794,762,32
2012,33,MD,901,871,30
2012,33,ME,123,122,1
2012,33,MI,204,182,22
2012,33,MN,149,136,13
2012,33,MO,234,241,-7
2012,33,MS,1351,1315,36
2012,33,MT,76,85,-9
2012,33,NC,3035,3006,29
2012,33,ND,164,169,-5
2012,33,NE,107,107,0
2012,33,NH,70,59,11
2012,33,NJ,3571,3515,56
2012,33,NM,185,173,12
2012,33,NV,171,164,7
2012,33,NY,2654,2578,76
2012,33,OH,407,406,1
2012,33,OK,282,290,-8
2012,33,OR,289,312,-23
2012,33,PA,1267,1250,17
2012,33,PR,166,320,-154
2012,33,RI,303,316,-13
2012,33,SC,3775,3751,24
2012,33,SD,74,88,-14
2012,33,TN,513,521,-8
2012,33,TX,18212,18212,0
2012,33,UT,54,40,14
2012,33,VA,2555,2573,-18
2012,33,VI,26,25,1
2012,33,VT,38,38,0
2012,33,WA,385,448,-63
2012,33,WI,180,172,8
2012,33,WV,224,220,4
2012,33,WY,25,23,2
2012,34,AK,33,35,-2
2012,34,AL,1027,1027,0
2012,34,AR,214,203,11
2012,34,AZ,489,587,-98
2012,34,CA,2084,2078,6
2012,34,CO,420,288,132
2012,34,CT,661,647,14
2012,34,DC,25,20,5
2012,34,DE,350,346,4
2012,34,FL,36061,35493,568
2012,34,GA,1809,1841,-32
2012,34,GU,4,3,1
2012,34,HI,2503,2498,5
2012,34,IA,202,214,-12
2012,34,ID,72,67,5
2012,34,IL,637,664,-27
2012,34,IN,342,359,-17
2012,34,KS,147,149,-2
2012,34,KY,261,253,8
2012,34,LA,9521,9560,-39
2012,34,MA,948,796,152
2012,34,MD,1004,973,31
2012,34,ME,120,113,7
2012,34,MI,187,170,17
2012,34,MN,115,87,28
2012,34,MO,256,255,1
2012,34,MS,1249,1221,28
2012,34,MT,71,75,-4
2012,34,NC,2931,2953,-22
2012,34,ND,155,157,-2
2012,34,NE,114,109,5
2012,34,NH,88,90,-2
2012,34,NJ,2881,2821,60
2012,34,NM,152,150,2
2012,34,NV,157,165,-8
2012,34,NY,3195,3034,161
2012,34,OH,438,433,5
2012,34,OK,207,213,-6
2012,34,OR,384,388,-4
2012,34,PA,910,893,17
2012,34,PR,134,184,-50
2012,34,RI,319,325,-6
2012,34,SC,4055,3981,74
2012,34,SD,108,113,-5
2012,34,TN,485,476,9
2012,34,TX,16078,16399,-321
2012,34,UT,42,38,4
2012,34,VA,2494,2495,-1
2012,34,VI,32,35,-3
2012,34,VT,51,45,6
2012,34,WA,393,398,-5
2012,34,WI,225,223,2
2012,34,WV,216,229,-13
2012,34,WY,64,62,2
2012,35,AK,46,56,-10
2012,35,AL,907,887,20
2012,35,AR,197,199,-2
2012,35,AZ,508,472,36
2012,35,CA,2437,2444,-7
2012,35,CO,469,309,160
2012,35,CT,620,614,6
2012,35,DC,102,103,-1
2012,35,DE,828,636,192
2012,35,FL,40717,40583,134
2012,35,GA,2241,2268,-27
2012,35,GU,3,3,0
2012,35,HI,2616,2608,8
2012,35,IA,192,208,-16
2012,35,ID,53,54,-1
2012,35,IL,536,563,-27
2012,35,IN,312,308,4
2012,35,KS,180,164,16
2012,35,KY,274,255,19
2012,35,LA,11294,11446,-152
2012,35,MA,1048,998,50
2012,35,MD,1151,1106,45
2012,35,ME,143,143,0
2012,35,MI,208,199,9
2012,35,MN,149,137,12
2012,35,MO,320,302,18
2012,35,MS,1900,1859,41
2012,35,MT,54,48,6
2012,35,NC,3353,3314,39
2012,35,ND,230,237,-7
2012,35,NE,112,114,-2
2012,35,NH,143,145,-2
2012,35,NJ,3586,3517,69
2012,35,NM,185,192,-7
2012,35,NV,159,165,-6
2012,35,NY,3369,3270,99
2012,35,OH,530,530,0
2012,35,OK,229,230,-1
2012,35,OR,435,579,-144
2012,35,PA,1009,1014,-5
2012,35,PR,294,293,1
2012,35,RI,384,392,-8
2012,35,SC,4127,4168,-41
2012,35,SD,153,169,-16
2012,35,TN,516,535,-19
2012,35,TX,17868,18428,-560
2012,35,UT,50,38,12
2012,35,VA,3846,3824,22
2012,35,VI,13,14,-1
2012,35,VT,37,40,-3
2012,35,WA,480,523,-43
2012,35,WI,229,208,21
2012,35,WV,242,249,-7
2012,35,WY,27,24,3
2012,36,AK,31,30,1
2012,36,AL,859,821,38
2012,36,AR,161,147,14
2012,36,AZ,426,329,97
2012,36,CA,1963,1944,19
2012,36,CO,349,282,67
2012,36,CT,484,458,26
2012,36,DC,32,21,11
2012,36,DE,378,368,10
2012,36,FL,29300,28981,319
2012,36,GA,1603,1619,-16
2012,36,GU,1,1,0
2012,36,HI,383,385,-2
2012,36,IA,165,169,-4
2012,36,ID,49,55,-6
2012,36,IL,408,523,-115
2012,36,IN,268,277,-9
2012,36,KS,141,138,3
2012,36,KY,217,226,-9
2012,36,LA,7575,7483,92
2012,36,MA,650,623,27
2012,36,MD,888,823,65
2012,36,ME,96,96,0
2012,36,MI,152,132,20
2012,36,MN,132,115,17
2012,36,MO,231,243,-12
2012,36,MS,1107,1080,27
2012,36,MT,33,31,2
2012,36,NC,2511,2519,-8
2012,36,ND,251,285,-34
2012,36,NE,67,73,-6
2012,36,NH,104,106,-2
2012,36,NJ,2859,2811,48
2012,36,NM,157,167,-10
2012,36,NV,127,129,-2
2012,36,NY,2975,2641,334
2012,36,OH,418,411,7
2012,36,OK,198,187,11
2012,36,OR,537,555,-18
2012,36,PA,795,788,7
2012,36,PR,298,299,-1
2012,36,RI,255,245,10
2012,36,SC,2978,2962,16
2012,36,SD,51,59,-8
2012,36,TN,446,438,8
2012,36,TX,13492,13652,-160
2012,36,UT,72,55,17
2012,36,VA,2265,2232,33
2012,36,VI,11,13,-2
2012,36,VT,67,36,31
2012,36,WA,348,373,-25
2012,36,WI,173,171,2
2012,36,WV,209,206,3
2012,36,WY,22,21,1
2012,37,AK,43,42,1
2012,37,AL,921,890,31
2012,37,AR,223,199,24
2012,37,AZ,427,345,82
2012,37,CA,2363,2342,21
2012,37,CO,341,300,41
2012,37,CT,464,457,7
2012,37,DC,30,25,5
2012,37,DE,395,388,7
2012,37,FL,31181,30731,450
2012,37,GA,1616,1577,39
2012,37,HI,1729,1248,481
2012,37,IA,203,207,-4
2012,37,ID,56,59,-3
2012,37,IL,460,468,-8
2012,37,IN,306,302,4
2012,37,KS,161,160,1
2012,37,KY,300,304,-4
2012,37,LA,8042,8033,9
2012,37,MA,844,754,90
2012,37,MD,993,812,181
2012,37,ME,148,143,5
2012,37,MI,174,169,5
2012,37,MN,121,120,1
2012,37,MO,260,249,11
2012,37,MS,1086,1096,-10
2012,37,MT,65,63,2
2012,37,NC,2465,2423,42
2012,37,ND,254,305,-51
2012,37,NE,95,91,4
2012,37,NH,131,128,3
2012,37,NJ,3104,3037,67
2012,37,NM,165,162,3
2012,37,NV,121,112,9
2012,37,NY,3395,3292,103
2012,37,OH,438,452,-14
2012,37,OK,225,215,10
2012,37,OR,469,474,-5
2012,37,PA,904,857,47
2012,37,PR,163,173,-10
2012,37,RI,340,336,4
2012,37,SC,3444,3408,36
2012,37,SD,60,59,1
2012,37,TN,407,388,19
2012,37,TX,12480,12624,-144
2012,37,UT,49,43,6
2012,37,VA,2318,2312,6
2012,37,VI,25,19,6
2012,37,VT,38,28,10
2012,37,WA,393,447,-54
2012,37,WI,178,175,3
2012,37,WV,229,249,-20
2012,37,WY,25,24,1
2012,38,AK,38,34,4
2012,38,AL,929,905,24
2012,38,AR,179,172,7
2012,38,AZ,500,365,135
2012,38,CA,2371,2367,4
2012,38,CO,226,206,20
2012,38,CT,535,530,5
2012,38,DC,71,71,0
2012,38,DE,345,345,0
2012,38,FL,31799,30865,934
2012,38,GA,1786,1796,-10
2012,38,GU,3,3,0
2012,38,HI,531,532,-1
2012,38,IA,162,159,3
2012,38,ID,69,70,-1
2012,38,IL,445,452,-7
2012,38,IN,317,299,18
2012,38,KS,130,129,1
2012,38,KY,292,295,-3
2012,38,LA,7943,7916,27
2012,38,MA,939,940,-1
2012,38,MD,925,878,47
2012,38,ME,110,110,0
2012,38,MI,251,262,-11
2012,38,MN,111,112,-1
2012,38,MO,283,277,6
2012,38,MS,1128,1133,-5
2012,38,MT,58,55,3
2012,38,NC,2492,2521,-29
2012,38,ND,224,263,-39
2012,38,NE,81,83,-2
2012,38,NH,120,121,-1
2012,38,NJ,3568,3403,165
2012,38,NM,185,177,8
2012,38,NV,136,128,8
2012,38,NY,3087,3030,57
2012,38,OH,440,451,-11
2012,38,OK,241,241,0
2012,38,OR,474,487,-13
2012,38,PA,946,904,42
2012,38,PR,219,272,-53
2012,38,RI,251,251,0
2012,38,SC,3665,3514,151
2012,38,SD,97,92,5
2012,38,TN,511,648,-137
2012,38,TX,12210,12513,-303
2012,38,UT,72,62,10
2012,38,VA,2230,2125,105
2012,38,VI,13,15,-2
2012,38,VT,39,37,2
2012,38,WA,461,513,-52
2012,38,WI,179,177,2
2012,38,WV,194,214,-20
2012,38,WY,22,21,1
2012,39,AK,42,46,-4
2012,39,AL,873,787,86
2012,39,AR,243,207,36
2012,39,AZ,523,470,53
2012,39,CA,2589,2519,70
2012,39,CO,285,219,66
2012,39,CT,749,750,-1
2012,39,DC,306,315,-9
2012,39,DE,542,554,-12
2012,39,FL,37327,37034,293
2012,39,GA,1962,1985,-23
2012,39,GU,2,3,-1
2012,39,HI,1917,2197,-280
2012,39,IA,339,332,7
2012,39,ID,56,53,3
2012,39,IL,489,514,-25
2012,39,IN,304,315,-11
2012,39,KS,151,155,-4
2012,39,KY,311,301,10
2012,39,LA,9016,8947,69
2012,39,MA,1288,1173,115
2012,39,MD,1358,1387,-29
2012,39,ME,141,143,-2
2012,39,MI,212,215,-3
2012,39,MN,144,145,-1
2012,39,MO,292,284,8
2012,39,MS,1151,1094,57
2012,39,MT,41,53,-12
2012,39,NC,2916,2912,4
2012,39,ND,224,231,-7
2012,39,NE,92,94,-2
2012,39,NH,155,151,4
2012,39,NJ,3739,3856,-117
2012,39,NM,129,133,-4
2012,39,NV,172,180,-8
2012,39,NY,4239,4339,-100
2012,39,OH,521,526,-5
2012,39,OK,238,226,12
2012,39,OR,491,651,-160
2012,39,PA,1098,1106,-8
2012,39,PR,204,214,-10
2012,39,RI,403,423,-20
2012,39,SC,3706,3635,71
2012,39,SD,71,72,-1
2012,39,TN,508,477,31
2012,39,TX,13180,13445,-265
2012,39,UT,67,63,4
2012,39,VA,2967,3096,-129
2012,39,VI,14,19,-5
2012,39,VT,53,47,6
2012,39,WA,558,654,-96
2012,39,WI,200,196,4
2012,39,WV,196,201,-5
2012,39,WY,21,24,-3
2012,40,AK,31,35,-4
2012,40,AL,920,918,2
2012,40,AR,205,187,18
2012,40,AZ,376,334,42
2012,40,CA,2926,2908,18
2012,40,CO,257,206,51
2012,40,CT,623,622,1
2012,40,DC,41,34,7
2012,40,DE,477,475,2
2012,40,FL,40402,40954,-552
2012,40,GA,2026,1907,119
2012,40,GU,1,2,-1
2012,40,HI,1001,991,10
2012,40,IA,163,180,-17
2012,40,ID,52,56,-4
2012,40,IL,506,465,41
2012,40,IN,302,287,15
2012,40,KS,134,116,18
2012,40,KY,296,297,-1
2012,40,LA,7514,7339,175
2012,40,MA,918,831,87
2012,40,MD,1470,1444,26
2012,40,ME,170,174,-4
2012,40,MI,167,174,-7
2012,40,MN,145,139,6
2012,40,MO,283,270,13
2012,40,MS,1010,972,38
2012,40,MT,36,36,0
2012,40,NC,2676,2714,-38
2012,40,ND,226,277,-51
2012,40,NE,109,104,5
2012,40,NH,120,127,-7
2012,40,NJ,4076,4071,5
2012,40,NM,153,149,4
2012,40,NV,137,125,12
2012,40,NY,4085,4038,47
2012,40,OH,480,470,10
2012,40,OK,241,244,-3
2012,40,OR,441,473,-32
2012,40,PA,1023,1007,16
2012,40,PR,758,771,-13
2012,40,RI,254,249,5
2012,40,SC,4570,4593,-23
2012,40,SD,58,61,-3
2012,40,TN,502,527,-25
2012,40,TX,11839,12289,-450
2012,40,UT,77,69,8
2012,40,VA,3024,2992,32
2012,40,VI,10,10,0
2012,40,VT,63,68,-5
2012,40,WA,638,749,-111
2012,40,WI,177,166,11
2012,40,WV,216,216,0
2012,40,WY,31,29,2
2012,41,AK,29,28,1
2012,41,AL,818,825,-7
2012,41,AR,163,150,13
2012,41,AZ,413,358,55
2012,41,CA,2921,3061,-140
2012,41,CO,231,175,56
2012,41,CT,554,531,23
2012,41,DC,39,36,3
2012,41,DE,420,417,3
2012,41,FL,27452,27552,-100
2012,41,GA,1544,1585,-41
2012,41,HI,656,666,-10
2012,41,IA,154,157,-3
2012,41,ID,59,58,1
2012,41,IL,379,399,-20
2012,41,IN,257,267,-10
2012,41,KS,118,118,0
2012,41,KY,210,213,-3
2012,41,LA,6436,6228,208
2012,41,MA,1040,941,99
2012,41,MD,1037,982,55
2012,41,ME,146,148,-2
2012,41,MI,180,174,6
2012,41,MN,117,113,4
2012,41,MO,255,242,13
2012,41,MS,975,956,19
2012,41,MT,41,37,4
2012,41,NC,2298,2325,-27
2012,41,ND,206,241,-35
2012,41,NE,65,64,1
2012,41,NH,90,90,0
2012,41,NJ,2951,2946,5
2012,41,NM,119,123,-4
2012,41,NV,155,150,5
2012,41,NY,3759,3718,41
2012,41,OH,438,434,4
2012,41,OK,267,264,3
2012,41,OR,406,401,5
2012,41,PA,1242,1254,-12
2012,41,PR,151,162,-11
2012,41,RI,231,235,-4
2012,41,SC,2816,2793,23
2012,41,SD,67,71,-4
2012,41,TN,432,435,-3
2012,41,TX,10206,10609,-403
2012,41,UT,62,44,18
2012,41,VA,2225,2231,-6
2012,41,VI,17,16,1
2012,41,VT,83,84,-1
2012,41,WA,583,726,-143
2012,41,WI,137,142,-5
2012,41,WV,224,238,-14
2012,41,WY,20,19,1
2012,42,AK,45,39,6
2012,42,AL,617,590,27
2012,42,AR,207,201,6
2012,42,AZ,403,387,16
2012,42,CA,3768,3807,-39
2012,42,CO,205,204,1
2012,42,CT,581,572,9
2012,42,DC,41,87,-46
2012,42,DE,399,379,20
2012,42,FL,30300,30871,-571
2012,42,GA,1493,1505,-12
2012,42,GU,1,2,-1
2012,42,HI,462,448,14
2012,42,IA,217,216,1
2012,42,ID,89,93,-4
2012,42,IL,447,443,4
2012,42,IN,349,349,0
2012,42,KS,140,153,-13
2012,42,KY,233,234,-1
2012,42,LA,7167,7124,43
2012,42,MA,1051,909,142
2012,42,MD,1041,992,49
2012,42,ME,200,202,-2
2012,42,MI,168,182,-14
2012,42,MN,111,118,-7
2012,42,MO,283,268,15
2012,42,MS,935,907,28
2012,42,MT,40,44,-4
2012,42,NC,2189,2199,-10
2012,42,ND,228,288,-60
2012,42,NE,97,93,4
2012,42,NH,73,77,-4
2012,42,NJ,3704,3640,64
2012,42,NM,128,128,0
2012,42,NV,171,153,18
2012,42,NY,3203,3100,103
2012,42,OH,465,470,-5
2012,42,OK,219,213,6
2012,42,OR,600,594,6
2012,42,PA,1221,1194,27
2012,42,PR,202,210,-8
2012,42,RI,235,235,0
2012,42,SC,3010,3047,-37
2012,42,SD,48,47,1
2012,42,TN,430,422,8
2012,42,TX,11768,12178,-410
2012,42,UT,79,58,21
2012,42,VA,2157,2135,22
2012,42,VI,11,10,1
2012,42,VT,65,63,2
2012,42,WA,750,913,-163
2012,42,WI,171,163,8
2012,42,WV,200,216,-16
2012,42,WY,25,26,-1
2012,43,AK,48,36,12
2012,43,AL,707,711,-4
2012,43,AR,194,201,-7
2012,43,AZ,483,480,3
2012,43,CA,4103,4226,-123
2012,43,CO,301,224,77
2012,43,CT,618,604,14
2012,43,DC,40,46,-6
2012,43,DE,469,472,-3
2012,43,FL,27879,28120,-241
2012,43,GA,2160,2248,-88
2012,43,GU,1,1,0
2012,43,HI,911,912,-1
2012,43,IA,130,122,8
2012,43,ID,63,62,1
2012,43,IL,425,439,-14
2012,43,IN,329,342,-13
2012,43,KS,140,147,-7
2012,43,KY,263,274,-11
2012,43,LA,6407,6336,71
2012,43,MA,943,832,111
2012,43,MD,1130,1063,67
2012,43,ME,131,133,-2
2012,43,MI,202,194,8
2012,43,MN,146,153,-7
2012,43,MO,253,249,4
2012,43,MS,993,965,28
2012,43,MT,43,40,3
2012,43,NC,2035,2020,15
2012,43,ND,204,254,-50
2012,43,NE,80,84,-4
2012,43,NH,98,97,1
2012,43,NJ,3245,3167,78
2012,43,NM,130,124,6
2012,43,NV,533,150,383
2012,43,NY,2864,2724,140
2012,43,OH,494,509,-15
2012,43,OK,265,269,-4
2012,43,OR,453,463,-10
2012,43,PA,1490,1224,266
2012,43,PR,242,199,43
2012,43,RI,219,215,4
2012,43,SC,2570,2552,18
2012,43,SD,70,76,-6
2012,43,TN,482,476,6
2012,43,TX,10406,10897,-491
2012,43,UT,65,56,9
2012,43,VA,2370,2285,85
2012,43,VI,11,7,4
2012,43,VT,58,55,3
2012,43,WA,754,935,-181
2012,43,WI,154,171,-17
2012,43,WV,205,204,1
2012,43,WY,24,27,-3
2012,44,AK,36,34,2
2012,44,AL,957,961,-4
2012,44,AR,200,177,23
2012,44,AZ,347,327,20
2012,44,CA,4066,4236,-170
2012,44,CO,361,378,-17
2012,44,CT,575,563,12
2012,44,DC,24,24,0
2012,44,DE,469,480,-11
2012,44,FL,33783,34309,-526
2012,44,GA,1982,2052,-70
2012,44,GU,1,0,1
2012,44,HI,1538,1537,1
2012,44,IA,176,180,-4
2012,44,ID,71,73,-2
2012,44,IL,636,642,-6
2012,44,IN,310,330,-20
2012,44,KS,154,167,-13
2012,44,KY,275,266,9
2012,44,LA,7581,7520,61
2012,44,MA,840,816,24
2012,44,MD,1198,1011,187
2012,44,ME,131,133,-2
2012,44,MI,218,217,1
2012,44,MN,139,135,4
2012,44,MO,290,282,8
2012,44,MS,950,927,23
2012,44,MT,58,57,1
2012,44,NC,2280,2304,-24
2012,44,ND,240,328,-88
2012,44,NE,92,92,0
2012,44,NH,169,168,1
2012,44,NJ,3636,3650,-14
2012,44,NM,122,117,5
2012,44,NV,203,178,25
2012,44,NY,3603,3549,54
2012,44,OH,446,463,-17
2012,44,OK,279,258,21
2012,44,OR,686,703,-17
2012,44,PA,1261,1252,9
2012,44,PR,141,140,1
2012,44,RI,264,259,5
2012,44,SC,3239,3201,38
2012,44,SD,63,63,0
2012,44,TN,441,453,-12
2012,44,TX,12108,12596,-488
2012,44,UT,59,44,15
2012,44,VA,2057,2036,21
2012,44,VI,10,10,0
2012,44,VT,82,83,-1
2012,44,WA,1087,1217,-130
2012,44,WI,173,176,-3
2012,44,WV,188,177,11
2012,44,WY,24,28,-4
2012,45,AK,37,30,7
2012,45,AL,733,745,-12
2012,45,AR,175,174,1
2012,45,AZ,265,248,17
2012,45,CA,4118,4296,-178
2012,45,CO,187,181,6
2012,45,CT,439,439,0
2012,45,DC,34,28,6
2012,45,DE,268,259,9
2012,45,FL,23665,24007,-342
2012,45,GA,1374,1386,-12
2012,45,HI,695,684,11
2012,45,IA,113,124,-11
2012,45,ID,62,59,3
2012,45,IL,384,388,-4
2012,45,IN,284,289,-5
2012,45,KS,86,86,0
2012,45,KY,254,226,28
2012,45,LA,5214,5133,81
2012,45,MA,694,618,76
2012,45,MD,711,682,29
2012,45,ME,143,143,0
2012,45,MI,175,176,-1
2012,45,MN,84,82,2
2012,45,MO,294,295,-1
2012,45,MS,891,906,-15
2012,45,MT,38,37,1
2012,45,NC,1760,1773,-13
2012,45,ND,150,159,-9
2012,45,NE,76,71,5
2012,45,NH,130,125,5
2012,45,NJ,2941,2911,30
2012,45,NM,105,96,9
2012,45,NV,165,132,33
2012,45,NY,2442,2344,98
2012,45,OH,401,395,6
2012,45,OK,188,185,3
2012,45,OR,487,488,-1
2012,45,PA,927,906,21
2012,45,PR,114,134,-20
2012,45,RI,160,161,-1
2012,45,SC,2400,2381,19
2012,45,SD,50,49,1
2012,45,TN,345,338,7
2012,45,TX,7588,7877,-289
2012,45,UT,45,45,0
2012,45,VA,1529,1537,-8
2012,45,VI,10,11,-1
2012,45,VT,54,55,-1
2012,45,WA,970,1098,-128
2012,45,WI,143,147,-4
2012,45,WV,181,203,-22
2012,45,WY,24,25,-1
2012,46,AK,29,19,10
2012,46,AL,517,501,16
2012,46,AR,153,145,8
2012,46,AZ,343,314,29
2012,46,CA,4319,4994,-675
2012,46,CO,357,298,59
2012,46,CT,615,595,20
2012,46,DC,23,24,-1
2012,46,DE,396,384,12
2012,46,FL,24061,24015,46
2012,46,GA,1374,1395,-21
2012,46,GU,1,1,0
2012,46,HI,494,471,23
2012,46,IA,132,126,6
2012,46,ID,65,60,5
2012,46,IL,410,415,-5
2012,46,IN,268,275,-7
2012,46,KS,126,128,-2
2012,46,KY,233,221,12
2012,46,LA,5659,5659,0
2012,46,MA,699,627,72
2012,46,MD,867,843,24
2012,46,ME,135,134,1
2012,46,MI,156,156,0
2012,46,MN,117,109,8
2012,46,MO,191,191,0
2012,46,MS,939,941,-2
2012,46,MT,36,33,3
2012,46,NC,1994,1966,28
2012,46,ND,109,109,0
2012,46,NE,75,77,-2
2012,46,NH,86,86,0
2012,46,NJ,3265,3233,32
2012,46,NM,110,115,-5
2012,46,NV,189,170,19
2012,46,NY,2541,2452,89
2012,46,OH,404,404,0
2012,46,OK,212,207,5
2012,46,OR,523,516,7
2012,46,PA,933,933,0
2012,46,PR,927,896,31
2012,46,RI,171,173,-2
2012,46,SC,2494,2451,43
2012,46,SD,48,45,3
2012,46,TN,339,354,-15
2012,46,TX,8175,8162,13
2012,46,UT,66,53,13
2012,46,VA,1669,1629,40
2012,46,VI,3,13,-10
2012,46,VT,50,54,-4
2012,46,WA,832,953,-121
2012,46,WI,143,141,2
2012,46,WV,187,203,-16
2012,46,WY,16,23,-7
2012,47,AK,26,25,1
2012,47,AL,470,467,3
2012,47,AR,160,149,11
2012,47,AZ,301,287,14
2012,47,CA,3996,4035,-39
2012,47,CO,183,159,24
2012,47,CT,428,405,23
2012,47,DC,34,22,12
2012,47,DE,271,255,16
2012,47,FL,22419,22816,-397
2012,47,GA,1137,1151,-14
2012,47,HI,899,1359,-460
2012,47,IA,114,116,-2
2012,47,ID,67,57,10
2012,47,IL,413,434,-21
2012,47,IN,246,262,-16
2012,47,KS,109,116,-7
2012,47,KY,232,224,8
2012,47,LA,5310,5331,-21
2012,47,MA,733,637,96
2012,47,MD,908,831,77
2012,47,ME,115,113,2
2012,47,MI,162,157,5
2012,47,MN,101,94,7
2012,47,MO,306,323,-17
2012,47,MS,952,975,-23
2012,47,MT,36,34,2
2012,47,NC,1697,1711,-14
2012,47,ND,105,102,3
2012,47,NE,72,71,1
2012,47,NH,62,58,4
2012,47,NJ,2901,2807,94
2012,47,NM,99,112,-13
2012,47,NV,153,144,9
2012,47,NY,2693,2457,236
2012,47,OH,414,627,-213
2012,47,OK,177,162,15
2012,47,OR,507,508,-1
2012,47,PA,867,830,37
2012,47,PR,145,148,-3
2012,47,RI,179,175,4
2012,47,SC,2234,2181,53
2012,47,SD,43,39,4
2012,47,TN,374,360,14
2012,47,TX,7482,7669,-187
2012,47,UT,56,53,3
2012,47,VA,1573,1534,39
2012,47,VI,9,10,-1
2012,47,VT,57,52,5
2012,47,WA,869,932,-63
2012,47,WI,115,113,2
2012,47,WV,196,205,-9
2012,47,WY,19,17,2
2012,48,AK,39,32,7
2012,48,AL,855,830,25
2012,48,AR,181,172,9
2012,48,AZ,369,333,36
2012,48,CA,4459,4273,186
2012,48,CO,219,178,41
2012,48,CT,967,913,54
2012,48,DC,61,30,31
2012,48,DE,418,333,85
2012,48,FL,30478,30239,239
2012,48,GA,1406,1263,143
2012,48,GU,2,1,1
2012,48,HI,1446,1416,30
2012,48,IA,124,135,-11
2012,48,ID,64,59,5
2012,48,IL,499,483,16
2012,48,IN,256,259,-3
2012,48,KS,134,122,12
2012,48,KY,226,213,13
2012,48,LA,5996,5981,15
2012,48,MA,785,673,112
2012,48,MD,1332,1045,287
2012,48,ME,138,116,22
2012,48,MI,222,161,61
2012,48,MN,123,109,14
2012,48,MO,213,202,11
2012,48,MS,929,876,53
2012,48,MT,61,55,6
2012,48,NC,1896,1819,77
2012,48,ND,105,119,-14
2012,48,NE,84,78,6
2012,48,NH,217,200,17
2012,48,NJ,3281,2987,294
2012,48,NM,130,122,8
2012,48,NV,143,127,16
2012,48,NY,3152,2710,442
2012,48,OH,435,404,31
2012,48,OK,173,149,24
2012,48,OR,590,573,17
2012,48,PA,1080,907,173
2012,48,PR,235,311,-76
2012,48,RI,224,207,17
2012,48,SC,2788,2697,91
2012,48,SD,45,48,-3
2012,48,TN,524,368,156
2012,48,TX,9044,8992,52
2012,48,UT,74,59,15
2012,48,VA,2136,1836,300
2012,48,VI,4,3,1
2012,48,VT,87,62,25
2012,48,WA,908,917,-9
2012,48,WI,142,123,19
2012,48,WV,179,183,-4
2012,48,WY,15,16,-1
2012,49,AK,28,26,2
2012,49,AL,1695,1668,27
2012,49,AR,155,145,10
2012,49,AZ,265,234,31
2012,49,CA,4696,4587,109
2012,49,CO,189,146,43
2012,49,CT,588,513,75
2012,49,DC,33,22,11
2012,49,DE,352,277,75
2012,49,FL,21242,20913,329
2012,49,GA,1107,1084,23
2012,49,GU,2,3,-1
2012,49,HI,304,286,18
2012,49,IA,125,120,5
2012,49,ID,68,64,4
2012,49,IL,389,356,33
2012,49,IN,238,239,-1
2012,49,KS,110,113,-3
2012,49,KY,188,172,16
2012,49,LA,4734,4726,8
2012,49,MA,780,680,100
2012,49,MD,761,624,137
2012,49,ME,139,119,20
2012,49,MI,355,329,26
2012,49,MN,88,84,4
2012,49,MO,255,233,22
2012,49,MS,985,982,3
2012,49,MT,39,37,2
2012,49,NC,1633,1529,104
2012,49,ND,95,96,-1
2012,49,NE,78,72,6
2012,49,NH,92,91,1
2012,49,NJ,2819,2476,343
2012,49,NM,125,123,2
2012,49,NV,132,113,19
2012,49,NY,3089,2447,642
2012,49,OH,401,371,30
2012,49,OK,198,203,-5
2012,49,OR,507,467,40
2012,49,PA,876,758,118
2012,49,PR,177,183,-6
2012,49,RI,216,203,13
2012,49,SC,1935,1825,110
2012,49,SD,51,48,3
2012,49,TN,345,316,29
2012,49,TX,5939,5965,-26
2012,49,UT,49,44,5
2012,49,VA,1517,1340,177
2012,49,VI,45,44,1
2012,49,VT,38,36,2
2012,49,WA,775,779,-4
2012,49,WI,135,117,18
2012,49,WV,162,162,0
2012,49,WY,13,14,-1
2012,50,AK,31,28,3
2012,50,AL,531,511,20
2012,50,AR,137,146,-9
2012,50,AZ,308,262,46
2012,50,CA,4799,4670,129
2012,50,CO,188,170,18
2012,50,CT,531,471,60
2012,50,DC,25,25,0
2012,50,DE,377,316,61
2012,50,FL,26285,25887,398
2012,50,GA,1153,1123,30
2012,50,GU,1,1,0
2012,50,HI,2083,2065,18
2012,50,IA,140,136,4
2012,50,ID,71,62,9
2012,50,IL,371,357,14
2012,50,IN,213,206,7
2012,50,KS,145,141,4
2012,50,KY,204,195,9
2012,50,LA,5634,5598,36
2012,50,MA,603,508,95
2012,50,MD,1089,952,137
2012,50,ME,115,102,13
2012,50,MI,191,177,14
2012,50,MN,82,74,8
2012,50,MO,222,219,3
2012,50,MS,847,804,43
2012,50,MT,45,39,6
2012,50,NC,1778,1665,113
2012,50,ND,113,112,1
2012,50,NE,87,86,1
2012,50,NH,77,75,2
2012,50,NJ,3632,3300,332
2012,50,NM,131,120,11
2012,50,NV,159,142,17
2012,50,NY,3129,2282,847
2012,50,OH,489,489,0
2012,50,OK,183,194,-11
2012,50,OR,488,460,28
2012,50,PA,805,737,68
2012,50,PR,94,105,-11
2012,50,RI,133,125,8
2012,50,SC,2287,2130,157
2012,50,SD,58,60,-2
2012,50,TN,362,327,35
2012,50,TX,6546,6484,62
2012,50,UT,41,41,0
2012,50,VA,1465,1349,116
2012,50,VI,7,10,-3
2012,50,VT,42,36,6
2012,50,WA,736,724,12
2012,50,WI,121,110,11
2012,50,WV,161,161,0
2012,50,WY,21,22,-1
2012,51,AK,25,26,-1
2012,51,AL,593,564,29
2012,51,AR,186,180,6
2012,51,AZ,282,251,31
2012,51,CA,4015,3829,186
2012,51,CO,377,360,17
2012,51,CT,452,417,35
2012,51,DC,34,22,12
2012,51,DE,329,291,38
2012,51,FL,25363,25093,270
2012,51,GA,1171,1159,12
2012,51,GU,2,2,0
2012,51,HI,493,480,13
2012,51,IA,141,139,2
2012,51,ID,71,64,7
2012,51,IL,375,362,13
2012,51,IN,216,230,-14
2012,51,KS,94,90,4
2012,51,KY,307,292,15
2012,51,LA,5397,5464,-67
2012,51,MA,752,718,34
2012,51,MD,788,658,130
2012,51,ME,117,113,4
2012,51,MI,237,222,15
2012,51,MN,101,89,12
2012,51,MO,226,214,12
2012,51,MP,1,1,0
2012,51,MS,839,859,-20
2012,51,MT,41,37,4
2012,51,NC,1735,1709,26
2012,51,ND,156,140,16
2012,51,NE,79,80,-1
2012,51,NH,77,75,2
2012,51,NJ,3074,2797,277
2012,51,NM,121,127,-6
2012,51,NV,132,115,17
2012,51,NY,3134,2374,760
2012,51,OH,340,353,-13
2012,51,OK,168,163,5
2012,51,OR,592,522,70
2012,51,PA,794,775,19
2012,51,PR,239,238,1
2012,51,RI,134,127,7
2012,51,SC,2429,2331,98
2012,51,SD,53,59,-6
2012,51,TN,352,351,1
2012,51,TX,6750,6908,-158
2012,51,UT,55,49,6
2012,51,VA,1385,1329,56
2012,51,VI,7,9,-2
2012,51,VT,48,45,3
2012,51,WA,817,804,13
2012,51,WI,115,107,8
2012,51,WV,181,185,-4
2012,51,WY,22,20,2
2012,52,AK,23,19,4
2012,52,AL,403,380,23
2012,52,AR,116,108,8
2012,52,AZ,234,211,23
2012,52,CA,3310,2812,498
2012,52,CO,174,147,27
2012,52,CT,327,276,51
2012,52,DC,26,17,9
2012,52,DE,212,175,37
2012,52,FL,19640,19512,128
2012,52,GA,740,708,32
2012,52,HI,979,961,18
2012,52,IA,99,83,16
2012,52,ID,37,33,4
2012,52,IL,235,234,1
2012,52,IN,182,189,-7
2012,52,KS,88,87,1
2012,52,KY,173,153,20
2012,52,LA,4064,3978,86
2012,52,MA,709,390,319
2012,52,MD,1006,914,92
2012,52,ME,88,81,7
2012,52,MI,140,117,23
2012,52,MN,60,52,8
2012,52,MO,181,156,25
2012,52,MS,559,547,12
2012,52,MT,28,27,1
2012,52,NC,1029,997,32
2012,52,ND,101,80,21
2012,52,NE,95,95,0
2012,52,NH,57,51,6
2012,52,NJ,2059,1740,319
2012,52,NM,101,94,7
2012,52,NV,104,89,15
2012,52,NY,2227,1428,799
2012,52,OH,273,259,14
2012,52,OK,110,91,19
2012,52,OR,330,306,24
2012,52,PA,606,573,33
2012,52,PR,164,181,-17
2012,52,RI,97,93,4
2012,52,SC,1437,1376,61
2012,52,SD,31,35,-4
2012,52,TN,303,292,11
2012,52,TX,5218,4852,366
2012,52,UN,1,1,0
2012,52,UT,39,36,3
2012,52,VA,953,869,84
2012,52,VI,38,38,0
2012,52,VT,36,26,10
2012,52,WA,554,512,42
2012,52,WI,67,68,-1
2012,52,WV,120,116,4
2012,52,WY,19,19,0
2012,53,AK,9,7,2
2012,53,AL,221,221,0
2012,53,AR,38,41,-3
2012,53,AZ,93,83,10
2012,53,CA,1421,1270,151
2012,53,CO,89,78,11
2012,53,CT,102,86,16
2012,53,DC,9,8,1
2012,53,DE,70,64,6
2012,53,FL,10785,10902,-117
2012,53,GA,367,378,-11
2012,53,HI,124,115,9
2012,53,IA,44,37,7
2012,53,ID,42,42,0
2012,53,IL,89,96,-7
2012,53,IN,76,65,11
2012,53,KS,30,29,1
2012,53,KY,68,71,-3
2012,53,LA,2052,1965,87
2012,53,MA,239,216,23
2012,53,MD,215,174,41
2012,53,ME,30,30,0
2012,53,MI,54,58,-4
2012,53,MN,35,30,5
2012,53,MO,58,62,-4
2012,53,MS,269,277,-8
2012,53,MT,7,11,-4
2012,53,NC,458,465,-7
2012,53,ND,21,32,-11
2012,53,NE,43,45,-2
2012,53,NH,24,21,3
2012,53,NJ,680,614,66
2012,53,NM,33,33,0
2012,53,NV,45,32,13
2012,53,NY,770,580,190
2012,53,OH,105,110,-5
2012,53,OK,67,61,6
2012,53,OR,147,140,7
2012,53,PA,226,211,15
2012,53,PR,91,94,-3
2012,53,RI,35,34,1
2012,53,SC,1120,1107,13
2012,53,SD,17,18,-1
2012,53,TN,107,104,3
2012,53,TX,2262,2332,-70
2012,53,UT,15,16,-1
2012,53,VA,464,479,-15
2012,53,VI,3,4,-1
2012,53,VT,2,2,0
2012,53,WA,205,197,8
2012,53,WI,35,35,0
2012,53,WV,47,46,1
2012,53,WY,4,4,0
2013,0,AK,12,12,0
2013,0,AL,545,530,15
2013,0,AR,97,90,7
2013,0,AZ,253,241,12
2013,0,CA,4510,4390,120
2013,0,CO,172,144,28
2013,0,CT,283,265,18
2013,0,DC,21,13,8
2013,0,DE,364,538,-174
2013,0,FL,23231,23038,193
2013,0,GA,648,621,27
2013,0,GU,3,2,1
2013,0,HI,682,687,-5
2013,0,IA,193,178,15
2013,0,ID,50,45,5
2013,0,IL,240,241,-1
2013,0,IN,143,131,12
2013,0,KS,81,81,0
2013,0,KY,156,145,11
2013,0,LA,3717,3707,10
2013,0,MA,524,486,38
2013,0,MD,480,375,105
2013,0,ME,65,64,1
2013,0,MI,90,93,-3
2013,0,MN,56,55,1
2013,0,MO,116,123,-7
2013,0,MS,522,533,-11
2013,0,MT,32,31,1
2013,0,NC,1272,1249,23
2013,0,ND,65,66,-1
2013,0,NE,67,66,1
2013,0,NH,48,45,3
2013,0,NJ,1680,1495,185
2013,0,NM,87,84,3
2013,0,NV,106,95,11
2013,0,NY,1950,1430,520
2013,0,OH,234,242,-8
2013,0,OK,104,100,4
2013,0,OR,433,412,21
2013,0,PA,524,507,17
2013,0,PR,51,55,-4
2013,0,RI,76,73,3
2013,0,SC,1504,1444,60
2013,0,SD,44,44,0
2013,0,TN,295,298,-3
2013,0,TX,5029,5055,-26
2013,0,UT,27,24,3
2013,0,VA,1654,1615,39
2013,0,VI,8,11,-3
2013,0,VT,33,30,3
2013,0,WA,404,381,23
2013,0,WI,145,146,-1
2013,0,WV,120,122,-2
2013,0,WY,9,9,0
2013,1,AK,29,32,-3
2013,1,AL,484,478,6
2013,1,AR,145,141,4
2013,1,AZ,282,246,36
2013,1,CA,3175,3118,57
2013,1,CO,206,189,17
2013,1,CT,588,566,22
2013,1,DC,27,21,6
2013,1,DE,220,202,18
2013,1,FL,21302,21146,156
2013,1,GA,903,875,28
2013,1,HI,874,876,-2
2013,1,IA,156,127,29
2013,1,ID,53,52,1
2013,1,IL,585,578,7
2013,1,IN,219,203,16
2013,1,KS,139,138,1
2013,1,KY,195,185,10
2013,1,LA,4516,4474,42
2013,1,MA,460,388,72
2013,1,MD,727,652,75
2013,1,ME,103,92,11
2013,1,MI,142,140,2
2013,1,MN,73,80,-7
2013,1,MO,182,181,1
2013,1,MS,840,837,3
2013,1,MT,48,42,6
2013,1,NC,1351,1312,39
2013,1,ND,74,76,-2
2013,1,NE,69,71,-2
2013,1,NH,63,58,5
2013,1,NJ,2478,2160,318
2013,1,NM,118,120,-2
2013,1,NV,159,163,-4
2013,1,NY,2776,1959,817
2013,1,OH,444,432,12
2013,1,OK,159,151,8
2013,1,OR,475,473,2
2013,1,PA,739,656,83
2013,1,PR,74,76,-2
2013,1,RI,304,311,-7
2013,1,SC,1732,1680,52
2013,1,SD,41,45,-4
2013,1,TN,298,291,7
2013,1,TX,5208,5135,73
2013,1,UT,51,48,3
2013,1,VA,1003,976,27
2013,1,VI,6,8,-2
2013,1,VT,44,44,0
2013,1,WA,559,545,14
2013,1,WI,166,148,18
2013,1,WV,178,179,-1
2013,1,WY,25,24,1
2013,2,AK,38,36,2
2013,2,AL,516,508,8
2013,2,AR,134,136,-2
2013,2,AZ,253,230,23
2013,2,CA,3534,3518,16
2013,2,CO,155,137,18
2013,2,CT,444,400,44
2013,2,DC,24,23,1
2013,2,DE,308,290,18
2013,2,FL,22832,22610,222
2013,2,GA,960,955,5
2013,2,GU,1,1,0
2013,2,HI,808,795,13
2013,2,IA,124,123,1
2013,2,ID,46,46,0
2013,2,IL,321,346,-25
2013,2,IN,195,199,-4
2013,2,KS,91,94,-3
2013,2,KY,211,196,15
2013,2,LA,4865,4846,19
2013,2,MA,568,502,66
2013,2,MD,1109,1035,74
2013,2,ME,114,111,3
2013,2,MI,155,137,18
2013,2,MN,72,72,0
2013,2,MO,183,178,5
2013,2,MS,783,787,-4
2013,2,MT,46,42,4
2013,2,NC,1827,1776,51
2013,2,ND,82,85,-3
2013,2,NE,69,72,-3
2013,2,NH,92,95,-3
2013,2,NJ,2658,2373,285
2013,2,NM,105,107,-2
2013,2,NV,169,164,5
2013,2,NY,2952,2227,725
2013,2,OH,305,285,20
2013,2,OK,145,122,23
2013,2,OR,402,404,-2
2013,2,PA,1091,700,391
2013,2,PR,87,96,-9
2013,2,RI,128,126,2
2013,2,SC,2245,2204,41
2013,2,SD,41,43,-2
2013,2,TN,279,259,20
2013,2,TX,5388,5431,-43
2013,2,UT,49,40,9
2013,2,VA,1156,1100,56
2013,2,VI,9,10,-1
2013,2,VT,42,38,4
2013,2,WA,584,560,24
2013,2,WI,125,104,21
2013,2,WV,155,154,1
2013,2,WY,15,18,-3
2013,3,AK,16,19,-3
2013,3,AL,410,419,-9
2013,3,AR,105,109,-4
2013,3,AZ,238,240,-2
2013,3,CA,2639,2596,43
2013,3,CO,149,241,-92
2013,3,CT,234,211,23
2013,3,DC,13,14,-1
2013,3,DE,355,347,8
2013,3,FL,20714,20825,-111
2013,3,GA,823,830,-7
2013,3,GU,1,1,0
2013,3,HI,660,657,3
2013,3,IA,98,98,0
2013,3,ID,74,73,1
2013,3,IL,311,323,-12
2013,3,IN,154,164,-10
2013,3,KS,82,90,-8
2013,3,KY,161,152,9
2013,3,LA,4726,4750,-24
2013,3,MA,445,428,17
2013,3,MD,566,512,54
2013,3,ME,75,69,6
2013,3,MI,162,148,14
2013,3,MN,92,74,18
2013,3,MO,190,174,16
2013,3,MS,630,654,-24
2013,3,MT,41,34,7
2013,3,NC,1219,1207,12
2013,3,ND,67,87,-20
2013,3,NE,73,74,-1
2013,3,NH,69,73,-4
2013,3,NJ,2255,1959,296
2013,3,NM,97,96,1
2013,3,NV,106,115,-9
2013,3,NY,2192,1753,439
2013,3,OH,285,286,-1
2013,3,OK,121,116,5
2013,3,OR,312,318,-6
2013,3,PA,602,665,-63
2013,3,PR,189,202,-13
2013,3,RI,157,145,12
2013,3,SC,1660,1641,19
2013,3,SD,38,39,-1
2013,3,TN,248,234,14
2013,3,TX,4743,4853,-110
2013,3,UT,23,27,-4
2013,3,VA,866,835,31
2013,3,VI,25,27,-2
2013,3,VT,26,27,-1
2013,3,WA,434,437,-3
2013,3,WI,77,79,-2
2013,3,WV,118,118,0
2013,3,WY,18,18,0
2013,4,AK,21,21,0
2013,4,AL,826,842,-16
2013,4,AR,165,164,1
2013,4,AZ,298,287,11
2013,4,CA,3525,3550,-25
2013,4,CO,178,172,6
2013,4,CT,465,443,22
2013,4,DC,21,20,1
2013,4,DE,252,229,23
2013,4,FL,26226,26867,-641
2013,4,GA,1039,1038,1
2013,4,GU,1,1,0
2013,4,HI,1401,1383,18
2013,4,IA,120,126,-6
2013,4,ID,78,75,3
2013,4,IL,350,370,-20
2013,4,IN,232,233,-1
2013,4,KS,112,118,-6
2013,4,KY,208,196,12
2013,4,LA,5560,5688,-128
2013,4,MA,654,598,56
2013,4,MD,851,743,108
2013,4,ME,80,80,0
2013,4,MI,157,146,11
2013,4,MN,104,100,4
2013,4,MO,194,227,-33
2013,4,MS,899,914,-15
2013,4,MT,53,50,3
2013,4,NC,1587,1590,-3
2013,4,ND,93,84,9
2013,4,NE,90,89,1
2013,4,NH,72,69,3
2013,4,NJ,3846,3224,622
2013,4,NM,119,123,-4
2013,4,NV,227,220,7
2013,4,NY,2484,1915,569
2013,4,OH,349,359,-10
2013,4,OK,121,130,-9
2013,4,OR,469,495,-26
2013,4,PA,1018,1006,12
2013,4,PR,413,408,5
2013,4,RI,117,112,5
2013,4,SC,2252,2430,-178
2013,4,SD,59,57,2
2013,4,TN,282,270,12
2013,4,TX,5682,5767,-85
2013,4,UT,37,34,3
2013,4,VA,1211,1192,19
2013,4,VI,11,9,2
2013,4,VT,49,46,3
2013,4,WA,541,531,10
2013,4,WI,126,126,0
2013,4,WV,219,232,-13
2013,4,WY,15,14,1
2013,5,AK,20,20,0
2013,5,AL,549,551,-2
2013,5,AR,206,209,-3
2013,5,AZ,280,263,17
2013,5,CA,4254,4363,-109
2013,5,CO,186,167,19
2013,5,CT,280,274,6
2013,5,DC,17,16,1
2013,5,DE,233,223,10
2013,5,FL,20041,20030,11
2013,5,GA,959,961,-2
2013,5,HI,726,585,141
2013,5,IA,133,146,-13
2013,5,ID,99,95,4
2013,5,IL,403,425,-22
2013,5,IN,218,230,-12
2013,5,KS,143,137,6
2013,5,KY,220,210,10
2013,5,LA,5132,4980,152
2013,5,MA,551,503,48
2013,5,MD,594,548,46
2013,5,ME,127,122,5
2013,5,MI,162,153,9
2013,5,MN,122,130,-8
2013,5,MO,166,170,-4
2013,5,MS,942,958,-16
2013,5,MT,47,51,-4
2013,5,NC,1426,1395,31
2013,5,ND,134,143,-9
2013,5,NE,74,86,-12
2013,5,NH,86,82,4
2013,5,NJ,2766,2453,313
2013,5,NM,110,111,-1
2013,5,NV,208,222,-14
2013,5,NY,3157,1934,1223
2013,5,OH,414,392,22
2013,5,OK,137,133,4
2013,5,OR,602,624,-22
2013,5,PA,1023,1002,21
2013,5,PR,53,61,-8
2013,5,RI,132,118,14
2013,5,SC,1699,1632,67
2013,5,SD,46,55,-9
2013,5,TN,314,287,27
2013,5,TX,5944,5883,61
2013,5,UT,112,107,5
2013,5,VA,1014,932,82
2013,5,VI,13,13,0
2013,5,VT,37,35,2
2013,5,WA,578,568,10
2013,5,WI,118,106,12
2013,5,WV,244,262,-18
2013,5,WY,21,18,3
2013,6,AK,33,25,8
2013,6,AL,733,730,3
2013,6,AR,166,163,3
2013,6,AZ,335,311,24
2013,6,CA,3601,3777,-176
2013,6,CO,187,170,17
2013,6,CT,354,349,5
2013,6,DC,29,29,0
2013,6,DE,223,193,30
2013,6,FL,23653,23812,-159
2013,6,GA,1050,1017,33
2013,6,HI,501,500,1
2013,6,IA,159,163,-4
2013,6,ID,104,105,-1
2013,6,IL,691,679,12
2013,6,IN,283,278,5
2013,6,KS,112,108,4
2013,6,KY,241,239,2
2013,6,LA,5725,5578,147
2013,6,MA,529,471,58
2013,6,MD,599,502,97
2013,6,ME,79,73,6
2013,6,MI,203,190,13
2013,6,MN,132,132,0
2013,6,MO,255,210,45
2013,6,MS,882,865,17
2013,6,MT,67,65,2
2013,6,NC,1704,1634,70
2013,6,ND,190,174,16
2013,6,NE,108,110,-2
2013,6,NH,70,59,11
2013,6,NJ,2858,2559,299
2013,6,NM,109,109,0
2013,6,NV,229,222,7
2013,6,NY,2746,2030,716
2013,6,OH,415,409,6
2013,6,OK,149,132,17
2013,6,OR,395,401,-6
2013,6,PA,1021,988,33
2013,6,PR,105,104,1
2013,6,RI,142,143,-1
2013,6,SC,2229,2188,41
2013,6,SD,44,44,0
2013,6,TN,350,305,45
2013,6,TX,6252,6197,55
2013,6,UN,1,1,0
2013,6,UT,64,60,4
2013,6,VA,1149,1079,70
2013,6,VI,48,49,-1
2013,6,VT,41,40,1
2013,6,WA,583,566,17
2013,6,WI,144,137,7
2013,6,WV,211,201,10
2013,6,WY,18,22,-4
2013,7,AK,23,20,3
2013,7,AL,819,810,9
2013,7,AR,181,186,-5
2013,7,AZ,299,299,0
2013,7,CA,3347,3545,-198
2013,7,CO,185,175,10
2013,7,CT,316,297,19
2013,7,DC,133,26,107
2013,7,DE,253,236,17
2013,7,FL,24162,24196,-34
2013,7,GA,1030,1057,-27
2013,7,HI,1528,1533,-5
2013,7,IA,171,169,2
2013,7,ID,82,79,3
2013,7,IL,383,400,-17
2013,7,IN,234,244,-10
2013,7,KS,118,115,3
2013,7,KY,241,248,-7
2013,7,LA,5936,5931,5
2013,7,MA,402,371,31
2013,7,MD,595,555,40
2013,7,ME,77,76,1
2013,7,MI,195,182,13
2013,7,MN,154,168,-14
2013,7,MO,210,209,1
2013,7,MS,988,984,4
2013,7,MT,76,73,3
2013,7,NC,1585,1562,23
2013,7,ND,228,256,-28
2013,7,NE,126,119,7
2013,7,NH,84,87,-3
2013,7,NJ,2696,2460,236
2013,7,NM,105,136,-31
2013,7,NV,207,217,-10
2013,7,NY,2783,1979,804
2013,7,OH,519,515,4
2013,7,OK,168,156,12
2013,7,OR,412,443,-31
2013,7,PA,1069,1094,-25
2013,7,PR,100,161,-61
2013,7,RI,112,100,12
2013,7,SC,1832,1802,30
2013,7,SD,60,67,-7
2013,7,TN,355,327,28
2013,7,TX,6218,6201,17
2013,7,UT,73,63,10
2013,7,VA,1167,1119,48
2013,7,VI,7,5,2
2013,7,VT,31,32,-1
2013,7,WA,514,498,16
2013,7,WI,122,122,0
2013,7,WV,222,225,-3
2013,7,WY,26,25,1
2013,8,AK,43,35,8
2013,8,AL,739,712,27
2013,8,AR,200,203,-3
2013,8,AZ,363,360,3
2013,8,CA,3448,3536,-88
2013,8,CO,259,249,10
2013,8,CT,451,423,28
2013,8,DC,44,35,9
2013,8,DE,291,281,10
2013,8,FL,33660,34386,-726
2013,8,GA,1421,1430,-9
2013,8,GU,2,2,0
2013,8,HI,1100,1097,3
2013,8,IA,253,266,-13
2013,8,ID,144,130,14
2013,8,IL,550,562,-12
2013,8,IN,337,336,1
2013,8,KS,146,152,-6
2013,8,KY,258,249,9
2013,8,LA,7979,8077,-98
2013,8,MA,635,590,45
2013,8,MD,1235,1177,58
2013,8,ME,143,135,8
2013,8,MI,343,318,25
2013,8,MN,280,314,-34
2013,8,MO,313,307,6
2013,8,MS,1175,1181,-6
2013,8,MT,99,98,1
2013,8,NC,2529,2516,13
2013,8,ND,500,583,-83
2013,8,NE,125,136,-11
2013,8,NH,97,98,-1
2013,8,NJ,3786,3319,467
2013,8,NM,121,113,8
2013,8,NV,347,344,3
2013,8,NY,3545,2690,855
2013,8,OH,456,449,7
2013,8,OK,186,188,-2
2013,8,OR,472,482,-10
2013,8,PA,1202,1166,36
2013,8,PR,113,115,-2
2013,8,RI,377,369,8
2013,8,SC,2711,2658,53
2013,8,SD,98,94,4
2013,8,TN,537,538,-1
2013,8,TX,10088,10363,-275
2013,8,UT,87,87,0
2013,8,VA,1619,1589,30
2013,8,VI,13,13,0
2013,8,VT,52,49,3
2013,8,WA,657,675,-18
2013,8,WI,156,140,16
2013,8,WV,254,257,-3
2013,8,WY,30,31,-1
2013,9,AK,36,35,1
2013,9,AL,553,548,5
2013,9,AR,156,142,14
2013,9,AZ,263,252,11
2013,9,CA,2831,2829,2
2013,9,CO,250,213,37
2013,9,CT,508,530,-22
2013,9,DC,21,14,7
2013,9,DE,233,223,10
2013,9,FL,25585,25386,199
2013,9,GA,1111,1112,-1
2013,9,GU,4,3,1
2013,9,HI,677,649,28
2013,9,IA,228,226,2
2013,9,ID,145,153,-8
2013,9,IL,520,528,-8
2013,9,IN,248,244,4
2013,9,KS,113,126,-13
2013,9,KY,217,211,6
2013,9,LA,6098,6171,-73
2013,9,MA,515,509,6
2013,9,MD,693,623,70
2013,9,ME,143,131,12
2013,9,MI,200,218,-18
2013,9,MN,297,331,-34
2013,9,MO,234,228,6
2013,9,MS,1012,1013,-1
2013,9,MT,74,72,2
2013,9,NC,1559,1531,28
2013,9,ND,573,654,-81
2013,9,NE,103,106,-3
2013,9,NH,69,63,6
2013,9,NJ,2457,2239,218
2013,9,NM,131,144,-13
2013,9,NV,292,298,-6
2013,9,NY,3172,2180,992
2013,9,OH,422,431,-9
2013,9,OK,199,203,-4
2013,9,OR,365,388,-23
2013,9,PA,983,973,10
2013,9,PR,77,180,-103
2013,9,RI,128,127,1
2013,9,SC,2115,2147,-32
2013,9,SD,94,104,-10
2013,9,TN,477,495,-18
2013,9,TX,6485,6620,-135
2013,9,UT,53,62,-9
2013,9,VA,1335,1284,51
2013,9,VI,7,9,-2
2013,9,VT,62,57,5
2013,9,WA,549,562,-13
2013,9,WI,172,164,8
2013,9,WV,196,208,-12
2013,9,WY,26,27,-1
2013,10,AK,31,32,-1
2013,10,AL,658,636,22
2013,10,AR,192,187,5
2013,10,AZ,289,273,16
2013,10,CA,2630,2679,-49
2013,10,CO,269,237,32
2013,10,CT,477,461,16
2013,10,DC,23,21,2
2013,10,DE,254,248,6
2013,10,FL,26561,26766,-205
2013,10,GA,1159,1112,47
2013,10,HI,562,566,-4
2013,10,IA,283,312,-29
2013,10,ID,105,112,-7
2013,10,IL,470,477,-7
2013,10,IN,322,328,-6
2013,10,KS,142,142,0
2013,10,KY,251,242,9
2013,10,LA,7382,7471,-89
2013,10,MA,559,532,27
2013,10,MD,749,669,80
2013,10,ME,105,103,2
2013,10,MI,238,220,18
2013,10,MN,397,453,-56
2013,10,MO,259,245,14
2013,10,MS,1157,1189,-32
2013,10,MT,98,97,1
2013,10,NC,1869,1831,38
2013,10,ND,836,958,-122
2013,10,NE,114,125,-11
2013,10,NH,148,142,6
2013,10,NJ,2602,2361,241
2013,10,NM,130,139,-9
2013,10,NV,196,181,15
2013,10,NY,2910,2256,654
2013,10,OH,510,515,-5
2013,10,OK,209,204,5
2013,10,OR,368,363,5
2013,10,PA,979,949,30
2013,10,PR,99,98,1
2013,10,RI,128,134,-6
2013,10,SC,2920,2880,40
2013,10,SD,90,103,-13
2013,10,TN,501,528,-27
2013,10,TX,7050,7205,-155
2013,10,UT,76,66,10
2013,10,VA,1299,1384,-85
2013,10,VI,15,15,0
2013,10,VT,58,51,7
2013,10,WA,534,557,-23
2013,10,WI,177,172,5
2013,10,WV,226,231,-5
2013,10,WY,25,25,0
2013,11,AK,34,32,2
2013,11,AL,596,555,41
2013,11,AR,152,145,7
2013,11,AZ,259,262,-3
2013,11,CA,2819,2819,0
2013,11,CO,249,226,23
2013,11,CT,412,373,39
2013,11,DC,24,20,4
2013,11,DE,283,279,4
2013,11,FL,24476,24985,-509
2013,11,GA,1094,1091,3
2013,11,HI,1251,1252,-1
2013,11,IA,275,286,-11
2013,11,ID,88,98,-10
2013,11,IL,461,464,-3
2013,11,IN,272,287,-15
2013,11,KS,124,122,2
2013,11,KY,279,273,6
2013,11,LA,6457,6510,-53
2013,11,MA,664,615,49
2013,11,MD,1128,1096,32
2013,11,ME,108,97,11
2013,11,MI,233,219,14
2013,11,MN,437,480,-43
2013,11,MO,264,266,-2
2013,11,MS,1147,1170,-23
2013,11,MT,109,115,-6
2013,11,NC,1697,1674,23
2013,11,ND,751,840,-89
2013,11,NE,110,108,2
2013,11,NH,63,80,-17
2013,11,NJ,2384,2195,189
2013,11,NM,124,126,-2
2013,11,NV,162,157,5
2013,11,NY,2652,2115,537
2013,11,OH,442,449,-7
2013,11,OK,174,172,2
2013,11,OR,345,356,-11
2013,11,PA,968,954,14
2013,11,PR,78,80,-2
2013,11,RI,151,146,5
2013,11,SC,2344,2303,41
2013,11,SD,119,133,-14
2013,11,TN,486,487,-1
2013,11,TX,6762,7128,-366
2013,11,UT,69,66,3
2013,11,VA,1824,1755,69
2013,11,VI,25,25,0
2013,11,VT,56,45,11
2013,11,WA,423,424,-1
2013,11,WI,181,185,-4
2013,11,WV,202,211,-9
2013,11,WY,30,31,-1
2013,12,AK,25,24,1
2013,12,AL,940,935,5
2013,12,AR,246,236,10
2013,12,AZ,317,303,14
2013,12,CA,2832,2896,-64
2013,12,CO,276,232,44
2013,12,CT,411,373,38
2013,12,DC,24,19,5
2013,12,DE,268,259,9
2013,12,FL,32356,32717,-361
2013,12,GA,1479,1365,114
2013,12,HI,706,703,3
2013,12,IA,413,432,-19
2013,12,ID,146,157,-11
2013,12,IL,647,629,18
2013,12,IN,301,339,-38
2013,12,KS,154,151,3
2013,12,KY,275,281,-6
2013,12,LA,7952,8039,-87
2013,12,MA,597,529,68
2013,12,MD,971,940,31
2013,12,ME,126,125,1
2013,12,MI,265,270,-5
2013,12,MN,565,614,-49
2013,12,MO,316,317,-1
2013,12,MS,1474,1331,143
2013,12,MT,106,117,-11
2013,12,NC,2029,2029,0
2013,12,ND,885,960,-75
2013,12,NE,121,138,-17
2013,12,NH,107,104,3
2013,12,NJ,2833,2659,174
2013,12,NM,144,158,-14
2013,12,NV,223,203,20
2013,12,NY,2769,2176,593
2013,12,OH,447,464,-17
2013,12,OK,212,204,8
2013,12,OR,361,363,-2
2013,12,PA,1257,1230,27
2013,12,PR,287,301,-14
2013,12,RI,161,157,4
2013,12,SC,2997,3085,-88
2013,12,SD,180,209,-29
2013,12,TN,520,534,-14
2013,12,TX,8620,8785,-165
2013,12,UN,2,2,0
2013,12,UT,78,68,10
2013,12,VA,1713,1427,286
2013,12,VI,11,13,-2
2013,12,VT,52,50,2
2013,12,WA,490,488,2
2013,12,WI,215,213,2
2013,12,WV,266,272,-6
2013,12,WY,23,31,-8
2013,13,AK,48,47,1
2013,13,AL,749,743,6
2013,13,AR,247,247,0
2013,13,AZ,286,273,13
2013,13,CA,2612,2514,98
2013,13,CO,285,279,6
2013,13,CT,442,393,49
2013,13,DC,21,16,5
2013,13,DE,272,255,17
2013,13,FL,35466,36052,-586
2013,13,GA,1380,1360,20
2013,13,GU,1,0,1
2013,13,HI,550,555,-5
2013,13,IA,374,377,-3
2013,13,ID,99,98,1
2013,13,IL,636,656,-20
2013,13,IN,367,373,-6
2013,13,KS,168,175,-7
2013,13,KY,244,240,4
2013,13,LA,7683,7800,-117
2013,13,MA,497,484,13
2013,13,MD,953,905,48
2013,13,ME,157,167,-10
2013,13,MI,219,217,2
2013,13,MN,589,601,-12
2013,13,MO,410,404,6
2013,13,MS,1261,1273,-12
2013,13,MT,138,145,-7
2013,13,NC,2298,2258,40
2013,13,ND,654,663,-9
2013,13,NE,103,105,-2
2013,13,NH,119,125,-6
2013,13,NJ,2721,2504,217
2013,13,NM,140,141,-1
2013,13,NV,147,138,9
2013,13,NY,3105,2467,638
2013,13,OH,543,565,-22
2013,13,OK,222,201,21
2013,13,OR,393,373,20
2013,13,PA,948,958,-10
2013,13,PR,189,194,-5
2013,13,RI,152,153,-1
2013,13,SC,3195,3149,46
2013,13,SD,136,159,-23
2013,13,TN,721,744,-23
2013,13,TX,8698,8819,-121
2013,13,UT,102,97,5
2013,13,VA,1356,1343,13
2013,13,VI,1,0,1
2013,13,VT,51,51,0
2013,13,WA,613,631,-18
2013,13,WI,258,257,1
2013,13,WV,260,275,-15
2013,13,WY,50,49,1
2013,14,AK,48,55,-7
2013,14,AL,766,759,7
2013,14,AR,201,211,-10
2013,14,AZ,262,267,-5
2013,14,CA,2319,2359,-40
2013,14,CO,265,263,2
2013,14,CT,439,386,53
2013,14,DC,19,21,-2
2013,14,DE,273,268,5
2013,14,FL,28902,28929,-27
2013,14,GA,1170,1166,4
2013,14,GU,1,3,-2
2013,14,HI,461,474,-13
2013,14,IA,387,369,18
2013,14,ID,169,175,-6
2013,14,IL,585,582,3
2013,14,IN,353,352,1
2013,14,KS,166,164,2
2013,14,KY,275,261,14
2013,14,LA,7661,7771,-110
2013,14,MA,480,445,35
2013,14,MD,798,781,17
2013,14,ME,157,160,-3
2013,14,MI,230,230,0
2013,14,MN,545,478,67
2013,14,MO,348,349,-1
2013,14,MS,1324,1335,-11
2013,14,MT,116,135,-19
2013,14,NC,1705,1711,-6
2013,14,ND,692,657,35
2013,14,NE,95,99,-4
2013,14,NH,112,117,-5
2013,14,NJ,2408,2238,170
2013,14,NM,129,133,-4
2013,14,NV,139,139,0
2013,14,NY,2542,1947,595
2013,14,OH,466,472,-6
2013,14,OK,198,212,-14
2013,14,OR,327,339,-12
2013,14,PA,909,865,44
2013,14,PR,179,183,-4
2013,14,RI,171,175,-4
2013,14,SC,2378,2391,-13
2013,14,SD,114,131,-17
2013,14,TN,439,453,-14
2013,14,TX,7670,7920,-250
2013,14,UT,74,75,-1
2013,14,VA,1281,1253,28
2013,14,VI,69,68,1
2013,14,VT,65,62,3
2013,14,WA,421,441,-20
2013,14,WI,302,292,10
2013,14,WV,240,242,-2
2013,14,WY,39,45,-6
2013,15,AK,57,69,-12
2013,15,AL,1004,983,21
2013,15,AR,191,184,7
2013,15,AZ,287,279,8
2013,15,CA,2464,2556,-92
2013,15,CO,308,291,17
2013,15,CT,434,384,50
2013,15,DC,24,24,0
2013,15,DE,345,324,21
2013,15,FL,34394,34572,-178
2013,15,GA,1347,1277,70
2013,15,GU,1,1,0
2013,15,HI,986,982,4
2013,15,IA,292,296,-4
2013,15,ID,88,94,-6
2013,15,IL,713,653,60
2013,15,IN,340,343,-3
2013,15,KS,174,196,-22
2013,15,KY,279,261,18
2013,15,LA,8489,8694,-205
2013,15,MA,583,550,33
2013,15,MD,731,687,44
2013,15,ME,126,127,-1
2013,15,MI,255,259,-4
2013,15,MN,365,235,130
2013,15,MO,382,382,0
2013,15,MS,1321,1336,-15
2013,15,MT,118,132,-14
2013,15,NC,1968,1944,24
2013,15,ND,488,314,174
2013,15,NE,127,133,-6
2013,15,NH,105,101,4
2013,15,NJ,3066,2726,340
2013,15,NM,144,139,5
2013,15,NV,143,142,1
2013,15,NY,2587,2172,415
2013,15,OH,505,525,-20
2013,15,OK,242,251,-9
2013,15,OR,367,400,-33
2013,15,PA,788,812,-24
2013,15,PR,110,113,-3
2013,15,RI,155,154,1
2013,15,SC,2766,2646,120
2013,15,SD,78,90,-12
2013,15,TN,461,449,12
2013,15,TX,8760,8849,-89
2013,15,UT,81,83,-2
2013,15,VA,1516,1478,38
2013,15,VI,19,18,1
2013,15,VT,60,56,4
2013,15,WA,492,518,-26
2013,15,WI,288,286,2
2013,15,WV,208,210,-2
2013,15,WY,43,55,-12
2013,16,AK,42,67,-25
2013,16,AL,818,810,8
2013,16,AR,200,184,16
2013,16,AZ,288,273,15
2013,16,CA,2639,2858,-219
2013,16,CO,371,349,22
2013,16,CT,426,402,24
2013,16,DC,21,21,0
2013,16,DE,341,323,18
2013,16,FL,32667,33079,-412
2013,16,GA,1344,1337,7
2013,16,HI,1369,1429,-60
2013,16,IA,222,242,-20
2013,16,ID,100,110,-10
2013,16,IL,736,716,20
2013,16,IN,356,346,10
2013,16,KS,188,184,4
2013,16,KY,288,294,-6
2013,16,LA,9476,9681,-205
2013,16,MA,613,607,6
2013,16,MD,789,791,-2
2013,16,ME,149,146,3
2013,16,MI,224,525,-301
2013,16,MN,267,189,78
2013,16,MO,442,446,-4
2013,16,MS,1511,1556,-45
2013,16,MT,120,128,-8
2013,16,NC,2071,2037,34
2013,16,ND,470,151,319
2013,16,NE,154,154,0
2013,16,NH,102,102,0
2013,16,NJ,2778,2601,177
2013,16,NM,184,144,40
2013,16,NV,166,153,13
2013,16,NY,3178,2976,202
2013,16,OH,472,455,17
2013,16,OK,252,240,12
2013,16,OR,317,323,-6
2013,16,PA,867,855,12
2013,16,PR,116,150,-34
2013,16,RI,231,232,-1
2013,16,SC,2853,2824,29
2013,16,SD,62,60,2
2013,16,TN,461,432,29
2013,16,TX,9900,10126,-226
2013,16,UT,58,65,-7
2013,16,VA,1470,1456,14
2013,16,VI,9,11,-2
2013,16,VT,44,43,1
2013,16,WA,465,467,-2
2013,16,WI,278,284,-6
2013,16,WV,222,238,-16
2013,16,WY,51,54,-3
2013,17,AK,45,50,-5
2013,17,AL,1446,1459,-13
2013,17,AR,220,221,-1
2013,17,AZ,377,316,61
2013,17,CA,2810,2912,-102
2013,17,CO,439,410,29
2013,17,CT,543,475,68
2013,17,DC,22,23,-1
2013,17,DE,365,353,12
2013,17,FL,46742,47393,-651
2013,17,GA,1572,1567,5
2013,17,GU,1,1,0
2013,17,HI,1372,1087,285
2013,17,IA,198,188,10
2013,17,ID,375,382,-7
2013,17,IL,674,674,0
2013,17,IN,330,333,-3
2013,17,KS,178,178,0
2013,17,KY,243,237,6
2013,17,LA,10930,11158,-228
2013,17,MA,622,616,6
2013,17,MD,868,816,52
2013,17,ME,141,134,7
2013,17,MI,254,258,-4
2013,17,MN,180,154,26
2013,17,MO,343,345,-2
2013,17,MS,1599,1669,-70
2013,17,MT,103,113,-10
2013,17,NC,2730,2719,11
2013,17,ND,217,112,105
2013,17,NE,146,148,-2
2013,17,NH,96,98,-2
2013,17,NJ,3944,3359,585
2013,17,NM,152,162,-10
2013,17,NV,142,145,-3
2013,17,NY,2882,2464,418
2013,17,OH,445,467,-22
2013,17,OK,250,241,9
2013,17,OR,697,698,-1
2013,17,PA,969,978,-9
2013,17,PR,161,276,-115
2013,17,RI,162,164,-2
2013,17,SC,3884,3841,43
2013,17,SD,71,67,4
2013,17,TN,423,430,-7
2013,17,TX,12504,12747,-243
2013,17,UT,172,172,0
2013,17,VA,1902,1934,-32
2013,17,VI,10,9,1
2013,17,VT,54,48,6
2013,17,WA,604,528,76
2013,17,WI,166,161,5
2013,17,WV,197,203,-6
2013,17,WY,37,40,-3
2013,18,AK,38,37,1
2013,18,AL,622,698,-76
2013,18,AR,203,209,-6
2013,18,AZ,263,255,8
2013,18,CA,2169,2282,-113
2013,18,CO,318,276,42
2013,18,CT,372,330,42
2013,18,DC,23,17,6
2013,18,DE,290,272,18
2013,18,FL,32321,32642,-321
2013,18,GA,1205,1192,13
2013,18,HI,281,286,-5
2013,18,IA,150,142,8
2013,18,ID,90,95,-5
2013,18,IL,437,407,30
2013,18,IN,259,256,3
2013,18,KS,130,134,-4
2013,18,KY,254,244,10
2013,18,LA,8645,8698,-53
2013,18,MA,568,442,126
2013,18,MD,748,730,18
2013,18,ME,82,90,-8
2013,18,MI,209,210,-1
2013,18,MN,146,124,22
2013,18,MO,263,268,-5
2013,18,MS,1354,1386,-32
2013,18,MT,85,85,0
2013,18,NC,1821,1832,-11
2013,18,ND,142,67,75
2013,18,NE,94,106,-12
2013,18,NH,70,64,6
2013,18,NJ,2461,2327,134
2013,18,NM,107,113,-6
2013,18,NV,119,112,7
2013,18,NY,2324,1899,425
2013,18,OH,350,333,17
2013,18,OK,223,228,-5
2013,18,OR,303,297,6
2013,18,PA,759,732,27
2013,18,PR,109,118,-9
2013,18,RI,139,139,0
2013,18,SC,2546,2498,48
2013,18,SD,62,60,2
2013,18,TN,334,344,-10
2013,18,TX,9278,9395,-117
2013,18,UT,67,74,-7
2013,18,VA,1364,1352,12
2013,18,VI,10,11,-1
2013,18,VT,45,40,5
2013,18,WA,417,428,-11
2013,18,WI,187,160,27
2013,18,WV,179,194,-15
2013,18,WY,46,54,-8
2013,19,AK,43,36,7
2013,19,AL,846,868,-22
2013,19,AR,179,179,0
2013,19,AZ,253,262,-9
2013,19,CA,2171,2232,-61
2013,19,CO,389,308,81
2013,19,CT,423,381,42
2013,19,DC,29,22,7
2013,19,DE,348,327,21
2013,19,FL,33876,33940,-64
2013,19,GA,1428,1403,25
2013,19,HI,796,799,-3
2013,19,IA,192,153,39
2013,19,ID,93,102,-9
2013,19,IL,712,550,162
2013,19,IN,257,246,11
2013,19,KS,147,154,-7
2013,19,KY,254,239,15
2013,19,LA,9213,9299,-86
2013,19,MA,458,459,-1
2013,19,MD,657,657,0
2013,19,ME,95,95,0
2013,19,MI,238,227,11
2013,19,MN,159,125,34
2013,19,MO,283,240,43
2013,19,MS,1442,1486,-44
2013,19,MT,98,99,-1
2013,19,NC,2218,2184,34
2013,19,ND,217,107,110
2013,19,NE,88,94,-6
2013,19,NH,95,97,-2
2013,19,NJ,2746,2596,150
2013,19,NM,134,133,1
2013,19,NV,148,131,17
2013,19,NY,2913,2224,689
2013,19,OH,378,358,20
2013,19,OK,230,218,12
2013,19,OR,321,326,-5
2013,19,PA,772,766,6
2013,19,PR,176,186,-10
2013,19,RI,146,147,-1
2013,19,SC,3308,3278,30
2013,19,SD,71,62,9
2013,19,TN,373,370,3
2013,19,TX,10463,10805,-342
2013,19,UT,69,74,-5
2013,19,VA,1665,1649,16
2013,19,VI,5,5,0
2013,19,VT,42,41,1
2013,19,WA,335,358,-23
2013,19,WI,172,155,17
2013,19,WV,199,199,0
2013,19,WY,48,51,-3
2013,20,AK,33,28,5
2013,20,AL,997,985,12
2013,20,AR,209,206,3
2013,20,AZ,291,301,-10
2013,20,CA,2400,2471,-71
2013,20,CO,410,370,40
2013,20,CT,429,368,61
2013,20,DC,22,14,8
2013,20,DE,327,305,22
2013,20,FL,33852,33708,144
2013,20,GA,1475,1430,45
2013,20,GU,3,3,0
2013,20,HI,929,918,11
2013,20,IA,256,237,19
2013,20,ID,107,111,-4
2013,20,IL,719,431,288
2013,20,IN,307,286,21
2013,20,KS,135,139,-4
2013,20,KY,256,243,13
2013,20,LA,9887,9836,51
2013,20,MA,522,523,-1
2013,20,MD,887,761,126
2013,20,ME,79,84,-5
2013,20,MI,228,203,25
2013,20,MN,123,104,19
2013,20,MO,318,275,43
2013,20,MS,1530,1545,-15
2013,20,MT,106,111,-5
2013,20,NC,2364,2314,50
2013,20,ND,114,97,17
2013,20,NE,102,105,-3
2013,20,NH,76,70,6
2013,20,NJ,2844,2781,63
2013,20,NM,146,148,-2
2013,20,NV,153,150,3
2013,20,NY,3045,2630,415
2013,20,OH,393,389,4
2013,20,OK,233,232,1
2013,20,OR,359,354,5
2013,20,PA,908,888,20
2013,20,PR,97,124,-27
2013,20,RI,167,163,4
2013,20,SC,3403,3190,213
2013,20,SD,93,108,-15
2013,20,TN,403,370,33
2013,20,TX,11348,11635,-287
2013,20,UN,1,1,0
2013,20,UT,59,63,-4
2013,20,VA,1529,1509,20
2013,20,VI,7,10,-3
2013,20,VT,40,37,3
2013,20,WA,391,406,-15
2013,20,WI,235,221,14
2013,20,WV,179,188,-9
2013,20,WY,43,46,-3
2013,21,AK,31,33,-2
2013,21,AL,983,1001,-18
2013,21,AR,291,329,-38
2013,21,AZ,316,323,-7
2013,21,CA,2337,2444,-107
2013,21,CO,345,329,16
2013,21,CT,513,494,19
2013,21,DC,19,25,-6
2013,21,DE,352,352,0
2013,21,FL,46175,46177,-2
2013,21,GA,1818,1815,3
2013,21,GU,1,1,0
2013,21,HI,1207,1226,-19
2013,21,IA,223,218,5
2013,21,ID,89,86,3
2013,21,IL,653,504,149
2013,21,IN,368,342,26
2013,21,KS,178,180,-2
2013,21,KY,266,255,11
2013,21,LA,13288,13312,-24
2013,21,MA,642,618,24
2013,21,MD,945,907,38
2013,21,ME,121,119,2
2013,21,MI,240,195,45
2013,21,MN,143,135,8
2013,21,MO,345,359,-14
2013,21,MS,2053,2173,-120
2013,21,MT,106,127,-21
2013,21,NC,2615,2595,20
2013,21,ND,148,147,1
2013,21,NE,143,142,1
2013,21,NH,119,119,0
2013,21,NJ,3290,2983,307
2013,21,NM,124,136,-12
2013,21,NV,134,132,2
2013,21,NY,3054,2163,891
2013,21,OH,434,421,13
2013,21,OK,230,233,-3
2013,21,OR,400,392,8
2013,21,PA,916,889,27
2013,21,PR,116,322,-206
2013,21,RI,225,232,-7
2013,21,SC,4419,4371,48
2013,21,SD,88,96,-8
2013,21,TN,671,693,-22
2013,21,TX,15444,16025,-581
2013,21,UN,1,1,0
2013,21,UT,106,105,1
2013,21,VA,2398,2408,-10
2013,21,VI,9,8,1
2013,21,VT,34,33,1
2013,21,WA,490,509,-19
2013,21,WI,175,174,1
2013,21,WV,211,215,-4
2013,21,WY,49,56,-7
2013,22,AK,39,34,5
2013,22,AL,1111,1100,11
2013,22,AR,357,390,-33
2013,22,AZ,282,303,-21
2013,22,CA,1982,2046,-64
2013,22,CO,324,251,73
2013,22,CT,363,338,25
2013,22,DC,264,259,5
2013,22,DE,369,351,18
2013,22,FL,34353,33995,358
2013,22,GA,1737,1735,2
2013,22,GU,2,2,0
2013,22,HI,245,244,1
2013,22,IA,198,197,1
2013,22,ID,68,86,-18
2013,22,IL,507,419,88
2013,22,IN,277,266,11
2013,22,KS,135,146,-11
2013,22,KY,302,296,6
2013,22,LA,10922,11191,-269
2013,22,MA,517,494,23
2013,22,MD,1076,1056,20
2013,22,ME,87,88,-1
2013,22,MI,198,204,-6
2013,22,MN,117,117,0
2013,22,MO,307,295,12
2013,22,MS,1881,1955,-74
2013,22,MT,117,122,-5
2013,22,NC,2502,2498,4
2013,22,ND,91,92,-1
2013,22,NE,106,116,-10
2013,22,NH,71,73,-2
2013,22,NJ,3064,2969,95
2013,22,NM,109,119,-10
2013,22,NV,163,150,13
2013,22,NY,2907,2521,386
2013,22,OH,382,392,-10
2013,22,OK,270,261,9
2013,22,OR,298,326,-28
2013,22,PA,737,693,44
2013,22,PR,148,100,48
2013,22,RI,170,169,1
2013,22,SC,3689,3582,107
2013,22,SD,146,185,-39
2013,22,TN,983,1069,-86
2013,22,TX,13622,14156,-534
2013,22,UT,78,76,2
2013,22,VA,1837,1802,35
2013,22,VI,6,7,-1
2013,22,VT,40,34,6
2013,22,WA,399,420,-21
2013,22,WI,143,136,7
2013,22,WV,172,174,-2
2013,22,WY,47,54,-7
2013,23,AK,35,37,-2
2013,23,AL,937,983,-46
2013,23,AR,263,284,-21
2013,23,AZ,316,315,1
2013,23,CA,2317,2331,-14
2013,23,CO,379,308,71
2013,23,CT,705,654,51
2013,23,DC,21,18,3
2013,23,DE,294,281,13
2013,23,FL,38863,39035,-172
2013,23,GA,1613,1625,-12
2013,23,GU,1,1,0
2013,23,HI,1313,1447,-134
2013,23,IA,146,152,-6
2013,23,ID,63,72,-9
2013,23,IL,656,557,99
2013,23,IN,282,278,4
2013,23,KS,182,195,-13
2013,23,KY,309,319,-10
2013,23,LA,12132,12412,-280
2013,23,MA,701,669,32
2013,23,MD,796,769,27
2013,23,ME,91,90,1
2013,23,MI,219,223,-4
2013,23,MN,111,106,5
2013,23,MO,309,313,-4
2013,23,MS,1728,1783,-55
2013,23,MT,111,123,-12
2013,23,NC,2446,2453,-7
2013,23,ND,94,96,-2
2013,23,NE,117,106,11
2013,23,NH,97,93,4
2013,23,NJ,2760,2693,67
2013,23,NM,140,155,-15
2013,23,NV,125,122,3
2013,23,NY,2854,2274,580
2013,23,OH,380,391,-11
2013,23,OK,244,245,-1
2013,23,OR,297,279,18
2013,23,PA,787,785,2
2013,23,PR,106,133,-27
2013,23,RI,207,208,-1
2013,23,SC,3662,3585,77
2013,23,SD,69,64,5
2013,23,TN,769,822,-53
2013,23,TX,15670,15895,-225
2013,23,UT,60,56,4
2013,23,VA,2034,2041,-7
2013,23,VI,23,23,0
2013,23,VT,39,36,3
2013,23,WA,408,419,-11
2013,23,WI,208,207,1
2013,23,WV,190,196,-6
2013,23,WY,38,44,-6
2013,24,AK,37,32,5
2013,24,AL,868,901,-33
2013,24,AR,214,225,-11
2013,24,AZ,315,326,-11
2013,24,CA,1943,1970,-27
2013,24,CO,491,482,9
2013,24,CT,464,407,57
2013,24,DC,48,44,4
2013,24,DE,355,341,14
2013,24,FL,40327,40139,188
2013,24,GA,1760,1731,29
2013,24,GU,3,3,0
2013,24,HI,505,498,7
2013,24,IA,155,150,5
2013,24,ID,73,72,1
2013,24,IL,528,444,84
2013,24,IN,264,264,0
2013,24,KS,181,189,-8
2013,24,KY,224,218,6
2013,24,LA,11207,11299,-92
2013,24,MA,583,571,12
2013,24,MD,982,959,23
2013,24,ME,89,87,2
2013,24,MI,194,205,-11
2013,24,MN,128,117,11
2013,24,MO,280,275,5
2013,24,MS,1769,1832,-63
2013,24,MT,105,113,-8
2013,24,NC,3053,3035,18
2013,24,ND,107,119,-12
2013,24,NE,97,100,-3
2013,24,NH,91,86,5
2013,24,NJ,3262,3173,89
2013,24,NM,138,146,-8
2013,24,NV,101,107,-6
2013,24,NY,3005,2471,534
2013,24,OH,372,365,7
2013,24,OK,261,264,-3
2013,24,OR,262,259,3
2013,24,PA,844,808,36
2013,24,PR,99,133,-34
2013,24,RI,214,215,-1
2013,24,SC,4024,3941,83
2013,24,SD,73,59,14
2013,24,TN,806,842,-36
2013,24,TX,17007,17553,-546
2013,24,UT,50,51,-1
2013,24,VA,2175,2183,-8
2013,24,VI,158,156,2
2013,24,VT,49,39,10
2013,24,WA,362,362,0
2013,24,WI,150,156,-6
2013,24,WV,195,192,3
2013,24,WY,48,54,-6
2013,25,AK,24,28,-4
2013,25,AL,923,920,3
2013,25,AR,190,202,-12
2013,25,AZ,416,423,-7
2013,25,CA,1960,1971,-11
2013,25,CO,286,278,8
2013,25,CT,514,462,52
2013,25,DC,27,30,-3
2013,25,DE,366,348,18
2013,25,FL,44428,44279,149
2013,25,GA,1923,1892,31
2013,25,GU,2,2,0
2013,25,HI,867,862,5
2013,25,IA,208,165,43
2013,25,ID,74,77,-3
2013,25,IL,604,523,81
2013,25,IN,242,231,11
2013,25,KS,194,186,8
2013,25,KY,192,198,-6
2013,25,LA,12461,12556,-95
2013,25,MA,754,735,19
2013,25,MD,1319,1262,57
2013,25,ME,120,101,19
2013,25,MI,226,199,27
2013,25,MN,124,116,8
2013,25,MO,288,274,14
2013,25,MS,1603,1578,25
2013,25,MT,186,195,-9
2013,25,NC,2938,2869,69
2013,25,ND,311,417,-106
2013,25,NE,128,134,-6
2013,25,NH,91,84,7
2013,25,NJ,3087,2973,114
2013,25,NM,134,137,-3
2013,25,NV,118,118,0
2013,25,NY,3204,2320,884
2013,25,OH,411,400,11
2013,25,OK,211,197,14
2013,25,OR,263,263,0
2013,25,PA,800,767,33
2013,25,PR,114,139,-25
2013,25,RI,216,223,-7
2013,25,SC,4146,4053,93
2013,25,SD,111,107,4
2013,25,TN,693,717,-24
2013,25,TX,19425,19542,-117
2013,25,UT,60,57,3
2013,25,VA,2513,2416,97
2013,25,VI,13,10,3
2013,25,VT,58,48,10
2013,25,WA,328,329,-1
2013,25,WI,160,145,15
2013,25,WV,169,177,-8
2013,25,WY,26,31,-5
2013,26,AK,32,36,-4
2013,26,AL,1142,1148,-6
2013,26,AR,201,196,5
2013,26,AZ,338,335,3
2013,26,CA,2191,2194,-3
2013,26,CO,337,341,-4
2013,26,CT,576,521,55
2013,26,DC,26,28,-2
2013,26,DE,418,397,21
2013,26,FL,47226,45652,1574
2013,26,GA,2550,2521,29
2013,26,HI,713,697,16
2013,26,IA,474,515,-41
2013,26,ID,64,72,-8
2013,26,IL,531,436,95
2013,26,IN,287,265,22
2013,26,KS,181,186,-5
2013,26,KY,241,254,-13
2013,26,LA,13913,13601,312
2013,26,MA,733,795,-62
2013,26,MD,1706,1613,93
2013,26,ME,128,124,4
2013,26,MI,191,198,-7
2013,26,MN,129,114,15
2013,26,MO,364,337,27
2013,26,MS,1882,1859,23
2013,26,MT,83,77,6
2013,26,NC,3225,3172,53
2013,26,ND,249,281,-32
2013,26,NE,195,231,-36
2013,26,NH,111,114,-3
2013,26,NJ,3470,3244,226
2013,26,NM,126,134,-8
2013,26,NV,118,120,-2
2013,26,NY,3558,2934,624
2013,26,OH,431,419,12
2013,26,OK,290,213,77
2013,26,OR,337,339,-2
2013,26,PA,896,865,31
2013,26,PR,118,151,-33
2013,26,RI,273,249,24
2013,26,SC,5073,4927,146
2013,26,SD,173,197,-24
2013,26,TN,484,491,-7
2013,26,TX,25104,25312,-208
2013,26,UN,1,0,1
2013,26,UT,71,73,-2
2013,26,VA,2793,2763,30
2013,26,VI,14,11,3
2013,26,VT,66,55,11
2013,26,WA,398,389,9
2013,26,WI,164,160,4
2013,26,WV,224,222,2
2013,26,WY,37,35,2
2013,27,AK,32,29,3
2013,27,AL,987,968,19
2013,27,AR,187,186,1
2013,27,AZ,445,345,100
2013,27,CA,2188,2354,-166
2013,27,CO,316,289,27
2013,27,CT,746,707,39
2013,27,DC,24,14,10
2013,27,DE,380,339,41
2013,27,FL,39104,38265,839
2013,27,GA,2191,2076,115
2013,27,HI,443,444,-1
2013,27,IA,286,282,4
2013,27,ID,53,55,-2
2013,27,IL,534,452,82
2013,27,IN,370,366,4
2013,27,KS,170,175,-5
2013,27,KY,282,249,33
2013,27,LA,11442,11474,-32
2013,27,MA,683,626,57
2013,27,MD,1077,895,182
2013,27,ME,126,118,8
2013,27,MI,244,233,11
2013,27,MN,147,145,2
2013,27,MO,293,313,-20
2013,27,MS,1469,1423,46
2013,27,MT,87,93,-6
2013,27,NC,2834,2753,81
2013,27,ND,103,94,9
2013,27,NE,139,175,-36
2013,27,NH,95,92,3
2013,27,NJ,3899,3665,234
2013,27,NM,133,138,-5
2013,27,NV,102,98,4
2013,27,NY,3081,2465,616
2013,27,OH,367,358,9
2013,27,OK,252,212,40
2013,27,OR,364,380,-16
2013,27,PA,768,737,31
2013,27,PR,132,152,-20
2013,27,RI,248,226,22
2013,27,SC,4086,3915,171
2013,27,SD,78,74,4
2013,27,TN,508,515,-7
2013,27,TX,23503,24049,-546
2013,27,UT,59,61,-2
2013,27,VA,2457,2352,105
2013,27,VI,11,14,-3
2013,27,VT,35,33,2
2013,27,WA,335,359,-24
2013,27,WI,199,193,6
2013,27,WV,165,165,0
2013,27,WY,37,35,2
2013,28,AK,42,37,5
2013,28,AL,964,972,-8
2013,28,AR,207,211,-4
2013,28,AZ,479,469,10
2013,28,CA,2249,2248,1
2013,28,CO,305,292,13
2013,28,CT,501,476,25
2013,28,DC,38,30,8
2013,28,DE,358,332,26
2013,28,FL,40141,39502,639
2013,28,GA,2072,1950,122
2013,28,GU,1,1,0
2013,28,HI,679,672,7
2013,28,IA,240,227,13
2013,28,ID,59,53,6
2013,28,IL,569,545,24
2013,28,IN,395,394,1
2013,28,KS,183,193,-10
2013,28,KY,255,242,13
2013,28,LA,11504,11639,-135
2013,28,MA,699,687,12
2013,28,MD,1112,1049,63
2013,28,ME,124,106,18
2013,28,MI,242,245,-3
2013,28,MN,140,139,1
2013,28,MO,323,322,1
2013,28,MS,1442,1418,24
2013,28,MT,118,125,-7
2013,28,NC,3273,3227,46
2013,28,ND,95,99,-4
2013,28,NE,133,137,-4
2013,28,NH,195,160,35
2013,28,NJ,3684,3518,166
2013,28,NM,160,147,13
2013,28,NV,138,127,11
2013,28,NY,3351,3129,222
2013,28,OH,420,421,-1
2013,28,OK,294,282,12
2013,28,OR,295,310,-15
2013,28,PA,905,876,29
2013,28,PR,112,181,-69
2013,28,RI,236,278,-42
2013,28,SC,4279,4174,105
2013,28,SD,66,51,15
2013,28,TN,506,505,1
2013,28,TX,23144,24116,-972
2013,28,UT,76,68,8
2013,28,VA,2685,2655,30
2013,28,VI,7,6,1
2013,28,VT,64,57,7
2013,28,WA,371,390,-19
2013,28,WI,192,203,-11
2013,28,WV,212,227,-15
2013,28,WY,24,31,-7
2013,29,AK,34,35,-1
2013,29,AL,908,925,-17
2013,29,AR,180,172,8
2013,29,AZ,443,451,-8
2013,29,CA,2059,2110,-51
2013,29,CO,296,305,-9
2013,29,CT,507,465,42
2013,29,DC,22,26,-4
2013,29,DE,396,389,7
2013,29,FL,40799,41374,-575
2013,29,GA,2033,1964,69
2013,29,HI,493,583,-90
2013,29,IA,241,244,-3
2013,29,ID,71,78,-7
2013,29,IL,705,486,219
2013,29,IN,383,379,4
2013,29,KS,188,196,-8
2013,29,KY,273,269,4
2013,29,LA,10630,10774,-144
2013,29,MA,833,799,34
2013,29,MD,1228,1213,15
2013,29,ME,115,114,1
2013,29,MI,218,221,-3
2013,29,MN,165,166,-1
2013,29,MO,273,277,-4
2013,29,MS,1332,1299,33
2013,29,MT,106,102,4
2013,29,NC,2916,2902,14
2013,29,ND,112,119,-7
2013,29,NE,116,127,-11
2013,29,NH,118,116,2
2013,29,NJ,2759,2665,94
2013,29,NM,180,198,-18
2013,29,NV,148,143,5
2013,29,NY,3445,2543,902
2013,29,OH,417,420,-3
2013,29,OK,264,254,10
2013,29,OR,292,344,-52
2013,29,PA,854,852,2
2013,29,PR,106,174,-68
2013,29,RI,255,236,19
2013,29,SC,3633,3559,74
2013,29,SD,82,69,13
2013,29,TN,461,458,3
2013,29,TX,20822,21858,-1036
2013,29,UT,49,50,-1
2013,29,VA,2629,2659,-30
2013,29,VI,10,5,5
2013,29,VT,50,39,11
2013,29,WA,400,396,4
2013,29,WI,211,210,1
2013,29,WV,202,199,3
2013,29,WY,35,36,-1
2013,30,AK,43,39,4
2013,30,AL,1214,1231,-17
2013,30,AR,185,180,5
2013,30,AZ,437,415,22
2013,30,CA,2065,2225,-160
2013,30,CO,299,296,3
2013,30,CT,563,514,49
2013,30,DC,41,37,4
2013,30,DE,401,404,-3
2013,30,FL,40281,41612,-1331
2013,30,GA,2168,2112,56
2013,30,HI,1293,1285,8
2013,30,IA,226,206,20
2013,30,ID,74,71,3
2013,30,IL,623,563,60
2013,30,IN,337,351,-14
2013,30,KS,206,207,-1
2013,30,KY,263,263,0
2013,30,LA,11057,11275,-218
2013,30,MA,902,881,21
2013,30,MD,1248,1232,16
2013,30,ME,115,117,-2
2013,30,MI,228,221,7
2013,30,MN,133,148,-15
2013,30,MO,366,374,-8
2013,30,MS,1827,1840,-13
2013,30,MT,65,63,2
2013,30,NC,3132,3011,121
2013,30,ND,97,97,0
2013,30,NE,120,133,-13
2013,30,NH,91,81,10
2013,30,NJ,3694,3568,126
2013,30,NM,203,199,4
2013,30,NV,158,152,6
2013,30,NY,3013,2549,464
2013,30,OH,434,446,-12
2013,30,OK,282,274,8
2013,30,OR,293,298,-5
2013,30,PA,1027,985,42
2013,30,PR,228,256,-28
2013,30,RI,336,297,39
2013,30,SC,4288,4235,53
2013,30,SD,70,62,8
2013,30,TN,664,663,1
2013,30,TX,18916,19730,-814
2013,30,UT,64,58,6
2013,30,VA,2714,2631,83
2013,30,VI,15,14,1
2013,30,VT,40,32,8
2013,30,WA,373,378,-5
2013,30,WI,187,193,-6
2013,30,WV,196,195,1
2013,30,WY,27,35,-8
2013,31,AK,28,26,2
2013,31,AL,925,925,0
2013,31,AR,182,188,-6
2013,31,AZ,511,543,-32
2013,31,CA,1997,2005,-8
2013,31,CO,537,628,-91
2013,31,CT,614,558,56
2013,31,DC,277,274,3
2013,31,DE,342,337,5
2013,31,FL,33647,34070,-423
2013,31,GA,2085,2039,46
2013,31,HI,794,790,4
2013,31,IA,155,161,-6
2013,31,ID,70,63,7
2013,31,IL,437,407,30
2013,31,IN,361,364,-3
2013,31,KS,156,162,-6
2013,31,KY,260,254,6
2013,31,LA,9800,10095,-295
2013,31,MA,715,709,6
2013,31,MD,860,852,8
2013,31,ME,105,119,-14
2013,31,MI,202,210,-8
2013,31,MN,100,105,-5
2013,31,MO,441,452,-11
2013,31,MS,1198,1253,-55
2013,31,MT,54,56,-2
2013,31,NC,3034,2941,93
2013,31,ND,91,97,-6
2013,31,NE,100,118,-18
2013,31,NH,77,70,7
2013,31,NJ,2798,2700,98
2013,31,NM,185,185,0
2013,31,NV,216,147,69
2013,31,NY,2958,2625,333
2013,31,OH,436,399,37
2013,31,OK,287,290,-3
2013,31,OR,313,336,-23
2013,31,PA,899,876,23
2013,31,PR,9735,10200,-465
2013,31,RI,274,273,1
2013,31,SC,3786,3728,58
2013,31,SD,68,65,3
2013,31,TN,606,615,-9
2013,31,TX,17317,18227,-910
2013,31,UT,55,59,-4
2013,31,VA,2321,2386,-65
2013,31,VI,14,14,0
2013,31,VT,58,43,15
2013,31,WA,326,351,-25
2013,31,WI,148,155,-7
2013,31,WV,187,199,-12
2013,31,WY,34,36,-2
2013,32,AK,32,28,4
2013,32,AL,869,857,12
2013,32,AR,206,214,-8
2013,32,AZ,506,493,13
2013,32,CA,1907,2005,-98
2013,32,CO,515,590,-75
2013,32,CT,584,504,80
2013,32,DC,40,35,5
2013,32,DE,461,429,32
2013,32,FL,36501,36833,-332
2013,32,GA,2148,2044,104
2013,32,HI,989,980,9
2013,32,IA,184,196,-12
2013,32,ID,72,75,-3
2013,32,IL,473,458,15
2013,32,IN,301,296,5
2013,32,KS,149,139,10
2013,32,KY,239,239,0
2013,32,LA,9697,9829,-132
2013,32,MA,843,803,40
2013,32,MD,911,892,19
2013,32,ME,120,117,3
2013,32,MI,211,209,2
2013,32,MN,128,137,-9
2013,32,MO,241,235,6
2013,32,MS,1354,1354,0
2013,32,MT,93,80,13
2013,32,NC,3120,3019,101
2013,32,ND,156,166,-10
2013,32,NE,97,109,-12
2013,32,NH,74,68,6
2013,32,NJ,3768,3719,49
2013,32,NM,181,191,-10
2013,32,NV,177,173,4
2013,32,NY,3451,3045,406
2013,32,OH,426,414,12
2013,32,OK,265,271,-6
2013,32,OR,281,295,-14
2013,32,PA,930,941,-11
2013,32,PR,85,125,-40
2013,32,RI,321,311,10
2013,32,SC,4020,3868,152
2013,32,SD,77,74,3
2013,32,TN,505,493,12
2013,32,TX,17281,18225,-944
2013,32,UT,59,55,4
2013,32,VA,2488,2525,-37
2013,32,VI,15,25,-10
2013,32,VT,53,42,11
2013,32,WA,397,391,6
2013,32,WI,192,192,0
2013,32,WV,203,205,-2
2013,32,WY,25,26,-1
2013,33,AK,33,28,5
2013,33,AL,1030,1019,11
2013,33,AR,187,192,-5
2013,33,AZ,534,475,59
2013,33,CA,2155,2177,-22
2013,33,CO,331,351,-20
2013,33,CT,756,687,69
2013,33,DC,35,40,-5
2013,33,DE,353,331,22
2013,33,FL,34219,34497,-278
2013,33,GA,1963,1929,34
2013,33,GU,4,4,0
2013,33,HI,2466,2458,8
2013,33,IA,177,196,-19
2013,33,ID,67,73,-6
2013,33,IL,610,618,-8
2013,33,IN,318,320,-2
2013,33,KS,150,158,-8
2013,33,KY,262,261,1
2013,33,LA,9248,9385,-137
2013,33,MA,944,913,31
2013,33,MD,1019,992,27
2013,33,ME,137,127,10
2013,33,MI,190,177,13
2013,33,MN,115,123,-8
2013,33,MO,229,249,-20
2013,33,MS,1249,1258,-9
2013,33,MT,79,76,3
2013,33,NC,2960,2924,36
2013,33,ND,128,142,-14
2013,33,NE,113,112,1
2013,33,NH,98,96,2
2013,33,NJ,3583,3002,581
2013,33,NM,175,157,18
2013,33,NV,178,156,22
2013,33,NY,3635,3213,422
2013,33,OH,450,428,22
2013,33,OK,209,207,2
2013,33,OR,382,398,-16
2013,33,PA,1204,1191,13
2013,33,PR,118,160,-42
2013,33,RI,319,309,10
2013,33,SC,3977,3893,84
2013,33,SD,116,110,6
2013,33,TN,495,492,3
2013,33,TX,15500,16214,-714
2013,33,UT,38,37,1
2013,33,VA,2320,2358,-38
2013,33,VI,34,33,1
2013,33,VT,37,39,-2
2013,33,WA,379,379,0
2013,33,WI,184,196,-12
2013,33,WV,212,207,5
2013,33,WY,57,58,-1
2013,34,AK,52,55,-3
2013,34,AL,1055,1044,11
2013,34,AR,211,217,-6
2013,34,AZ,462,431,31
2013,34,CA,2227,2210,17
2013,34,CO,494,500,-6
2013,34,CT,737,560,177
2013,34,DC,95,92,3
2013,34,DE,615,611,4
2013,34,FL,39127,40165,-1038
2013,34,GA,2171,2150,21
2013,34,GU,4,4,0
2013,34,HI,2357,2315,42
2013,34,IA,189,206,-17
2013,34,ID,66,65,1
2013,34,IL,625,599,26
2013,34,IN,331,335,-4
2013,34,KS,164,165,-1
2013,34,KY,278,274,4
2013,34,LA,11190,11351,-161
2013,34,MA,1057,1043,14
2013,34,MD,1086,1079,7
2013,34,ME,152,148,4
2013,34,MI,277,272,5
2013,34,MN,144,148,-4
2013,34,MO,260,276,-16
2013,34,MS,1437,1474,-37
2013,34,MT,64,50,14
2013,34,NC,3274,3247,27
2013,34,ND,209,214,-5
2013,34,NE,104,110,-6
2013,34,NH,93,87,6
2013,34,NJ,3564,3518,46
2013,34,NM,172,163,9
2013,34,NV,170,164,6
2013,34,NY,3706,3320,386
2013,34,OH,561,501,60
2013,34,OK,255,236,19
2013,34,OR,325,370,-45
2013,34,PA,1022,1014,8
2013,34,PR,286,274,12
2013,34,RI,394,359,35
2013,34,SC,4071,4027,44
2013,34,SD,141,131,10
2013,34,TN,493,493,0
2013,34,TX,16286,16878,-592
2013,34,UT,61,54,7
2013,34,VA,3215,3287,-72
2013,34,VI,9,9,0
2013,34,VT,43,32,11
2013,34,WA,444,441,3
2013,34,WI,213,219,-6
2013,34,WV,231,235,-4
2013,34,WY,29,31,-2
2013,35,AK,38,34,4
2013,35,AL,929,907,22
2013,35,AR,171,162,9
2013,35,AZ,439,486,-47
2013,35,CA,2158,2174,-16
2013,35,CO,407,404,3
2013,35,CT,737,638,99
2013,35,DC,37,39,-2
2013,35,DE,387,388,-1
2013,35,FL,31341,31266,75
2013,35,GA,1765,1730,35
2013,35,GU,1,1,0
2013,35,HI,622,611,11
2013,35,IA,173,184,-11
2013,35,ID,55,55,0
2013,35,IL,478,467,11
2013,35,IN,261,271,-10
2013,35,KS,155,137,18
2013,35,KY,231,230,1
2013,35,LA,7564,7705,-141
2013,35,MA,724,719,5
2013,35,MD,998,961,37
2013,35,ME,111,108,3
2013,35,MI,139,145,-6
2013,35,MN,137,134,3
2013,35,MO,246,235,11
2013,35,MS,1122,1157,-35
2013,35,MT,45,38,7
2013,35,NC,2658,2655,3
2013,35,ND,218,243,-25
2013,35,NE,76,70,6
2013,35,NH,176,175,1
2013,35,NJ,3338,3538,-200
2013,35,NM,167,164,3
2013,35,NV,131,128,3
2013,35,NY,3451,3164,287
2013,35,OH,417,409,8
2013,35,OK,216,212,4
2013,35,OR,489,598,-109
2013,35,PA,823,835,-12
2013,35,PR,149,318,-169
2013,35,RI,265,273,-8
2013,35,SC,3161,3142,19
2013,35,SD,62,50,12
2013,35,TN,485,480,5
2013,35,TX,12813,13459,-646
2013,35,UT,71,79,-8
2013,35,VA,2234,2297,-63
2013,35,VI,13,13,0
2013,35,VT,71,65,6
2013,35,WA,376,377,-1
2013,35,WI,185,189,-4
2013,35,WV,211,224,-13
2013,35,WY,24,26,-2
2013,36,AK,45,42,3
2013,36,AL,884,877,7
2013,36,AR,200,199,1
2013,36,AZ,369,383,-14
2013,36,CA,2076,2075,1
2013,36,CO,401,384,17
2013,36,CT,592,498,94
2013,36,DC,25,25,0
2013,36,DE,409,393,16
2013,36,FL,29853,30114,-261
2013,36,GA,1623,1569,54
2013,36,GU,1,1,0
2013,36,HI,1370,1346,24
2013,36,IA,174,189,-15
2013,36,ID,54,52,2
2013,36,IL,437,415,22
2013,36,IN,261,275,-14
2013,36,KS,149,156,-7
2013,36,KY,267,263,4
2013,36,LA,7566,7641,-75
2013,36,MA,823,805,18
2013,36,MD,814,820,-6
2013,36,ME,158,149,9
2013,36,MI,164,166,-2
2013,36,MN,118,121,-3
2013,36,MO,254,240,14
2013,36,MS,997,1004,-7
2013,36,MT,71,60,11
2013,36,NC,2423,2382,41
2013,36,ND,223,242,-19
2013,36,NE,80,80,0
2013,36,NH,132,129,3
2013,36,NJ,2973,2860,113
2013,36,NM,164,164,0
2013,36,NV,127,130,-3
2013,36,NY,4396,3957,439
2013,36,OH,456,448,8
2013,36,OK,234,223,11
2013,36,OR,305,345,-40
2013,36,PA,877,862,15
2013,36,PR,129,152,-23
2013,36,RI,353,330,23
2013,36,SC,3185,3110,75
2013,36,SD,65,57,8
2013,36,TN,485,418,67
2013,36,TX,12673,12563,110
2013,36,UT,45,48,-3
2013,36,VA,2234,2241,-7
2013,36,VI,23,24,-1
2013,36,VT,46,38,8
2013,36,WA,367,366,1
2013,36,WI,180,177,3
2013,36,WV,231,225,6
2013,36,WY,36,21,15
2013,37,AK,37,33,4
2013,37,AL,1009,990,19
2013,37,AR,193,186,7
2013,37,AZ,488,506,-18
2013,37,CA,2398,2435,-37
2013,37,CO,461,432,29
2013,37,CT,648,559,89
2013,37,DC,35,38,-3
2013,37,DE,386,366,20
2013,37,FL,31576,32191,-615
2013,37,GA,1851,1803,48
2013,37,GU,2,2,0
2013,37,HI,921,910,11
2013,37,IA,163,178,-15
2013,37,ID,82,77,5
2013,37,IL,442,449,-7
2013,37,IN,325,330,-5
2013,37,KS,135,131,4
2013,37,KY,298,294,4
2013,37,LA,7903,8000,-97
2013,37,MA,971,954,17
2013,37,MD,1077,1050,27
2013,37,ME,141,132,9
2013,37,MI,238,236,2
2013,37,MN,106,105,1
2013,37,MO,302,314,-12
2013,37,MS,1130,1132,-2
2013,37,MT,67,56,11
2013,37,NC,2542,2514,28
2013,37,ND,216,240,-24
2013,37,NE,85,87,-2
2013,37,NH,145,148,-3
2013,37,NJ,3363,3435,-72
2013,37,NM,189,190,-1
2013,37,NV,141,138,3
2013,37,NY,4425,4003,422
2013,37,OH,433,430,3
2013,37,OK,245,244,1
2013,37,OR,444,558,-114
2013,37,PA,1017,987,30
2013,37,PR,256,228,28
2013,37,RI,272,275,-3
2013,37,SC,4000,3932,68
2013,37,SD,81,94,-13
2013,37,TN,479,487,-8
2013,37,TX,12488,12722,-234
2013,37,UT,60,59,1
2013,37,VA,2130,2230,-100
2013,37,VI,20,13,7
2013,37,VT,33,31,2
2013,37,WA,447,447,0
2013,37,WI,187,178,9
2013,37,WV,214,212,2
2013,37,WY,20,20,0
2013,38,AK,49,42,7
2013,38,AL,821,835,-14
2013,38,AR,218,224,-6
2013,38,AZ,502,512,-10
2013,38,CA,2569,2518,51
2013,38,CO,381,327,54
2013,38,CT,815,741,74
2013,38,DC,311,320,-9
2013,38,DE,504,511,-7
2013,38,FL,35067,35915,-848
2013,38,GA,1846,1887,-41
2013,38,GU,2,2,0
2013,38,HI,1649,1642,7
2013,38,IA,327,334,-7
2013,38,ID,57,56,1
2013,38,IL,515,503,12
2013,38,IN,271,275,-4
2013,38,KS,150,143,7
2013,38,KY,285,293,-8
2013,38,LA,8474,8673,-199
2013,38,MA,1128,1097,31
2013,38,MD,1234,1294,-60
2013,38,ME,143,148,-5
2013,38,MI,205,224,-19
2013,38,MN,123,134,-11
2013,38,MO,285,270,15
2013,38,MS,1086,1135,-49
2013,38,MT,47,46,1
2013,38,NC,2884,2983,-99
2013,38,ND,200,216,-16
2013,38,NE,88,81,7
2013,38,NH,136,149,-13
2013,38,NJ,3870,3867,3
2013,38,NM,153,145,8
2013,38,NV,217,176,41
2013,38,NY,4693,4456,237
2013,38,OH,491,499,-8
2013,38,OK,234,231,3
2013,38,OR,396,461,-65
2013,38,PA,989,1000,-11
2013,38,PR,156,199,-43
2013,38,RI,399,397,2
2013,38,SC,3528,3537,-9
2013,38,SD,77,80,-3
2013,38,TN,669,677,-8
2013,38,TX,12563,12860,-297
2013,38,UT,76,70,6
2013,38,VA,2580,2775,-195
2013,38,VI,14,14,0
2013,38,VT,51,51,0
2013,38,WA,559,564,-5
2013,38,WI,174,181,-7
2013,38,WV,232,231,1
2013,38,WY,22,24,-2
2013,39,AK,44,41,3
2013,39,AL,1088,1105,-17
2013,39,AR,217,221,-4
2013,39,AZ,412,420,-8
2013,39,CA,2736,2857,-121
2013,39,CO,343,275,68
2013,39,CT,678,621,57
2013,39,DC,47,48,-1
2013,39,DE,451,461,-10
2013,39,FL,38165,39286,-1121
2013,39,GA,2101,2327,-226
2013,39,GU,1,1,0
2013,39,HI,1954,1960,-6
2013,39,IA,159,160,-1
2013,39,ID,56,56,0
2013,39,IL,499,489,10
2013,39,IN,326,335,-9
2013,39,KS,144,145,-1
2013,39,KY,303,326,-23
2013,39,LA,7252,7433,-181
2013,39,MA,920,938,-18
2013,39,MD,1524,1561,-37
2013,39,ME,180,178,2
2013,39,MI,162,165,-3
2013,39,MN,128,144,-16
2013,39,MO,288,301,-13
2013,39,MS,949,1005,-56
2013,39,MT,64,48,16
2013,39,NC,2696,2830,-134
2013,39,ND,176,197,-21
2013,39,NE,117,123,-6
2013,39,NH,156,154,2
2013,39,NJ,4070,4269,-199
2013,39,NM,135,156,-21
2013,39,NV,150,136,14
2013,39,NY,4367,4318,49
2013,39,OH,459,490,-31
2013,39,OK,244,261,-17
2013,39,OR,388,470,-82
2013,39,PA,974,991,-17
2013,39,PR,706,765,-59
2013,39,RI,365,359,6
2013,39,SC,4658,4775,-117
2013,39,SD,51,54,-3
2013,39,TN,503,523,-20
2013,39,TX,11376,11873,-497
2013,39,UT,67,64,3
2013,39,VA,2973,3128,-155
2013,39,VI,13,12,1
2013,39,VT,56,57,-1
2013,39,WA,647,688,-41
2013,39,WI,199,195,4
2013,39,WV,210,219,-9
2013,39,WY,30,28,2
2013,40,AK,34,29,5
2013,40,AL,763,786,-23
2013,40,AR,142,154,-12
2013,40,AZ,398,394,4
2013,40,CA,2716,2789,-73
2013,40,CO,416,258,158
2013,40,CT,725,664,61
2013,40,DC,37,41,-4
2013,40,DE,451,447,4
2013,40,FL,27244,27718,-474
2013,40,GA,1497,1521,-24
2013,40,HI,1249,1249,0
2013,40,IA,147,156,-9
2013,40,ID,63,57,6
2013,40,IL,360,357,3
2013,40,IN,236,248,-12
2013,40,KS,116,111,5
2013,40,KY,211,222,-11
2013,40,LA,6076,6300,-224
2013,40,MA,1037,1018,19
2013,40,MD,978,1025,-47
2013,40,ME,154,154,0
2013,40,MI,171,176,-5
2013,40,MN,119,121,-2
2013,40,MO,234,256,-22
2013,40,MS,894,966,-72
2013,40,MT,46,45,1
2013,40,NC,2184,2236,-52
2013,40,ND,163,178,-15
2013,40,NE,75,73,2
2013,40,NH,90,81,9
2013,40,NJ,3037,3000,37
2013,40,NM,129,125,4
2013,40,NV,168,155,13
2013,40,NY,3879,3897,-18
2013,40,OH,403,412,-9
2013,40,OK,245,264,-19
2013,40,OR,382,392,-10
2013,40,PA,1143,1211,-68
2013,40,PR,150,158,-8
2013,40,RI,231,225,6
2013,40,SC,2776,2850,-74
2013,40,SD,52,46,6
2013,40,TN,394,405,-11
2013,40,TX,9724,10255,-531
2013,40,UT,67,62,5
2013,40,VA,2078,2236,-158
2013,40,VI,10,13,-3
2013,40,VT,75,80,-5
2013,40,WA,564,579,-15
2013,40,WI,131,134,-3
2013,40,WV,224,227,-3
2013,40,WY,24,22,2
2013,41,AK,39,36,3
2013,41,AL,1576,1588,-12
2013,41,AR,196,202,-6
2013,41,AZ,423,394,29
2013,41,CA,3493,3521,-28
2013,41,CO,630,211,419
2013,41,CT,590,590,0
2013,41,DC,32,37,-5
2013,41,DE,405,403,2
2013,41,FL,26966,27751,-785
2013,41,GA,1450,1471,-21
2013,41,GU,1,1,0
2013,41,HI,1025,1019,6
2013,41,IA,140,145,-5
2013,41,ID,87,77,10
2013,41,IL,461,438,23
2013,41,IN,319,322,-3
2013,41,KS,131,127,4
2013,41,KY,257,253,4
2013,41,LA,6866,7005,-139
2013,41,MA,1014,999,15
2013,41,MD,1195,1197,-2
2013,41,ME,217,207,10
2013,41,MI,158,162,-4
2013,41,MN,112,114,-2
2013,41,MO,240,253,-13
2013,41,MS,858,885,-27
2013,41,MT,51,46,5
2013,41,NC,2147,2169,-22
2013,41,ND,185,191,-6
2013,41,NE,87,86,1
2013,41,NH,83,87,-4
2013,41,NJ,3222,3206,16
2013,41,NM,170,130,40
2013,41,NV,153,163,-10
2013,41,NY,3619,3182,437
2013,41,OH,462,471,-9
2013,41,OK,211,220,-9
2013,41,OR,531,542,-11
2013,41,PA,1139,1215,-76
2013,41,PR,110,172,-62
2013,41,RI,296,285,11
2013,41,SC,2769,2815,-46
2013,41,SD,70,67,3
2013,41,TN,423,441,-18
2013,41,TX,10140,10432,-292
2013,41,UT,79,70,9
2013,41,VA,2107,2139,-32
2013,41,VI,21,14,7
2013,41,VT,54,61,-7
2013,41,WA,676,711,-35
2013,41,WI,159,171,-12
2013,41,WV,183,197,-14
2013,41,WY,26,20,6
2013,42,AK,55,56,-1
2013,42,AL,605,632,-27
2013,42,AR,186,188,-2
2013,42,AZ,474,476,-2
2013,42,CA,3977,4023,-46
2013,42,CO,542,309,233
2013,42,CT,580,546,34
2013,42,DC,42,47,-5
2013,42,DE,367,372,-5
2013,42,FL,27122,27432,-310
2013,42,GA,1865,2099,-234
2013,42,GU,1,1,0
2013,42,HI,426,434,-8
2013,42,IA,198,209,-11
2013,42,ID,78,64,14
2013,42,IL,457,442,15
2013,42,IN,315,323,-8
2013,42,KS,137,140,-3
2013,42,KY,237,235,2
2013,42,LA,6091,6265,-174
2013,42,MA,835,824,11
2013,42,MD,993,1008,-15
2013,42,ME,136,137,-1
2013,42,MI,209,202,7
2013,42,MN,127,123,4
2013,42,MO,239,250,-11
2013,42,MS,1006,1047,-41
2013,42,MT,52,47,5
2013,42,NC,2005,2035,-30
2013,42,ND,220,242,-22
2013,42,NE,81,83,-2
2013,42,NH,110,123,-13
2013,42,NJ,3103,3149,-46
2013,42,NM,152,124,28
2013,42,NV,547,542,5
2013,42,NY,3071,2963,108
2013,42,OH,480,486,-6
2013,42,OK,250,256,-6
2013,42,OR,468,471,-3
2013,42,PA,1173,1250,-77
2013,42,PR,183,257,-74
2013,42,RI,218,219,-1
2013,42,SC,2898,2873,25
2013,42,SD,53,52,1
2013,42,TN,453,479,-26
2013,42,TX,10459,10658,-199
2013,42,UT,72,63,9
2013,42,VA,2301,2342,-41
2013,42,VI,7,9,-2
2013,42,VT,61,57,4
2013,42,WA,711,726,-15
2013,42,WI,139,145,-6
2013,42,WV,195,207,-12
2013,42,WY,25,24,1
2013,43,AK,50,43,7
2013,43,AL,1085,1103,-18
2013,43,AR,201,211,-10
2013,43,AZ,385,368,17
2013,43,CA,4066,4064,2
2013,43,CO,385,397,-12
2013,43,CT,539,521,18
2013,43,DC,34,25,9
2013,43,DE,713,724,-11
2013,43,FL,36540,37707,-1167
2013,43,GA,1942,2000,-58
2013,43,HI,1864,1876,-12
2013,43,IA,186,197,-11
2013,43,ID,83,81,2
2013,43,IL,503,490,13
2013,43,IN,306,300,6
2013,43,KS,148,148,0
2013,43,KY,268,276,-8
2013,43,LA,7461,7724,-263
2013,43,MA,957,927,30
2013,43,MD,1183,1229,-46
2013,43,ME,144,129,15
2013,43,MI,191,207,-16
2013,43,MN,120,120,0
2013,43,MO,253,266,-13
2013,43,MS,947,940,7
2013,43,MT,64,58,6
2013,43,NC,2223,2259,-36
2013,43,ND,242,267,-25
2013,43,NE,80,83,-3
2013,43,NH,183,185,-2
2013,43,NJ,3209,3321,-112
2013,43,NM,152,152,0
2013,43,NV,173,180,-7
2013,43,NY,3729,3569,160
2013,43,OH,472,468,4
2013,43,OK,267,291,-24
2013,43,OR,534,511,23
2013,43,PA,1427,1507,-80
2013,43,PR,88,151,-63
2013,43,RI,256,261,-5
2013,43,SC,3351,3329,22
2013,43,SD,65,71,-6
2013,43,TN,449,461,-12
2013,43,TX,11586,12152,-566
2013,43,UT,73,74,-1
2013,43,VA,2146,2247,-101
2013,43,VI,120,9,111
2013,43,VT,72,78,-6
2013,43,WA,1072,1105,-33
2013,43,WI,163,166,-3
2013,43,WV,184,199,-15
2013,43,WY,29,28,1
2013,44,AK,36,35,1
2013,44,AL,564,581,-17
2013,44,AR,173,180,-7
2013,44,AZ,278,266,12
2013,44,CA,4074,4173,-99
2013,44,CO,257,199,58
2013,44,CT,507,466,41
2013,44,DC,29,30,-1
2013,44,DE,277,271,6
2013,44,FL,22008,22536,-528
2013,44,GA,1314,1388,-74
2013,44,HI,924,927,-3
2013,44,IA,125,121,4
2013,44,ID,64,61,3
2013,44,IL,391,384,7
2013,44,IN,277,284,-7
2013,44,KS,100,102,-2
2013,44,KY,257,260,-3
2013,44,LA,5012,5145,-133
2013,44,MA,714,694,20
2013,44,MD,714,687,27
2013,44,ME,139,136,3
2013,44,MI,151,155,-4
2013,44,MN,88,82,6
2013,44,MO,311,299,12
2013,44,MS,857,856,1
2013,44,MT,48,52,-4
2013,44,NC,1734,1709,25
2013,44,ND,138,139,-1
2013,44,NE,67,65,2
2013,44,NH,137,133,4
2013,44,NJ,2703,2712,-9
2013,44,NM,107,97,10
2013,44,NV,175,173,2
2013,44,NY,2527,2431,96
2013,44,OH,391,396,-5
2013,44,OK,178,190,-12
2013,44,OR,448,467,-19
2013,44,PA,855,896,-41
2013,44,PR,91,116,-25
2013,44,RI,167,154,13
2013,44,SC,2167,2163,4
2013,44,SD,41,43,-2
2013,44,TN,387,360,27
2013,44,TX,7378,7634,-256
2013,44,UT,47,44,3
2013,44,VA,1484,1501,-17
2013,44,VI,14,14,0
2013,44,VT,62,63,-1
2013,44,WA,879,899,-20
2013,44,WI,137,145,-8
2013,44,WV,194,199,-5
2013,44,WY,30,23,7
2013,45,AK,26,29,-3
2013,45,AL,619,633,-14
2013,45,AR,150,151,-1
2013,45,AZ,309,322,-13
2013,45,CA,4088,4228,-140
2013,45,CO,329,252,77
2013,45,CT,736,703,33
2013,45,DC,24,26,-2
2013,45,DE,307,300,7
2013,45,FL,22863,23297,-434
2013,45,GA,1366,1389,-23
2013,45,GU,1,1,0
2013,45,HI,495,501,-6
2013,45,IA,124,131,-7
2013,45,ID,65,72,-7
2013,45,IL,394,394,0
2013,45,IN,240,262,-22
2013,45,KS,113,114,-1
2013,45,KY,216,227,-11
2013,45,LA,5368,5472,-104
2013,45,MA,723,705,18
2013,45,MD,965,941,24
2013,45,ME,138,135,3
2013,45,MI,134,152,-18
2013,45,MN,95,102,-7
2013,45,MO,178,204,-26
2013,45,MS,886,928,-42
2013,45,MT,44,40,4
2013,45,NC,1918,1930,-12
2013,45,ND,116,118,-2
2013,45,NE,68,73,-5
2013,45,NH,82,83,-1
2013,45,NJ,2961,2994,-33
2013,45,NM,95,98,-3
2013,45,NV,158,168,-10
2013,45,NY,2667,2520,147
2013,45,OH,354,379,-25
2013,45,OK,200,194,6
2013,45,OR,476,497,-21
2013,45,PA,907,931,-24
2013,45,PR,840,929,-89
2013,45,RI,168,168,0
2013,45,SC,2435,2422,13
2013,45,SD,49,49,0
2013,45,TN,319,329,-10
2013,45,TX,7493,7878,-385
2013,45,UT,59,62,-3
2013,45,VA,1578,1602,-24
2013,45,VI,2,3,-1
2013,45,VT,53,50,3
2013,45,WA,762,836,-74
2013,45,WI,127,127,0
2013,45,WV,151,173,-22
2013,45,WY,22,22,0
2013,46,AK,56,29,27
2013,46,AL,456,484,-28
2013,46,AR,155,166,-11
2013,46,AZ,310,303,7
2013,46,CA,3942,4103,-161
2013,46,CO,360,284,76
2013,46,CT,506,447,59
2013,46,DC,26,26,0
2013,46,DE,316,292,24
2013,46,FL,21928,22738,-810
2013,46,GA,1152,1179,-27
2013,46,HI,347,363,-16
2013,46,IA,101,111,-10
2013,46,ID,61,62,-1
2013,46,IL,549,432,117
2013,46,IN,243,252,-9
2013,46,KS,118,120,-2
2013,46,KY,211,211,0
2013,46,LA,5313,5411,-98
2013,46,MA,722,711,11
2013,46,MD,946,917,29
2013,46,ME,123,122,1
2013,46,MI,141,147,-6
2013,46,MN,98,106,-8
2013,46,MO,250,264,-14
2013,46,MS,914,1002,-88
2013,46,MT,37,38,-1
2013,46,NC,1751,1765,-14
2013,46,ND,99,97,2
2013,46,NE,62,72,-10
2013,46,NH,60,62,-2
2013,46,NJ,2787,2809,-22
2013,46,NM,118,115,3
2013,46,NV,168,166,2
2013,46,NY,2800,2651,149
2013,46,OH,431,456,-25
2013,46,OK,194,189,5
2013,46,OR,498,513,-15
2013,46,PA,803,843,-40
2013,46,PR,87,135,-48
2013,46,RI,168,176,-8
2013,46,SC,2641,2647,-6
2013,46,SD,42,40,2
2013,46,TN,382,383,-1
2013,46,TX,7453,7751,-298
2013,46,UT,59,60,-1
2013,46,VA,1522,1545,-23
2013,46,VI,10,8,2
2013,46,VT,56,55,1
2013,46,WA,972,1019,-47
2013,46,WI,116,112,4
2013,46,WV,175,199,-24
2013,46,WY,17,17,0
2013,47,AK,30,31,-1
2013,47,AL,581,581,0
2013,47,AR,159,169,-10
2013,47,AZ,320,325,-5
2013,47,CA,3722,3977,-255
2013,47,CO,250,220,30
2013,47,CT,670,666,4
2013,47,DC,45,56,-11
2013,47,DE,352,387,-35
2013,47,FL,22775,23523,-748
2013,47,GA,1254,1287,-33
2013,47,GU,1,1,0
2013,47,HI,2799,2804,-5
2013,47,IA,109,112,-3
2013,47,ID,60,59,1
2013,47,IL,379,385,-6
2013,47,IN,228,230,-2
2013,47,KS,110,112,-2
2013,47,KY,219,235,-16
2013,47,LA,5547,5701,-154
2013,47,MA,878,838,40
2013,47,MD,1072,1172,-100
2013,47,ME,127,130,-3
2013,47,MI,198,204,-6
2013,47,MN,103,108,-5
2013,47,MO,189,200,-11
2013,47,MS,868,907,-39
2013,47,MT,56,44,12
2013,47,NC,1545,1559,-14
2013,47,ND,104,95,9
2013,47,NE,68,70,-2
2013,47,NH,189,196,-7
2013,47,NJ,3159,2705,454
2013,47,NM,103,110,-7
2013,47,NV,139,132,7
2013,47,NY,2859,2909,-50
2013,47,OH,365,416,-51
2013,47,OK,162,158,4
2013,47,OR,520,533,-13
2013,47,PA,881,977,-96
2013,47,PR,167,232,-65
2013,47,RI,206,220,-14
2013,47,SC,2234,2235,-1
2013,47,SD,50,48,2
2013,47,TN,451,476,-25
2013,47,TX,7559,7745,-186
2013,47,UT,66,66,0
2013,47,VA,1642,1838,-196
2013,47,VI,4,5,-1
2013,47,VT,77,80,-3
2013,47,WA,782,826,-44
2013,47,WI,120,129,-9
2013,47,WV,159,167,-8
2013,47,WY,17,16,1
2013,48,AK,32,30,2
2013,48,AL,957,978,-21
2013,48,AR,184,180,4
2013,48,AZ,287,280,7
2013,48,CA,4877,5141,-264
2013,48,CO,288,228,60
2013,48,CT,917,906,11
2013,48,DC,35,35,0
2013,48,DE,341,361,-20
2013,48,FL,26075,26690,-615
2013,48,GA,1057,1134,-77
2013,48,GU,2,2,0
2013,48,HI,715,717,-2
2013,48,IA,140,145,-5
2013,48,ID,59,67,-8
2013,48,IL,441,410,31
2013,48,IN,229,235,-6
2013,48,KS,117,121,-4
2013,48,KY,184,190,-6
2013,48,LA,5185,5324,-139
2013,48,MA,662,685,-23
2013,48,MD,978,996,-18
2013,48,ME,143,144,-1
2013,48,MI,340,357,-17
2013,48,MN,96,98,-2
2013,48,MO,245,257,-12
2013,48,MS,972,1012,-40
2013,48,MT,59,64,-5
2013,48,NC,1594,1656,-62
2013,48,ND,97,99,-2
2013,48,NE,72,85,-13
2013,48,NH,89,103,-14
2013,48,NJ,2788,2930,-142
2013,48,NM,161,147,14
2013,48,NV,131,137,-6
2013,48,NY,2816,2877,-61
2013,48,OH,403,425,-22
2013,48,OK,201,196,5
2013,48,OR,515,537,-22
2013,48,PA,869,932,-63
2013,48,PR,166,180,-14
2013,48,RI,213,211,2
2013,48,SC,2382,2393,-11
2013,48,SD,48,43,5
2013,48,TN,326,349,-23
2013,48,TX,6804,6661,143
2013,48,UT,46,49,-3
2013,48,VA,1610,1625,-15
2013,48,VI,41,43,-2
2013,48,VT,40,44,-4
2013,48,WA,745,814,-69
2013,48,WI,128,134,-6
2013,48,WV,156,162,-6
2013,48,WY,14,14,0
2013,49,AK,52,48,4
2013,49,AL,674,1586,-912
2013,49,AR,131,131,0
2013,49,AZ,301,275,26
2013,49,CA,4351,4644,-293
2013,49,CO,231,184,47
2013,49,CT,362,359,3
2013,49,DC,26,21,5
2013,49,DE,347,353,-6
2013,49,FL,21299,22274,-975
2013,49,GA,1057,1084,-27
2013,49,GU,1,1,0
2013,49,HI,527,527,0
2013,49,IA,133,138,-5
2013,49,ID,63,66,-3
2013,49,IL,349,354,-5
2013,49,IN,187,198,-11
2013,49,KS,115,127,-12
2013,49,KY,190,198,-8
2013,49,LA,4707,4839,-132
2013,49,MA,538,531,7
2013,49,MD,1017,1062,-45
2013,49,ME,112,110,2
2013,49,MI,187,196,-9
2013,49,MN,66,75,-9
2013,49,MO,203,211,-8
2013,49,MS,796,840,-44
2013,49,MT,47,44,3
2013,49,NC,1566,1643,-77
2013,49,ND,114,114,0
2013,49,NE,70,64,6
2013,49,NH,80,88,-8
2013,49,NJ,2798,2982,-184
2013,49,NM,124,124,0
2013,49,NV,139,147,-8
2013,49,NY,2851,2923,-72
2013,49,OH,481,482,-1
2013,49,OK,182,178,4
2013,49,OR,472,479,-7
2013,49,PA,760,784,-24
2013,49,PR,49,95,-46
2013,49,RI,132,122,10
2013,49,SC,2041,2039,2
2013,49,SD,68,73,-5
2013,49,TN,363,373,-10
2013,49,TX,6094,6272,-178
2013,49,UT,38,41,-3
2013,49,VA,1328,1407,-79
2013,49,VI,5,6,-1
2013,49,VT,39,41,-2
2013,49,WA,639,701,-62
2013,49,WI,120,116,4
2013,49,WV,149,157,-8
2013,49,WY,18,17,1
2013,50,AK,26,29,-3
2013,50,AL,582,612,-30
2013,50,AR,187,193,-6
2013,50,AZ,344,317,27
2013,50,CA,3973,4205,-232
2013,50,CO,324,271,53
2013,50,CT,568,577,-9
2013,50,DC,45,46,-1
2013,50,DE,355,353,2
2013,50,FL,27836,28932,-1096
2013,50,GA,1226,1236,-10
2013,50,GU,2,2,0
2013,50,HI,814,853,-39
2013,50,IA,135,141,-6
2013,50,ID,74,73,1
2013,50,IL,436,393,43
2013,50,IN,240,239,1
2013,50,KS,106,117,-11
2013,50,KY,268,279,-11
2013,50,LA,5880,5985,-105
2013,50,MA,832,822,10
2013,50,MD,835,855,-20
2013,50,ME,126,118,8
2013,50,MI,165,171,-6
2013,50,MN,94,96,-2
2013,50,MO,235,256,-21
2013,50,MP,1,1,0
2013,50,MS,816,838,-22
2013,50,MT,48,46,2
2013,50,NC,1818,1849,-31
2013,50,ND,117,122,-5
2013,50,NE,83,91,-8
2013,50,NH,95,94,1
2013,50,NJ,4226,4139,87
2013,50,NM,119,131,-12
2013,50,NV,136,139,-3
2013,50,NY,3335,3374,-39
2013,50,OH,364,360,4
2013,50,OK,199,179,20
2013,50,OR,599,618,-19
2013,50,PA,819,846,-27
2013,50,PR,158,235,-77
2013,50,RI,177,163,14
2013,50,SC,2674,2639,35
2013,50,SD,67,69,-2
2013,50,TN,331,338,-7
2013,50,TX,6946,7167,-221
2013,50,UT,61,55,6
2013,50,VA,1586,1637,-51
2013,50,VI,8,10,-2
2013,50,VT,43,51,-8
2013,50,WA,775,853,-78
2013,50,WI,124,128,-4
2013,50,WV,177,189,-12
2013,50,WY,25,23,2
2013,51,AK,23,21,2
2013,51,AL,402,431,-29
2013,51,AR,97,101,-4
2013,51,AZ,230,206,24
2013,51,CA,2806,3042,-236
2013,51,CO,189,178,11
2013,51,CT,293,288,5
2013,51,DC,22,22,0
2013,51,DE,205,207,-2
2013,51,FL,17406,17812,-406
2013,51,GA,690,667,23
2013,51,HI,1176,1176,0
2013,51,IA,96,102,-6
2013,51,ID,42,42,0
2013,51,IL,234,225,9
2013,51,IN,175,168,7
2013,51,KS,82,82,0
2013,51,KY,154,161,-7
2013,51,LA,4355,4406,-51
2013,51,MA,412,400,12
2013,51,MD,1090,1085,5
2013,51,ME,88,91,-3
2013,51,MI,119,120,-1
2013,51,MN,52,58,-6
2013,51,MO,156,184,-28
2013,51,MS,530,527,3
2013,51,MT,29,28,1
2013,51,NC,981,987,-6
2013,51,ND,74,75,-1
2013,51,NE,78,81,-3
2013,51,NH,57,54,3
2013,51,NJ,2104,2166,-62
2013,51,NM,90,96,-6
2013,51,NV,93,95,-2
2013,51,NY,2245,1999,246
2013,51,OH,247,263,-16
2013,51,OK,109,103,6
2013,51,OR,303,325,-22
2013,51,PA,514,569,-55
2013,51,PR,57,104,-47
2013,51,RI,95,92,3
2013,51,SC,1409,1372,37
2013,51,SD,25,28,-3
2013,51,TN,322,323,-1
2013,51,TX,4505,4597,-92
2013,51,UN,1,1,0
2013,51,UT,47,47,0
2013,51,VA,924,965,-41
2013,51,VI,33,39,-6
2013,51,VT,27,31,-4
2013,51,WA,545,546,-1
2013,51,WI,63,56,7
2013,51,WV,110,121,-11
2013,51,WY,17,16,1
2013,52,AK,10,12,-2
2013,52,AL,258,292,-34
2013,52,AR,46,56,-10
2013,52,AZ,139,139,0
2013,52,CA,1603,1982,-379
2013,52,CO,122,114,8
2013,52,CT,135,145,-10
2013,52,DC,17,15,2
2013,52,DE,109,116,-7
2013,52,FL,14518,15389,-871
2013,52,GA,491,537,-46
2013,52,HI,93,96,-3
2013,52,IA,45,49,-4
2013,52,ID,28,29,-1
2013,52,IL,129,143,-14
2013,52,IN,106,120,-14
2013,52,KS,47,47,0
2013,52,KY,93,98,-5
2013,52,LA,3170,3392,-222
2013,52,MA,581,597,-16
2013,52,MD,302,320,-18
2013,52,ME,36,39,-3
2013,52,MI,86,82,4
2013,52,MN,37,41,-4
2013,52,MO,93,109,-16
2013,52,MS,365,408,-43
2013,52,MT,10,9,1
2013,52,NC,617,672,-55
2013,52,ND,51,57,-6
2013,52,NE,58,65,-7
2013,52,NH,42,42,0
2013,52,NJ,1186,1265,-79
2013,52,NM,44,47,-3
2013,52,NV,58,65,-7
2013,52,NY,1206,1135,71
2013,52,OH,141,153,-12
2013,52,OK,82,90,-8
2013,52,OR,184,203,-19
2013,52,PA,300,333,-33
2013,52,PR,76,169,-93
2013,52,RI,54,59,-5
2013,52,SC,1391,1442,-51
2013,52,SD,21,23,-2
2013,52,TN,124,140,-16
2013,52,TX,2911,3261,-350
2013,52,UT,17,21,-4
2013,52,VA,514,550,-36
2013,52,VI,4,4,0
2013,52,VT,16,15,1
2013,52,WA,255,286,-31
2013,52,WI,52,51,1
2013,52,WV,75,78,-3
2013,52,WY,12,13,-1
2014,0,AK,7,8,-1
2014,0,AL,232,229,3
2014,0,AR,74,79,-5
2014,0,AZ,185,153,32
2014,0,CA,3390,3672,-282
2014,0,CO,146,125,21
2014,0,CT,298,273,25
2014,0,DC,18,18,0
2014,0,DE,311,309,2
2014,0,FL,19659,20049,-390
2014,0,GA,711,570,141
2014,0,GU,2,2,0
2014,0,HI,253,277,-24
2014,0,IA,97,101,-4
2014,0,ID,37,33,4
2014,0,IL,208,184,24
2014,0,IN,155,146,9
2014,0,KS,56,51,5
2014,0,KY,127,125,2
2014,0,LA,2805,2771,34
2014,0,MA,356,359,-3
2014,0,MD,420,408,12
2014,0,ME,59,55,4
2014,0,MI,78,72,6
2014,0,MN,43,45,-2
2014,0,MO,88,92,-4
2014,0,MS,384,398,-14
2014,0,MT,29,28,1
2014,0,NC,1108,1102,6
2014,0,ND,139,135,4
2014,0,NE,49,53,-4
2014,0,NH,56,39,17
2014,0,NJ,1166,1176,-10
2014,0,NM,85,84,1
2014,0,NV,80,88,-8
2014,0,NY,1308,1320,-12
2014,0,OH,198,190,8
2014,0,OK,84,75,9
2014,0,OR,296,320,-24
2014,0,PA,427,431,-4
2014,0,PR,23,39,-16
2014,0,RI,68,55,13
2014,0,SC,1246,1232,14
2014,0,SD,41,42,-1
2014,0,TN,194,190,4
2014,0,TX,5414,5413,1
2014,0,UT,25,24,1
2014,0,VA,852,839,13
2014,0,VI,3,4,-1
2014,0,VT,28,29,-1
2014,0,WA,325,352,-27
2014,0,WI,138,134,4
2014,0,WV,91,95,-4
2014,0,WY,6,7,-1
2014,1,AK,26,26,0
2014,1,AL,505,502,3
2014,1,AR,115,128,-13
2014,1,AZ,311,303,8
2014,1,CA,3213,3441,-228
2014,1,CO,266,227,39
2014,1,CT,515,491,24
2014,1,DC,32,25,7
2014,1,DE,237,232,5
2014,1,FL,20395,21122,-727
2014,1,GA,887,906,-19
2014,1,HI,491,503,-12
2014,1,IA,133,153,-20
2014,1,ID,68,63,5
2014,1,IL,609,590,19
2014,1,IN,209,202,7
2014,1,KS,130,128,2
2014,1,KY,185,179,6
2014,1,LA,4250,4272,-22
2014,1,MA,577,499,78
2014,1,MD,740,738,2
2014,1,ME,91,89,2
2014,1,MI,127,136,-9
2014,1,MN,72,72,0
2014,1,MO,191,186,5
2014,1,MS,779,820,-41
2014,1,MT,46,45,1
2014,1,NC,1319,1323,-4
2014,1,ND,83,81,2
2014,1,NE,70,73,-3
2014,1,NH,59,54,5
2014,1,NJ,2180,2284,-104
2014,1,NM,120,117,3
2014,1,NV,154,163,-9
2014,1,NY,2657,2769,-112
2014,1,OH,417,430,-13
2014,1,OK,166,158,8
2014,1,OR,439,457,-18
2014,1,PA,657,686,-29
2014,1,PR,48,75,-27
2014,1,RI,324,305,19
2014,1,SC,1704,1675,29
2014,1,SD,36,39,-3
2014,1,TN,312,310,2
2014,1,TX,5074,5235,-161
2014,1,UT,44,42,2
2014,1,VA,1037,1041,-4
2014,1,VI,8,7,1
2014,1,VT,36,37,-1
2014,1,WA,494,539,-45
2014,1,WI,130,149,-19
2014,1,WV,137,149,-12
2014,1,WY,22,26,-4
2014,2,AK,42,44,-2
2014,2,AL,517,508,9
2014,2,AR,132,132,0
2014,2,AZ,260,251,9
2014,2,CA,3218,3472,-254
2014,2,CO,190,172,18
2014,2,CT,408,391,17
2014,2,DC,40,26,14
2014,2,DE,248,252,-4
2014,2,FL,21645,22567,-922
2014,2,GA,936,954,-18
2014,2,HI,1156,1154,2
2014,2,IA,116,123,-7
2014,2,ID,37,38,-1
2014,2,IL,316,332,-16
2014,2,IN,212,208,4
2014,2,KS,104,106,-2
2014,2,KY,158,169,-11
2014,2,LA,4619,4727,-108
2014,2,MA,511,526,-15
2014,2,MD,918,912,6
2014,2,ME,119,121,-2
2014,2,MI,148,153,-5
2014,2,MN,76,69,7
2014,2,MO,181,186,-5
2014,2,MS,746,769,-23
2014,2,MT,65,50,15
2014,2,NC,1561,1565,-4
2014,2,ND,217,212,5
2014,2,NE,78,75,3
2014,2,NH,96,95,1
2014,2,NJ,2594,2701,-107
2014,2,NM,112,109,3
2014,2,NV,151,160,-9
2014,2,NY,2943,2769,174
2014,2,OH,309,307,2
2014,2,OK,145,142,3
2014,2,OR,373,390,-17
2014,2,PA,1263,1294,-31
2014,2,PR,133,170,-37
2014,2,RI,129,115,14
2014,2,SC,2282,2252,30
2014,2,SD,44,47,-3
2014,2,TN,275,278,-3
2014,2,TX,5354,5669,-315
2014,2,UT,39,40,-1
2014,2,VA,1115,1137,-22
2014,2,VI,7,8,-1
2014,2,VT,41,40,1
2014,2,WA,595,525,70
2014,2,WI,126,126,0
2014,2,WV,146,164,-18
2014,2,WY,10,12,-2
2014,3,AK,20,18,2
2014,3,AL,404,412,-8
2014,3,AR,107,112,-5
2014,3,AZ,230,228,2
2014,3,CA,2456,2656,-200
2014,3,CO,172,159,13
2014,3,CT,348,347,1
2014,3,DC,22,12,10
2014,3,DE,345,339,6
2014,3,FL,19656,20359,-703
2014,3,GA,727,811,-84
2014,3,HI,428,432,-4
2014,3,IA,99,96,3
2014,3,ID,50,75,-25
2014,3,IL,295,305,-10
2014,3,IN,160,149,11
2014,3,KS,68,70,-2
2014,3,KY,150,149,1
2014,3,LA,3811,3924,-113
2014,3,MA,427,423,4
2014,3,MD,814,820,-6
2014,3,ME,67,67,0
2014,3,MI,147,151,-4
2014,3,MN,77,83,-6
2014,3,MO,169,182,-13
2014,3,MS,617,678,-61
2014,3,MT,45,40,5
2014,3,NC,1455,1475,-20
2014,3,ND,70,67,3
2014,3,NE,61,66,-5
2014,3,NH,61,63,-2
2014,3,NJ,1871,1986,-115
2014,3,NM,81,84,-3
2014,3,NV,101,114,-13
2014,3,NY,1955,2061,-106
2014,3,OH,276,264,12
2014,3,OK,122,125,-3
2014,3,OR,312,334,-22
2014,3,PA,558,592,-34
2014,3,PR,31,86,-55
2014,3,RI,98,104,-6
2014,3,SC,1939,1772,167
2014,3,SD,33,34,-1
2014,3,TN,251,250,1
2014,3,TX,4498,4582,-84
2014,3,UT,22,22,0
2014,3,VA,828,836,-8
2014,3,VI,21,28,-7
2014,3,VT,25,30,-5
2014,3,WA,430,471,-41
2014,3,WI,83,83,0
2014,3,WV,115,117,-2
2014,3,WY,20,20,0
2014,4,AK,45,42,3
2014,4,AL,798,809,-11
2014,4,AR,154,170,-16
2014,4,AZ,308,306,2
2014,4,CA,2973,3285,-312
2014,4,CO,264,196,68
2014,4,CT,491,486,5
2014,4,DC,52,20,32
2014,4,DE,239,243,-4
2014,4,FL,24736,25937,-1201
2014,4,GA,1013,1023,-10
2014,4,GU,1,1,0
2014,4,HI,1323,1330,-7
2014,4,IA,114,112,2
2014,4,ID,77,78,-1
2014,4,IL,365,352,13
2014,4,IN,230,218,12
2014,4,KS,128,120,8
2014,4,KY,172,189,-17
2014,4,LA,5404,5518,-114
2014,4,MA,533,548,-15
2014,4,MD,720,784,-64
2014,4,ME,95,95,0
2014,4,MI,166,158,8
2014,4,MN,84,84,0
2014,4,MO,205,193,12
2014,4,MS,833,865,-32
2014,4,MT,56,53,3
2014,4,NC,1499,1543,-44
2014,4,ND,103,93,10
2014,4,NE,95,90,5
2014,4,NH,74,76,-2
2014,4,NJ,2750,2845,-95
2014,4,NM,131,133,-2
2014,4,NV,201,206,-5
2014,4,NY,2059,2170,-111
2014,4,OH,312,318,-6
2014,4,OK,139,132,7
2014,4,OR,455,506,-51
2014,4,PA,769,794,-25
2014,4,PR,374,527,-153
2014,4,RI,131,132,-1
2014,4,SC,2213,2236,-23
2014,4,SD,55,60,-5
2014,4,TN,289,297,-8
2014,4,TX,5680,5955,-275
2014,4,UT,36,38,-2
2014,4,VA,1172,1169,3
2014,4,VI,9,10,-1
2014,4,VT,50,46,4
2014,4,WA,501,528,-27
2014,4,WI,112,116,-4
2014,4,WV,142,150,-8
2014,4,WY,22,23,-1
2014,5,AK,20,17,3
2014,5,AL,419,473,-54
2014,5,AR,217,219,-2
2014,5,AZ,296,275,21
2014,5,CA,3969,4243,-274
2014,5,CO,237,201,36
2014,5,CT,272,268,4
2014,5,DC,31,18,13
2014,5,DE,234,234,0
2014,5,FL,18669,19463,-794
2014,5,GA,964,997,-33
2014,5,HI,1153,1156,-3
2014,5,IA,132,132,0
2014,5,ID,94,98,-4
2014,5,IL,397,384,13
2014,5,IN,220,210,10
2014,5,KS,116,124,-8
2014,5,KY,204,223,-19
2014,5,LA,4664,4850,-186
2014,5,MA,540,550,-10
2014,5,MD,557,551,6
2014,5,ME,134,129,5
2014,5,MI,175,161,14
2014,5,MN,125,121,4
2014,5,MO,163,180,-17
2014,5,MS,893,939,-46
2014,5,MT,62,52,10
2014,5,NC,1349,1402,-53
2014,5,ND,131,125,6
2014,5,NE,76,81,-5
2014,5,NH,74,75,-1
2014,5,NJ,2229,2224,5
2014,5,NM,108,107,1
2014,5,NV,168,186,-18
2014,5,NY,2709,2852,-143
2014,5,OH,402,392,10
2014,5,OK,132,143,-11
2014,5,OR,548,578,-30
2014,5,PA,1027,1040,-13
2014,5,PR,41,64,-23
2014,5,RI,131,122,9
2014,5,SC,1566,1548,18
2014,5,SD,42,43,-1
2014,5,TN,289,297,-8
2014,5,TX,7927,8190,-263
2014,5,UT,40,40,0
2014,5,VA,993,1007,-14
2014,5,VI,12,14,-2
2014,5,VT,52,50,2
2014,5,WA,505,534,-29
2014,5,WI,126,119,7
2014,5,WV,205,226,-21
2014,5,WY,18,17,1
2014,6,AK,37,30,7
2014,6,AL,821,846,-25
2014,6,AR,177,182,-5
2014,6,AZ,395,385,10
2014,6,CA,3731,3832,-101
2014,6,CO,256,201,55
2014,6,CT,360,356,4
2014,6,DC,52,28,24
2014,6,DE,260,251,9
2014,6,FL,23481,24093,-612
2014,6,GA,1119,1118,1
2014,6,HI,542,556,-14
2014,6,IA,165,159,6
2014,6,ID,101,105,-4
2014,6,IL,765,720,45
2014,6,IN,306,282,24
2014,6,KS,116,118,-2
2014,6,KY,226,248,-22
2014,6,LA,5574,5734,-160
2014,6,MA,849,534,315
2014,6,MD,690,703,-13
2014,6,ME,84,80,4
2014,6,MI,182,185,-3
2014,6,MN,134,125,9
2014,6,MO,215,263,-48
2014,6,MS,914,938,-24
2014,6,MT,76,67,9
2014,6,NC,1669,1707,-38
2014,6,ND,178,179,-1
2014,6,NE,115,107,8
2014,6,NH,96,99,-3
2014,6,NJ,2484,2451,33
2014,6,NM,120,121,-1
2014,6,NV,226,247,-21
2014,6,NY,2551,2544,7
2014,6,OH,426,421,5
2014,6,OK,161,162,-1
2014,6,OR,397,411,-14
2014,6,PA,887,913,-26
2014,6,PR,67,107,-40
2014,6,RI,161,154,7
2014,6,SC,2731,2697,34
2014,6,SD,53,54,-1
2014,6,TN,347,356,-9
2014,6,TX,6430,6660,-230
2014,6,UN,1,1,0
2014,6,UT,125,135,-10
2014,6,VA,1298,1292,6
2014,6,VI,44,45,-1
2014,6,VT,40,41,-1
2014,6,WA,605,626,-21
2014,6,WI,148,144,4
2014,6,WV,227,229,-2
2014,6,WY,19,20,-1
2014,7,AK,26,25,1
2014,7,AL,773,794,-21
2014,7,AR,188,182,6
2014,7,AZ,288,281,7
2014,7,CA,3160,3308,-148
2014,7,CO,219,194,25
2014,7,CT,322,325,-3
2014,7,DC,31,131,-100
2014,7,DE,237,228,9
2014,7,FL,22898,23435,-537
2014,7,GA,1064,1080,-16
2014,7,HI,1162,1156,6
2014,7,IA,154,160,-6
2014,7,ID,79,83,-4
2014,7,IL,384,355,29
2014,7,IN,260,247,13
2014,7,KS,104,112,-8
2014,7,KY,237,230,7
2014,7,LA,5367,5494,-127
2014,7,MA,380,396,-16
2014,7,MD,556,571,-15
2014,7,ME,87,89,-2
2014,7,MI,223,214,9
2014,7,MN,146,148,-2
2014,7,MO,196,218,-22
2014,7,MS,878,915,-37
2014,7,MT,64,67,-3
2014,7,NC,1554,1514,40
2014,7,ND,216,217,-1
2014,7,NE,113,106,7
2014,7,NH,84,82,2
2014,7,NJ,2147,2252,-105
2014,7,NM,103,108,-5
2014,7,NV,190,204,-14
2014,7,NY,2683,2364,319
2014,7,OH,520,528,-8
2014,7,OK,161,168,-7
2014,7,OR,395,413,-18
2014,7,PA,1040,1072,-32
2014,7,PR,54,89,-35
2014,7,RI,116,119,-3
2014,7,SC,1877,1870,7
2014,7,SD,60,57,3
2014,7,TN,314,317,-3
2014,7,TX,5901,6087,-186
2014,7,UT,71,71,0
2014,7,VA,1180,1204,-24
2014,7,VI,7,8,-1
2014,7,VT,33,32,1
2014,7,WA,463,502,-39
2014,7,WI,128,131,-3
2014,7,WV,208,231,-23
2014,7,WY,28,27,1
2014,8,AK,42,42,0
2014,8,AL,582,607,-25
2014,8,AR,186,198,-12
2014,8,AZ,367,355,12
2014,8,CA,3368,3536,-168
2014,8,CO,287,259,28
2014,8,CT,415,419,-4
2014,8,DC,41,34,7
2014,8,DE,272,272,0
2014,8,FL,32412,33492,-1080
2014,8,GA,1443,1462,-19
2014,8,GU,1,2,-1
2014,8,HI,1607,1599,8
2014,8,IA,248,256,-8
2014,8,ID,111,124,-13
2014,8,IL,487,523,-36
2014,8,IN,347,346,1
2014,8,KS,133,146,-13
2014,8,KY,243,256,-13
2014,8,LA,7690,7931,-241
2014,8,MA,514,547,-33
2014,8,MD,1047,1056,-9
2014,8,ME,111,109,2
2014,8,MI,378,344,34
2014,8,MN,256,248,8
2014,8,MO,265,291,-26
2014,8,MS,1177,1198,-21
2014,8,MT,119,104,15
2014,8,NC,2259,2316,-57
2014,8,ND,418,480,-62
2014,8,NE,120,126,-6
2014,8,NH,105,105,0
2014,8,NJ,3009,3151,-142
2014,8,NM,117,118,-1
2014,8,NV,346,359,-13
2014,8,NY,2906,3019,-113
2014,8,OH,476,474,2
2014,8,OK,194,195,-1
2014,8,OR,438,466,-28
2014,8,PA,1180,1244,-64
2014,8,PR,59,105,-46
2014,8,RI,362,363,-1
2014,8,SC,2712,2693,19
2014,8,SD,85,92,-7
2014,8,TN,489,521,-32
2014,8,TX,9184,9738,-554
2014,8,UT,89,92,-3
2014,8,VA,1728,1763,-35
2014,8,VI,10,11,-1
2014,8,VT,45,46,-1
2014,8,WA,533,567,-34
2014,8,WI,154,142,12
2014,8,WV,231,257,-26
2014,8,WY,33,30,3
2014,9,AK,34,36,-2
2014,9,AL,619,639,-20
2014,9,AR,154,163,-9
2014,9,AZ,270,265,5
2014,9,CA,2692,2851,-159
2014,9,CO,283,246,37
2014,9,CT,452,488,-36
2014,9,DC,44,37,7
2014,9,DE,255,252,3
2014,9,FL,24607,25558,-951
2014,9,GA,1148,1088,60
2014,9,GU,2,3,-1
2014,9,HI,943,949,-6
2014,9,IA,236,241,-5
2014,9,ID,143,149,-6
2014,9,IL,598,540,58
2014,9,IN,270,259,11
2014,9,KS,119,119,0
2014,9,KY,206,251,-45
2014,9,LA,6302,6458,-156
2014,9,MA,512,479,33
2014,9,MD,843,838,5
2014,9,ME,136,137,-1
2014,9,MI,206,190,16
2014,9,MN,292,307,-15
2014,9,MO,224,238,-14
2014,9,MS,1006,1060,-54
2014,9,MT,85,77,8
2014,9,NC,1730,1774,-44
2014,9,ND,482,535,-53
2014,9,NE,121,107,14
2014,9,NH,67,62,5
2014,9,NJ,2138,2693,-555
2014,9,NM,130,124,6
2014,9,NV,272,291,-19
2014,9,NY,2444,2540,-96
2014,9,OH,378,400,-22
2014,9,OK,169,178,-9
2014,9,OR,324,356,-32
2014,9,PA,888,916,-28
2014,9,PR,30,69,-39
2014,9,RI,160,137,23
2014,9,SC,2056,2092,-36
2014,9,SD,68,82,-14
2014,9,TN,461,503,-42
2014,9,TX,6252,6277,-25
2014,9,UT,53,51,2
2014,9,VA,1272,1340,-68
2014,9,VI,8,7,1
2014,9,VT,59,59,0
2014,9,WA,547,537,10
2014,9,WI,177,175,2
2014,9,WV,172,205,-33
2014,9,WY,25,24,1
2014,10,AK,28,28,0
2014,10,AL,524,534,-10
2014,10,AR,159,159,0
2014,10,AZ,259,271,-12
2014,10,CA,2528,2587,-59
2014,10,CO,295,276,19
2014,10,CT,459,486,-27
2014,10,DC,28,21,7
2014,10,DE,248,243,5
2014,10,FL,25424,26018,-594
2014,10,GA,1111,1122,-11
2014,10,HI,605,670,-65
2014,10,IA,284,282,2
2014,10,ID,108,111,-3
2014,10,IL,522,459,63
2014,10,IN,347,304,43
2014,10,KS,136,133,3
2014,10,KY,243,240,3
2014,10,LA,6163,6251,-88
2014,10,MA,517,533,-16
2014,10,MD,620,631,-11
2014,10,ME,112,108,4
2014,10,MI,271,212,59
2014,10,MN,351,374,-23
2014,10,MO,222,249,-27
2014,10,MS,1074,1120,-46
2014,10,MT,105,95,10
2014,10,NC,1766,1802,-36
2014,10,ND,697,840,-143
2014,10,NE,119,108,11
2014,10,NH,137,142,-5
2014,10,NJ,2467,2503,-36
2014,10,NM,114,114,0
2014,10,NV,174,192,-18
2014,10,NY,2800,2853,-53
2014,10,OH,500,500,0
2014,10,OK,201,203,-2
2014,10,OR,343,370,-27
2014,10,PA,966,975,-9
2014,10,PR,49,96,-47
2014,10,RI,139,134,5
2014,10,SC,2984,2951,33
2014,10,SD,81,88,-7
2014,10,TN,443,447,-4
2014,10,TX,6652,6878,-226
2014,10,UT,63,60,3
2014,10,VA,1145,1157,-12
2014,10,VI,15,16,-1
2014,10,VT,51,54,-3
2014,10,WA,491,509,-18
2014,10,WI,186,171,15
2014,10,WV,198,201,-3
2014,10,WY,34,30,4
2014,11,AK,31,33,-2
2014,11,AL,572,582,-10
2014,11,AR,160,162,-2
2014,11,AZ,254,254,0
2014,11,CA,2274,2369,-95
2014,11,CO,298,247,51
2014,11,CT,505,523,-18
2014,11,DC,31,24,7
2014,11,DE,223,209,14
2014,11,FL,22148,22931,-783
2014,11,GA,1036,1068,-32
2014,11,HI,933,932,1
2014,11,IA,272,261,11
2014,11,ID,96,94,2
2014,11,IL,682,479,203
2014,11,IN,396,318,78
2014,11,KS,117,119,-2
2014,11,KY,241,252,-11
2014,11,LA,6157,6234,-77
2014,11,MA,681,680,1
2014,11,MD,1161,1126,35
2014,11,ME,106,107,-1
2014,11,MI,470,239,231
2014,11,MN,416,421,-5
2014,11,MO,276,264,12
2014,11,MS,1161,1203,-42
2014,11,MT,105,103,2
2014,11,NC,1553,1596,-43
2014,11,ND,642,752,-110
2014,11,NE,128,119,9
2014,11,NH,84,81,3
2014,11,NJ,2233,2272,-39
2014,11,NM,123,126,-3
2014,11,NV,158,156,2
2014,11,NY,2257,2273,-16
2014,11,OH,466,444,22
2014,11,OK,179,163,16
2014,11,OR,353,339,14
2014,11,PA,990,944,46
2014,11,PR,39,74,-35
2014,11,RI,102,108,-6
2014,11,SC,2328,2348,-20
2014,11,SD,116,124,-8
2014,11,TN,479,513,-34
2014,11,TX,6471,6889,-418
2014,11,UT,60,69,-9
2014,11,VA,1278,1286,-8
2014,11,VI,32,28,4
2014,11,VT,47,53,-6
2014,11,WA,426,421,5
2014,11,WI,198,166,32
2014,11,WV,206,224,-18
2014,11,WY,31,26,5
2014,12,AK,28,25,3
2014,12,AL,863,875,-12
2014,12,AR,223,222,1
2014,12,AZ,305,310,-5
2014,12,CA,2994,3065,-71
2014,12,CO,338,283,55
2014,12,CT,507,510,-3
2014,12,DC,33,29,4
2014,12,DE,310,322,-12
2014,12,FL,26996,27853,-857
2014,12,GA,1300,1336,-36
2014,12,HI,253,261,-8
2014,12,IA,430,407,23
2014,12,ID,143,143,0
2014,12,IL,1042,626,416
2014,12,IN,318,281,37
2014,12,KS,149,147,2
2014,12,KY,273,267,6
2014,12,LA,7194,7360,-166
2014,12,MA,530,557,-27
2014,12,MD,957,937,20
2014,12,ME,107,111,-4
2014,12,MI,306,247,59
2014,12,MN,587,538,49
2014,12,MO,281,311,-30
2014,12,MS,1306,1420,-114
2014,12,MT,134,104,30
2014,12,NC,1919,1934,-15
2014,12,ND,703,856,-153
2014,12,NE,122,110,12
2014,12,NH,94,100,-6
2014,12,NJ,2208,2299,-91
2014,12,NM,121,133,-12
2014,12,NV,196,210,-14
2014,12,NY,2430,2399,31
2014,12,OH,439,420,19
2014,12,OK,214,212,2
2014,12,OR,272,284,-12
2014,12,PA,1224,1230,-6
2014,12,PR,93,224,-131
2014,12,RI,169,165,4
2014,12,SC,2494,2516,-22
2014,12,SD,165,184,-19
2014,12,TN,439,473,-34
2014,12,TX,7981,8156,-175
2014,12,UT,77,81,-4
2014,12,VA,2157,2150,7
2014,12,VI,6,8,-2
2014,12,VT,52,55,-3
2014,12,WA,458,465,-7
2014,12,WI,277,217,60
2014,12,WV,233,257,-24
2014,12,WY,26,24,2
2014,13,AK,49,53,-4
2014,13,AL,821,803,18
2014,13,AR,244,241,3
2014,13,AZ,309,300,9
2014,13,CA,2937,3114,-177
2014,13,CO,351,302,49
2014,13,CT,427,433,-6
2014,13,DC,23,23,0
2014,13,DE,291,289,2
2014,13,FL,36210,37341,-1131
2014,13,GA,1393,1422,-29
2014,13,HI,1156,1155,1
2014,13,IA,371,379,-8
2014,13,ID,107,106,1
2014,13,IL,713,663,50
2014,13,IN,359,356,3
2014,13,KS,170,177,-7
2014,13,KY,250,263,-13
2014,13,LA,7711,8007,-296
2014,13,MA,576,515,61
2014,13,MD,994,987,7
2014,13,ME,163,161,2
2014,13,MI,348,244,104
2014,13,MN,701,567,134
2014,13,MO,358,383,-25
2014,13,MS,1201,1247,-46
2014,13,MT,216,124,92
2014,13,NC,2271,2318,-47
2014,13,ND,599,629,-30
2014,13,NE,172,117,55
2014,13,NH,110,122,-12
2014,13,NJ,2736,2820,-84
2014,13,NM,180,175,5
2014,13,NV,142,132,10
2014,13,NY,3162,2729,433
2014,13,OH,512,525,-13
2014,13,OK,203,203,0
2014,13,OR,421,460,-39
2014,13,PA,962,977,-15
2014,13,PR,58,176,-118
2014,13,RI,186,194,-8
2014,13,SC,3416,3453,-37
2014,13,SD,122,128,-6
2014,13,TN,738,743,-5
2014,13,TX,9948,10420,-472
2014,13,UN,2,2,0
2014,13,UT,95,97,-2
2014,13,VA,1297,1329,-32
2014,13,VI,2,2,0
2014,13,VT,48,50,-2
2014,13,WA,627,625,2
2014,13,WI,314,254,60
2014,13,WV,261,267,-6
2014,13,WY,48,43,5
2014,14,AK,38,45,-7
2014,14,AL,652,644,8
2014,14,AR,196,196,0
2014,14,AZ,277,249,28
2014,14,CA,2175,2287,-112
2014,14,CO,373,272,101
2014,14,CT,415,438,-23
2014,14,DC,17,14,3
2014,14,DE,262,263,-1
2014,14,FL,26305,27065,-760
2014,14,GA,1129,1080,49
2014,14,GU,1,1,0
2014,14,HI,328,338,-10
2014,14,IA,375,364,11
2014,14,ID,93,89,4
2014,14,IL,600,582,18
2014,14,IN,309,320,-11
2014,14,KS,162,169,-7
2014,14,KY,259,259,0
2014,14,LA,7055,7201,-146
2014,14,MA,473,473,0
2014,14,MD,719,714,5
2014,14,ME,144,146,-2
2014,14,MI,263,220,43
2014,14,MN,569,528,41
2014,14,MO,320,340,-20
2014,14,MS,1266,1304,-38
2014,14,MT,253,132,121
2014,14,NC,1575,1583,-8
2014,14,ND,550,631,-81
2014,14,NE,123,93,30
2014,14,NH,118,121,-3
2014,14,NJ,2246,2267,-21
2014,14,NM,114,118,-4
2014,14,NV,120,129,-9
2014,14,NY,2302,2364,-62
2014,14,OH,490,495,-5
2014,14,OK,192,198,-6
2014,14,OR,285,292,-7
2014,14,PA,844,878,-34
2014,14,PR,121,163,-42
2014,14,RI,195,195,0
2014,14,SC,2636,2627,9
2014,14,SD,110,101,9
2014,14,TN,420,425,-5
2014,14,TX,7423,7681,-258
2014,14,UT,58,68,-10
2014,14,VA,1176,1214,-38
2014,14,VI,52,70,-18
2014,14,VT,62,61,1
2014,14,WA,395,404,-9
2014,14,WI,344,294,50
2014,14,WV,228,246,-18
2014,14,WY,53,37,16
2014,15,AK,41,49,-8
2014,15,AL,1129,1091,38
2014,15,AR,181,187,-6
2014,15,AZ,281,307,-26
2014,15,CA,2309,2400,-91
2014,15,CO,492,324,168
2014,15,CT,414,429,-15
2014,15,DC,20,21,-1
2014,15,DE,292,292,0
2014,15,FL,32010,32625,-615
2014,15,GA,1219,1289,-70
2014,15,GU,1,1,0
2014,15,HI,670,685,-15
2014,15,IA,291,287,4
2014,15,ID,86,88,-2
2014,15,IL,608,620,-12
2014,15,IN,347,352,-5
2014,15,KS,165,171,-6
2014,15,KY,260,260,0
2014,15,LA,9673,9866,-193
2014,15,MA,569,568,1
2014,15,MD,728,735,-7
2014,15,ME,131,130,1
2014,15,MI,264,238,26
2014,15,MN,295,363,-68
2014,15,MO,359,376,-17
2014,15,MS,1260,1316,-56
2014,15,MT,152,95,57
2014,15,NC,2064,2109,-45
2014,15,ND,334,463,-129
2014,15,NE,143,121,22
2014,15,NH,92,97,-5
2014,15,NJ,2492,2612,-120
2014,15,NM,141,142,-1
2014,15,NV,136,145,-9
2014,15,NY,2259,2324,-65
2014,15,OH,453,469,-16
2014,15,OK,244,248,-4
2014,15,OR,360,362,-2
2014,15,PA,768,782,-14
2014,15,PR,55,113,-58
2014,15,RI,141,144,-3
2014,15,SC,2731,2746,-15
2014,15,SD,95,90,5
2014,15,TN,432,442,-10
2014,15,TX,8436,8649,-213
2014,15,UT,59,66,-7
2014,15,VA,1405,1456,-51
2014,15,VI,18,17,1
2014,15,VT,61,58,3
2014,15,WA,455,467,-12
2014,15,WI,255,260,-5
2014,15,WV,203,222,-19
2014,15,WY,58,47,11
2014,16,AK,49,54,-5
2014,16,AL,697,690,7
2014,16,AR,190,203,-13
2014,16,AZ,255,257,-2
2014,16,CA,2519,2737,-218
2014,16,CO,568,393,175
2014,16,CT,433,442,-9
2014,16,DC,22,19,3
2014,16,DE,389,393,-4
2014,16,FL,30736,31697,-961
2014,16,GA,1201,1240,-39
2014,16,HI,471,472,-1
2014,16,IA,249,245,4
2014,16,ID,92,101,-9
2014,16,IL,676,717,-41
2014,16,IN,320,332,-12
2014,16,KS,199,199,0
2014,16,KY,277,287,-10
2014,16,LA,8870,9084,-214
2014,16,MA,572,582,-10
2014,16,MD,774,787,-13
2014,16,ME,154,137,17
2014,16,MI,232,217,15
2014,16,MN,242,300,-58
2014,16,MO,415,440,-25
2014,16,MS,1372,1437,-65
2014,16,MT,183,126,57
2014,16,NC,2046,2135,-89
2014,16,ND,297,523,-226
2014,16,NE,136,153,-17
2014,16,NH,87,88,-1
2014,16,NJ,2494,2605,-111
2014,16,NM,169,177,-8
2014,16,NV,205,206,-1
2014,16,NY,3204,3219,-15
2014,16,OH,463,483,-20
2014,16,OK,208,226,-18
2014,16,OR,311,332,-21
2014,16,PA,797,831,-34
2014,16,PR,80,117,-37
2014,16,RI,215,223,-8
2014,16,SC,2539,2560,-21
2014,16,SD,57,59,-2
2014,16,TN,408,438,-30
2014,16,TX,9218,9669,-451
2014,16,UT,68,71,-3
2014,16,VA,1431,1457,-26
2014,16,VI,7,8,-1
2014,16,VT,45,42,3
2014,16,WA,458,460,-2
2014,16,WI,249,279,-30
2014,16,WV,187,206,-19
2014,16,WY,58,51,7
2014,17,AK,49,43,6
2014,17,AL,2100,2090,10
2014,17,AR,198,203,-5
2014,17,AZ,397,395,2
2014,17,CA,2773,2848,-75
2014,17,CO,542,391,151
2014,17,CT,468,473,-5
2014,17,DC,35,27,8
2014,17,DE,319,326,-7
2014,17,FL,45433,46419,-986
2014,17,GA,1720,1747,-27
2014,17,GU,1,1,0
2014,17,HI,2088,2067,21
2014,17,IA,198,209,-11
2014,17,ID,365,376,-11
2014,17,IL,684,687,-3
2014,17,IN,320,341,-21
2014,17,KS,188,187,1
2014,17,KY,273,272,1
2014,17,LA,10849,11110,-261
2014,17,MA,703,694,9
2014,17,MD,924,916,8
2014,17,ME,153,150,3
2014,17,MI,261,251,10
2014,17,MN,180,177,3
2014,17,MO,359,361,-2
2014,17,MS,1589,1603,-14
2014,17,MT,165,102,63
2014,17,NC,2805,2849,-44
2014,17,ND,152,214,-62
2014,17,NE,135,146,-11
2014,17,NH,117,113,4
2014,17,NJ,3207,3298,-91
2014,17,NM,140,142,-2
2014,17,NV,140,157,-17
2014,17,NY,2670,2711,-41
2014,17,OH,434,443,-9
2014,17,OK,244,249,-5
2014,17,OR,649,647,2
2014,17,PA,915,944,-29
2014,17,PR,80,150,-70
2014,17,RI,255,259,-4
2014,17,SC,4138,4140,-2
2014,17,SD,61,65,-4
2014,17,TN,444,452,-8
2014,17,TX,11768,12097,-329
2014,17,UT,70,74,-4
2014,17,VA,1719,1762,-43
2014,17,VI,14,15,-1
2014,17,VT,57,52,5
2014,17,WA,514,612,-98
2014,17,WI,190,184,6
2014,17,WV,193,205,-12
2014,17,WY,50,37,13
2014,18,AK,42,37,5
2014,18,AL,662,632,30
2014,18,AR,207,218,-11
2014,18,AZ,268,275,-7
2014,18,CA,2138,2221,-83
2014,18,CO,504,364,140
2014,18,CT,371,361,10
2014,18,DC,29,18,11
2014,18,DE,315,319,-4
2014,18,FL,29887,30835,-948
2014,18,GA,1185,1174,11
2014,18,HI,880,881,-1
2014,18,IA,148,150,-2
2014,18,ID,68,74,-6
2014,18,IL,447,436,11
2014,18,IN,260,244,16
2014,18,KS,133,126,7
2014,18,KY,240,246,-6
2014,18,LA,8016,8262,-246
2014,18,MA,631,563,68
2014,18,MD,687,674,13
2014,18,ME,85,78,7
2014,18,MI,226,218,8
2014,18,MN,139,139,0
2014,18,MO,257,252,5
2014,18,MS,1298,1350,-52
2014,18,MT,149,95,54
2014,18,NC,1877,1775,102
2014,18,ND,97,140,-43
2014,18,NE,102,110,-8
2014,18,NH,72,67,5
2014,18,NJ,2256,2292,-36
2014,18,NM,120,115,5
2014,18,NV,119,120,-1
2014,18,NY,3347,2332,1015
2014,18,OH,359,368,-9
2014,18,OK,220,214,6
2014,18,OR,294,311,-17
2014,18,PA,769,774,-5
2014,18,PR,67,115,-48
2014,18,RI,150,144,6
2014,18,SC,2448,2456,-8
2014,18,SD,57,52,5
2014,18,TN,311,319,-8
2014,18,TX,9304,9607,-303
2014,18,UN,1,0,1
2014,18,UT,146,153,-7
2014,18,VA,1274,1308,-34
2014,18,VI,16,8,8
2014,18,VT,45,42,3
2014,18,WA,387,399,-12
2014,18,WI,159,171,-12
2014,18,WV,161,170,-9
2014,18,WY,52,45,7
2014,19,AK,49,45,4
2014,19,AL,872,857,15
2014,19,AR,167,182,-15
2014,19,AZ,272,243,29
2014,19,CA,2048,2129,-81
2014,19,CO,488,395,93
2014,19,CT,424,413,11
2014,19,DC,34,32,2
2014,19,DE,288,303,-15
2014,19,FL,30142,31309,-1167
2014,19,GA,1372,1455,-83
2014,19,HI,764,753,11
2014,19,IA,156,173,-17
2014,19,ID,95,98,-3
2014,19,IL,563,591,-28
2014,19,IN,241,242,-1
2014,19,KS,134,146,-12
2014,19,KY,246,244,2
2014,19,LA,8859,9148,-289
2014,19,MA,530,447,83
2014,19,MD,675,664,11
2014,19,ME,95,88,7
2014,19,MI,235,230,5
2014,19,MN,147,144,3
2014,19,MO,271,267,4
2014,19,MS,1382,1407,-25
2014,19,MT,141,99,42
2014,19,NC,2203,2222,-19
2014,19,ND,129,214,-85
2014,19,NE,87,80,7
2014,19,NH,123,120,3
2014,19,NJ,2558,2590,-32
2014,19,NM,129,133,-4
2014,19,NV,137,153,-16
2014,19,NY,3018,3044,-26
2014,19,OH,392,400,-8
2014,19,OK,214,213,1
2014,19,OR,285,294,-9
2014,19,PA,753,772,-19
2014,19,PR,61,162,-101
2014,19,RI,178,186,-8
2014,19,SC,2996,2977,19
2014,19,SD,67,68,-1
2014,19,TN,343,348,-5
2014,19,TX,9882,10062,-180
2014,19,UT,66,67,-1
2014,19,VA,1602,1629,-27
2014,19,VI,7,8,-1
2014,19,VT,36,34,2
2014,19,WA,333,349,-16
2014,19,WI,170,174,-4
2014,19,WV,189,208,-19
2014,19,WY,48,45,3
2014,20,AK,31,29,2
2014,20,AL,916,897,19
2014,20,AR,175,186,-11
2014,20,AZ,303,281,22
2014,20,CA,2083,2162,-79
2014,20,CO,551,430,121
2014,20,CT,491,470,21
2014,20,DC,27,24,3
2014,20,DE,298,341,-43
2014,20,FL,31717,32825,-1108
2014,20,GA,1360,1415,-55
2014,20,GU,3,3,0
2014,20,HI,955,959,-4
2014,20,IA,226,260,-34
2014,20,ID,88,99,-11
2014,20,IL,667,798,-131
2014,20,IN,288,315,-27
2014,20,KS,138,140,-2
2014,20,KY,235,249,-14
2014,20,LA,9148,9525,-377
2014,20,MA,575,496,79
2014,20,MD,840,824,16
2014,20,ME,84,79,5
2014,20,MI,226,237,-11
2014,20,MN,122,134,-12
2014,20,MO,284,310,-26
2014,20,MS,1568,1662,-94
2014,20,MT,124,96,28
2014,20,NC,2211,2270,-59
2014,20,ND,91,124,-33
2014,20,NE,97,122,-25
2014,20,NH,91,87,4
2014,20,NJ,2626,2708,-82
2014,20,NM,147,144,3
2014,20,NV,136,135,1
2014,20,NY,2581,2646,-65
2014,20,OH,345,367,-22
2014,20,OK,229,237,-8
2014,20,OR,293,364,-71
2014,20,PA,891,906,-15
2014,20,PR,61,107,-46
2014,20,RI,169,168,1
2014,20,SC,3341,3358,-17
2014,20,SD,88,91,-3
2014,20,TN,334,384,-50
2014,20,TX,10768,11402,-634
2014,20,UN,1,1,0
2014,20,UT,64,70,-6
2014,20,VA,1427,1490,-63
2014,20,VI,5,5,0
2014,20,VT,40,42,-2
2014,20,WA,362,372,-10
2014,20,WI,188,240,-52
2014,20,WV,164,177,-13
2014,20,WY,50,45,5
2014,21,AK,30,28,2
2014,21,AL,1132,1060,72
2014,21,AR,242,269,-27
2014,21,AZ,314,296,18
2014,21,CA,2124,2209,-85
2014,21,CO,447,347,100
2014,21,CT,492,483,9
2014,21,DC,30,18,12
2014,21,DE,487,344,143
2014,21,FL,38628,39488,-860
2014,21,GA,1622,1661,-39
2014,21,GU,1,1,0
2014,21,HI,828,826,2
2014,21,IA,207,209,-2
2014,21,ID,70,79,-9
2014,21,IL,580,629,-49
2014,21,IN,350,365,-15
2014,21,KS,142,152,-10
2014,21,KY,265,231,34
2014,21,LA,11783,12122,-339
2014,21,MA,1047,918,129
2014,21,MD,905,895,10
2014,21,ME,122,120,2
2014,21,MI,185,220,-35
2014,21,MN,147,132,15
2014,21,MO,301,314,-13
2014,21,MS,1896,2010,-114
2014,21,MT,121,112,9
2014,21,NC,2446,2471,-25
2014,21,ND,134,152,-18
2014,21,NE,131,136,-5
2014,21,NH,98,100,-2
2014,21,NJ,2874,2914,-40
2014,21,NM,117,119,-2
2014,21,NV,119,129,-10
2014,21,NY,3138,3061,77
2014,21,OH,449,440,9
2014,21,OK,228,235,-7
2014,21,OR,300,296,4
2014,21,PA,861,888,-27
2014,21,PR,77,124,-47
2014,21,RI,222,220,2
2014,21,SC,4266,4272,-6
2014,21,SD,67,77,-10
2014,21,TN,573,611,-38
2014,21,TX,13874,14221,-347
2014,21,UN,1,1,0
2014,21,UT,85,89,-4
2014,21,VA,1864,1893,-29
2014,21,VI,8,10,-2
2014,21,VT,28,29,-1
2014,21,WA,464,476,-12
2014,21,WI,157,165,-8
2014,21,WV,169,184,-15
2014,21,WY,41,42,-1
2014,22,AK,43,42,1
2014,22,AL,1222,1138,84
2014,22,AR,373,393,-20
2014,22,AZ,313,293,20
2014,22,CA,2141,2142,-1
2014,22,CO,400,325,75
2014,22,CT,448,442,6
2014,22,DC,30,29,1
2014,22,DE,407,398,9
2014,22,FL,40231,40025,206
2014,22,GA,1764,1819,-55
2014,22,GU,2,2,0
2014,22,HI,709,703,6
2014,22,IA,197,210,-13
2014,22,ID,76,78,-2
2014,22,IL,660,669,-9
2014,22,IN,277,286,-9
2014,22,KS,153,156,-3
2014,22,KY,308,303,5
2014,22,LA,11004,11364,-360
2014,22,MA,830,568,262
2014,22,MD,855,830,25
2014,22,ME,86,86,0
2014,22,MI,213,221,-8
2014,22,MN,120,128,-8
2014,22,MO,312,327,-15
2014,22,MS,1878,1991,-113
2014,22,MT,115,123,-8
2014,22,NC,2563,2581,-18
2014,22,ND,114,108,6
2014,22,NE,106,112,-6
2014,22,NH,88,88,0
2014,22,NJ,3060,3135,-75
2014,22,NM,124,136,-12
2014,22,NV,131,134,-3
2014,22,NY,2828,2810,18
2014,22,OH,405,419,-14
2014,22,OK,286,280,6
2014,22,OR,436,388,48
2014,22,PA,765,775,-10
2014,22,PR,68,141,-73
2014,22,RI,190,184,6
2014,22,SC,3637,3783,-146
2014,22,SD,151,159,-8
2014,22,TN,930,1022,-92
2014,22,TX,13811,14375,-564
2014,22,UT,74,81,-7
2014,22,VA,2183,2203,-20
2014,22,VI,6,7,-1
2014,22,VT,46,48,-2
2014,22,WA,408,414,-6
2014,22,WI,163,159,4
2014,22,WV,196,196,0
2014,22,WY,64,71,-7
2014,23,AK,36,35,1
2014,23,AL,932,868,64
2014,23,AR,242,259,-17
2014,23,AZ,316,309,7
2014,23,CA,2112,2142,-30
2014,23,CO,453,377,76
2014,23,CT,425,430,-5
2014,23,DC,269,264,5
2014,23,DE,285,286,-1
2014,23,FL,33559,33714,-155
2014,23,GA,1453,1502,-49
2014,23,HI,585,589,-4
2014,23,IA,154,146,8
2014,23,ID,66,71,-5
2014,23,IL,693,628,65
2014,23,IN,295,286,9
2014,23,KS,157,166,-9
2014,23,KY,287,285,2
2014,23,LA,11208,11660,-452
2014,23,MA,723,699,24
2014,23,MD,1084,1045,39
2014,23,ME,96,90,6
2014,23,MI,186,195,-9
2014,23,MN,124,129,-5
2014,23,MO,282,297,-15
2014,23,MS,1428,1504,-76
2014,23,MT,82,96,-14
2014,23,NC,2301,2315,-14
2014,23,ND,87,95,-8
2014,23,NE,111,108,3
2014,23,NH,94,95,-1
2014,23,NJ,2420,2534,-114
2014,23,NM,114,122,-8
2014,23,NV,133,131,2
2014,23,NY,2705,2696,9
2014,23,OH,422,364,58
2014,23,OK,242,257,-15
2014,23,OR,287,283,4
2014,23,PA,762,748,14
2014,23,PR,59,112,-53
2014,23,RI,180,184,-4
2014,23,SC,3346,3390,-44
2014,23,SD,55,62,-7
2014,23,TN,708,759,-51
2014,23,TX,14584,15114,-530
2014,23,UT,54,58,-4
2014,23,VA,1849,1856,-7
2014,23,VI,19,19,0
2014,23,VT,46,43,3
2014,23,WA,356,376,-20
2014,23,WI,144,150,-6
2014,23,WV,155,168,-13
2014,23,WY,40,38,2
2014,24,AK,30,28,2
2014,24,AL,896,863,33
2014,24,AR,215,238,-23
2014,24,AZ,323,317,6
2014,24,CA,2104,2122,-18
2014,24,CO,615,522,93
2014,24,CT,512,529,-17
2014,24,DC,38,31,7
2014,24,DE,341,343,-2
2014,24,FL,40047,41204,-1157
2014,24,GA,1783,1836,-53
2014,24,GU,1,2,-1
2014,24,HI,1046,1038,8
2014,24,IA,158,164,-6
2014,24,ID,71,74,-3
2014,24,IL,540,541,-1
2014,24,IN,266,261,5
2014,24,KS,180,195,-15
2014,24,KY,259,264,-5
2014,24,LA,11313,11651,-338
2014,24,MA,773,746,27
2014,24,MD,988,973,15
2014,24,ME,96,82,14
2014,24,MI,229,218,11
2014,24,MN,139,137,2
2014,24,MO,248,261,-13
2014,24,MS,1635,1713,-78
2014,24,MT,109,113,-4
2014,24,NC,2910,3003,-93
2014,24,ND,96,109,-13
2014,24,NE,103,110,-7
2014,24,NH,88,89,-1
2014,24,NJ,2599,2677,-78
2014,24,NM,129,137,-8
2014,24,NV,112,115,-3
2014,24,NY,3334,3002,332
2014,24,OH,461,386,75
2014,24,OK,242,256,-14
2014,24,OR,288,278,10
2014,24,PA,839,868,-29
2014,24,PR,58,90,-32
2014,24,RI,219,224,-5
2014,24,SC,4001,4041,-40
2014,24,SD,82,83,-1
2014,24,TN,630,676,-46
2014,24,TX,16212,17075,-863
2014,24,UT,54,51,3
2014,24,VA,2064,2113,-49
2014,24,VI,102,160,-58
2014,24,VT,42,51,-9
2014,24,WA,365,398,-33
2014,24,WI,209,214,-5
2014,24,WV,191,209,-18
2014,24,WY,40,40,0
2014,25,AK,29,25,4
2014,25,AL,924,928,-4
2014,25,AR,192,206,-14
2014,25,AZ,413,405,8
2014,25,CA,2064,2121,-57
2014,25,CO,369,296,73
2014,25,CT,444,455,-11
2014,25,DC,42,38,4
2014,25,DE,354,371,-17
2014,25,FL,39588,41050,-1462
2014,25,GA,1759,1847,-88
2014,25,GU,2,2,0
2014,25,HI,1423,1420,3
2014,25,IA,165,175,-10
2014,25,ID,76,81,-5
2014,25,IL,539,559,-20
2014,25,IN,259,258,1
2014,25,KS,177,190,-13
2014,25,KY,183,185,-2
2014,25,LA,11605,11889,-284
2014,25,MA,884,756,128
2014,25,MD,1072,1072,0
2014,25,ME,122,131,-9
2014,25,MI,217,223,-6
2014,25,MN,110,124,-14
2014,25,MO,260,274,-14
2014,25,MS,1588,1676,-88
2014,25,MT,184,190,-6
2014,25,NC,2798,2892,-94
2014,25,ND,275,318,-43
2014,25,NE,132,131,1
2014,25,NH,79,82,-3
2014,25,NJ,3351,3466,-115
2014,25,NM,134,139,-5
2014,25,NV,133,136,-3
2014,25,NY,3419,3026,393
2014,25,OH,461,412,49
2014,25,OK,182,210,-28
2014,25,OR,257,264,-7
2014,25,PA,793,825,-32
2014,25,PR,70,108,-38
2014,25,RI,222,220,2
2014,25,SC,3887,3962,-75
2014,25,SD,105,108,-3
2014,25,TN,638,690,-52
2014,25,TX,18423,19165,-742
2014,25,UT,54,58,-4
2014,25,VA,2412,2514,-102
2014,25,VI,10,12,-2
2014,25,VT,46,50,-4
2014,25,WA,331,340,-9
2014,25,WI,149,152,-3
2014,25,WV,152,162,-10
2014,25,WY,31,30,1
2014,26,AK,35,34,1
2014,26,AL,1163,1120,43
2014,26,AR,170,182,-12
2014,26,AZ,445,405,40
2014,26,CA,2087,2120,-33
2014,26,CO,418,332,86
2014,26,CT,620,621,-1
2014,26,DC,39,35,4
2014,26,DE,457,463,-6
2014,26,FL,48125,48997,-872
2014,26,GA,2361,2525,-164
2014,26,GU,2,2,0
2014,26,HI,804,790,14
2014,26,IA,413,469,-56
2014,26,ID,69,69,0
2014,26,IL,523,526,-3
2014,26,IN,290,269,21
2014,26,KS,195,196,-1
2014,26,KY,225,232,-7
2014,26,LA,14073,14300,-227
2014,26,MA,785,710,75
2014,26,MD,1854,1939,-85
2014,26,ME,106,117,-11
2014,26,MI,192,198,-6
2014,26,MN,151,161,-10
2014,26,MO,313,349,-36
2014,26,MS,1923,1983,-60
2014,26,MT,83,78,5
2014,26,NC,3199,3289,-90
2014,26,ND,287,324,-37
2014,26,NE,197,207,-10
2014,26,NH,113,114,-1
2014,26,NJ,3465,3415,50
2014,26,NM,134,124,10
2014,26,NV,121,111,10
2014,26,NY,3526,3621,-95
2014,26,OH,466,425,41
2014,26,OK,280,304,-24
2014,26,OR,330,339,-9
2014,26,PA,887,917,-30
2014,26,PR,71,123,-52
2014,26,RI,281,280,1
2014,26,SC,5133,5237,-104
2014,26,SD,169,170,-1
2014,26,TN,451,466,-15
2014,26,TX,23563,25060,-1497
2014,26,UT,69,73,-4
2014,26,VA,2649,2784,-135
2014,26,VI,9,12,-3
2014,26,VT,62,65,-3
2014,26,WA,440,442,-2
2014,26,WI,149,161,-12
2014,26,WV,191,208,-17
2014,26,WY,36,38,-2
2014,27,AK,31,29,2
2014,27,AL,973,979,-6
2014,27,AR,195,193,2
2014,27,AZ,413,426,-13
2014,27,CA,1964,2043,-79
2014,27,CO,399,352,47
2014,27,CT,469,478,-9
2014,27,DC,32,28,4
2014,27,DE,344,351,-7
2014,27,FL,38086,39348,-1262
2014,27,GA,1950,2094,-144
2014,27,HI,383,384,-1
2014,27,IA,269,292,-23
2014,27,ID,57,60,-3
2014,27,IL,508,531,-23
2014,27,IN,320,336,-16
2014,27,KS,163,161,2
2014,27,KY,281,275,6
2014,27,LA,11333,11610,-277
2014,27,MA,775,735,40
2014,27,MD,967,1009,-42
2014,27,ME,124,120,4
2014,27,MI,260,273,-13
2014,27,MN,135,130,5
2014,27,MO,315,315,0
2014,27,MS,1431,1502,-71
2014,27,MT,78,79,-1
2014,27,NC,2695,2775,-80
2014,27,ND,94,128,-34
2014,27,NE,124,135,-11
2014,27,NH,118,124,-6
2014,27,NJ,3687,3810,-123
2014,27,NM,121,127,-6
2014,27,NV,113,128,-15
2014,27,NY,3079,3120,-41
2014,27,OH,414,404,10
2014,27,OK,239,242,-3
2014,27,OR,366,373,-7
2014,27,PA,720,740,-20
2014,27,PR,65,126,-61
2014,27,RI,251,244,7
2014,27,SC,4025,4065,-40
2014,27,SD,79,80,-1
2014,27,TN,493,504,-11
2014,27,TX,21183,22610,-1427
2014,27,UT,55,56,-1
2014,27,VA,2332,2421,-89
2014,27,VI,14,13,1
2014,27,VT,32,39,-7
2014,27,WA,330,333,-3
2014,27,WI,157,164,-7
2014,27,WV,156,174,-18
2014,27,WY,33,38,-5
2014,28,AK,42,38,4
2014,28,AL,999,867,132
2014,28,AR,205,203,2
2014,28,AZ,461,466,-5
2014,28,CA,2347,2406,-59
2014,28,CO,307,296,11
2014,28,CT,471,490,-19
2014,28,DC,37,34,3
2014,28,DE,351,363,-12
2014,28,FL,37358,38577,-1219
2014,28,GA,2004,2051,-47
2014,28,GU,1,1,0
2014,28,HI,1045,1039,6
2014,28,IA,263,262,1
2014,28,ID,53,59,-6
2014,28,IL,515,554,-39
2014,28,IN,380,400,-20
2014,28,KS,189,192,-3
2014,28,KY,244,270,-26
2014,28,LA,11226,11527,-301
2014,28,MA,863,781,82
2014,28,MD,984,979,5
2014,28,ME,114,119,-5
2014,28,MI,242,250,-8
2014,28,MN,167,138,29
2014,28,MO,284,304,-20
2014,28,MS,1383,1439,-56
2014,28,MT,106,125,-19
2014,28,NC,3223,3330,-107
2014,28,ND,77,90,-13
2014,28,NE,118,129,-11
2014,28,NH,169,179,-10
2014,28,NJ,3462,3545,-83
2014,28,NM,143,154,-11
2014,28,NV,134,133,1
2014,28,NY,3172,3257,-85
2014,28,OH,452,414,38
2014,28,OK,255,268,-13
2014,28,OR,292,300,-8
2014,28,PA,836,868,-32
2014,28,PR,109,121,-12
2014,28,RI,234,238,-4
2014,28,SC,3938,4028,-90
2014,28,SD,78,62,16
2014,28,TN,462,492,-30
2014,28,TX,21863,23144,-1281
2014,28,UT,43,50,-7
2014,28,VA,2395,2499,-104
2014,28,VI,2,4,-2
2014,28,VT,61,65,-4
2014,28,WA,367,367,0
2014,28,WI,214,212,2
2014,28,WV,188,218,-30
2014,28,WY,32,34,-2
2014,29,AK,36,37,-1
2014,29,AL,966,961,5
2014,29,AR,195,194,1
2014,29,AZ,431,424,7
2014,29,CA,2168,2008,160
2014,29,CO,297,272,25
2014,29,CT,562,519,43
2014,29,DC,27,25,2
2014,29,DE,361,369,-8
2014,29,FL,37560,38578,-1018
2014,29,GA,1933,1992,-59
2014,29,HI,1255,1258,-3
2014,29,IA,238,241,-3
2014,29,ID,55,60,-5
2014,29,IL,659,695,-36
2014,29,IN,385,395,-10
2014,29,KS,182,192,-10
2014,29,KY,241,264,-23
2014,29,LA,10255,10521,-266
2014,29,MA,898,879,19
2014,29,MD,1282,1292,-10
2014,29,ME,121,127,-6
2014,29,MI,220,228,-8
2014,29,MN,191,156,35
2014,29,MO,275,272,3
2014,29,MS,1288,1378,-90
2014,29,MT,90,99,-9
2014,29,NC,2625,2719,-94
2014,29,ND,106,118,-12
2014,29,NE,122,117,5
2014,29,NH,109,115,-6
2014,29,NJ,2633,2646,-13
2014,29,NM,166,178,-12
2014,29,NV,148,142,6
2014,29,NY,3363,3371,-8
2014,29,OH,485,433,52
2014,29,OK,247,257,-10
2014,29,OR,291,301,-10
2014,29,PA,827,854,-27
2014,29,PR,60,97,-37
2014,29,RI,242,251,-9
2014,29,SC,3707,3756,-49
2014,29,SD,74,77,-3
2014,29,TN,443,471,-28
2014,29,TX,19683,20779,-1096
2014,29,UT,56,63,-7
2014,29,VA,2477,2510,-33
2014,29,VI,7,8,-1
2014,29,VT,45,44,1
2014,29,WA,387,405,-18
2014,29,WI,201,203,-2
2014,29,WV,170,187,-17
2014,29,WY,23,26,-3
2014,30,AK,55,51,4
2014,30,AL,1287,1272,15
2014,30,AR,197,199,-2
2014,30,AZ,501,491,10
2014,30,CA,2276,2305,-29
2014,30,CO,392,383,9
2014,30,CT,591,605,-14
2014,30,DC,54,44,10
2014,30,DE,439,439,0
2014,30,FL,42683,43764,-1081
2014,30,GA,2241,2311,-70
2014,30,HI,732,737,-5
2014,30,IA,273,259,14
2014,30,ID,69,68,1
2014,30,IL,680,703,-23
2014,30,IN,372,372,0
2014,30,KS,207,212,-5
2014,30,KY,276,318,-42
2014,30,LA,11880,12054,-174
2014,30,MA,981,960,21
2014,30,MD,1261,1277,-16
2014,30,ME,133,124,9
2014,30,MI,240,253,-13
2014,30,MN,181,169,12
2014,30,MO,390,398,-8
2014,30,MS,1454,1464,-10
2014,30,MT,72,75,-3
2014,30,NC,3245,3289,-44
2014,30,ND,116,123,-7
2014,30,NE,129,130,-1
2014,30,NH,89,99,-10
2014,30,NJ,3683,3781,-98
2014,30,NM,215,223,-8
2014,30,NV,189,192,-3
2014,30,NY,3284,3248,36
2014,30,OH,486,467,19
2014,30,OK,288,313,-25
2014,30,OR,289,306,-17
2014,30,PA,1020,1078,-58
2014,30,PR,103,169,-66
2014,30,RI,332,329,3
2014,30,SC,4419,4472,-53
2014,30,SD,85,80,5
2014,30,TN,542,531,11
2014,30,TX,19682,20718,-1036
2014,30,UT,70,76,-6
2014,30,VA,3212,3294,-82
2014,30,VI,14,17,-3
2014,30,VT,52,51,1
2014,30,WA,427,451,-24
2014,30,WI,196,203,-7
2014,30,WV,186,206,-20
2014,30,WY,34,35,-1
2014,31,AK,40,31,9
2014,31,AL,726,734,-8
2014,31,AR,162,161,1
2014,31,AZ,456,443,13
2014,31,CA,1848,1887,-39
2014,31,CO,432,493,-61
2014,31,CT,513,528,-15
2014,31,DC,276,276,0
2014,31,DE,327,330,-3
2014,31,FL,29934,30783,-849
2014,31,GA,1811,1874,-63
2014,31,HI,836,825,11
2014,31,IA,158,147,11
2014,31,ID,68,64,4
2014,31,IL,396,371,25
2014,31,IN,306,314,-8
2014,31,KS,130,134,-4
2014,31,KY,229,234,-5
2014,31,LA,8562,8889,-327
2014,31,MA,749,669,80
2014,31,MD,785,790,-5
2014,31,ME,102,105,-3
2014,31,MI,189,199,-10
2014,31,MN,102,99,3
2014,31,MO,182,189,-7
2014,31,MS,1047,1105,-58
2014,31,MT,48,49,-1
2014,31,NC,2536,2656,-120
2014,31,ND,97,104,-7
2014,31,NE,92,91,1
2014,31,NH,74,74,0
2014,31,NJ,2457,2523,-66
2014,31,NM,154,166,-12
2014,31,NV,150,200,-50
2014,31,NY,2577,2560,17
2014,31,OH,407,373,34
2014,31,OK,242,264,-22
2014,31,OR,260,286,-26
2014,31,PA,795,812,-17
2014,31,PR,149,9818,-9669
2014,31,RI,250,299,-49
2014,31,SC,3695,3623,72
2014,31,SD,59,62,-3
2014,31,TN,432,440,-8
2014,31,TX,15159,16022,-863
2014,31,UT,50,49,1
2014,31,VA,2221,2300,-79
2014,31,VI,15,14,1
2014,31,VT,43,51,-8
2014,31,WA,314,321,-7
2014,31,WI,142,135,7
2014,31,WV,146,166,-20
2014,31,WY,29,31,-2
2014,32,AK,44,36,8
2014,32,AL,855,875,-20
2014,32,AR,197,217,-20
2014,32,AZ,593,587,6
2014,32,CA,2033,2042,-9
2014,32,CO,532,531,1
2014,32,CT,617,629,-12
2014,32,DC,38,39,-1
2014,32,DE,447,452,-5
2014,32,FL,34743,35517,-774
2014,32,GA,2083,2191,-108
2014,32,HI,923,921,2
2014,32,IA,199,201,-2
2014,32,ID,74,71,3
2014,32,IL,444,478,-34
2014,32,IN,296,311,-15
2014,32,KS,155,157,-2
2014,32,KY,227,239,-12
2014,32,LA,9606,9822,-216
2014,32,MA,892,834,58
2014,32,MD,976,958,18
2014,32,ME,119,130,-11
2014,32,MI,238,233,5
2014,32,MN,138,128,10
2014,32,MO,454,467,-13
2014,32,MS,1414,1433,-19
2014,32,MT,80,82,-2
2014,32,NC,3143,3225,-82
2014,32,ND,151,161,-10
2014,32,NE,98,114,-16
2014,32,NH,76,76,0
2014,32,NJ,3616,3665,-49
2014,32,NM,170,172,-2
2014,32,NV,165,178,-13
2014,32,NY,3212,3216,-4
2014,32,OH,476,448,28
2014,32,OK,245,267,-22
2014,32,OR,308,309,-1
2014,32,PA,908,929,-21
2014,32,PR,44,82,-38
2014,32,RI,533,310,223
2014,32,SC,4242,4318,-76
2014,32,SD,73,78,-5
2014,32,TN,503,520,-17
2014,32,TX,16186,16999,-813
2014,32,UT,57,65,-8
2014,32,VA,2456,2547,-91
2014,32,VI,12,15,-3
2014,32,VT,49,50,-1
2014,32,WA,410,403,7
2014,32,WI,175,176,-1
2014,32,WV,198,207,-9
2014,32,WY,26,26,0
2014,33,AK,28,25,3
2014,33,AL,857,861,-4
2014,33,AR,185,194,-9
2014,33,AZ,551,563,-12
2014,33,CA,2006,2028,-22
2014,33,CO,346,363,-17
2014,33,CT,751,773,-22
2014,33,DC,22,21,1
2014,33,DE,367,357,10
2014,33,FL,36735,38251,-1516
2014,33,GA,1931,1884,47
2014,33,GU,3,4,-1
2014,33,HI,1664,1661,3
2014,33,IA,179,177,2
2014,33,ID,62,63,-1
2014,33,IL,608,615,-7
2014,33,IN,310,325,-15
2014,33,KS,141,149,-8
2014,33,KY,237,247,-10
2014,33,LA,9323,9395,-72
2014,33,MA,880,827,53
2014,33,MD,1114,1133,-19
2014,33,ME,116,118,-2
2014,33,MI,193,202,-9
2014,33,MN,124,120,4
2014,33,MO,233,224,9
2014,33,MS,1203,1263,-60
2014,33,MT,77,80,-3
2014,33,NC,2744,2821,-77
2014,33,ND,205,212,-7
2014,33,NE,113,116,-3
2014,33,NH,92,95,-3
2014,33,NJ,3173,3420,-247
2014,33,NM,168,174,-6
2014,33,NV,189,184,5
2014,33,NY,3822,3862,-40
2014,33,OH,447,441,6
2014,33,OK,194,209,-15
2014,33,OR,278,295,-17
2014,33,PA,1182,1229,-47
2014,33,PR,104,133,-29
2014,33,RI,322,330,-8
2014,33,SC,3665,3629,36
2014,33,SD,116,111,5
2014,33,TN,459,470,-11
2014,33,TX,15355,15980,-625
2014,33,UT,33,38,-5
2014,33,VA,2209,2312,-103
2014,33,VI,22,33,-11
2014,33,VT,40,38,2
2014,33,WA,362,358,4
2014,33,WI,188,203,-15
2014,33,WV,202,225,-23
2014,33,WY,53,56,-3
2014,34,AK,74,75,-1
2014,34,AL,1090,1097,-7
2014,34,AR,221,205,16
2014,34,AZ,497,456,41
2014,34,CA,2183,2199,-16
2014,34,CO,503,491,12
2014,34,CT,663,687,-24
2014,34,DC,93,97,-4
2014,34,DE,570,578,-8
2014,34,FL,35240,36421,-1181
2014,34,GA,2061,2012,49
2014,34,GU,1,3,-2
2014,34,HI,2458,2457,1
2014,34,IA,209,212,-3
2014,34,ID,82,73,9
2014,34,IL,537,566,-29
2014,34,IN,330,331,-1
2014,34,KS,137,149,-12
2014,34,KY,280,277,3
2014,34,LA,10281,10548,-267
2014,34,MA,1392,1225,167
2014,34,MD,1239,1220,19
2014,34,ME,151,151,0
2014,34,MI,223,215,8
2014,34,MN,123,135,-12
2014,34,MO,257,253,4
2014,34,MS,1318,1375,-57
2014,34,MT,68,66,2
2014,34,NC,3005,3128,-123
2014,34,ND,189,204,-15
2014,34,NE,109,107,2
2014,34,NH,84,87,-3
2014,34,NJ,3362,3440,-78
2014,34,NM,176,176,0
2014,34,NV,183,183,0
2014,34,NY,3578,3619,-41
2014,34,OH,534,547,-13
2014,34,OK,235,245,-10
2014,34,OR,367,385,-18
2014,34,PA,977,1011,-34
2014,34,PR,158,271,-113
2014,34,RI,407,391,16
2014,34,SC,4574,4570,4
2014,34,SD,145,144,1
2014,34,TN,509,513,-4
2014,34,TX,14918,15698,-780
2014,34,UT,52,54,-2
2014,34,VA,3065,3150,-85
2014,34,VI,11,11,0
2014,34,VT,43,40,3
2014,34,WA,407,415,-8
2014,34,WI,199,209,-10
2014,34,WV,212,226,-14
2014,34,WY,27,26,1
2014,35,AK,41,38,3
2014,35,AL,927,961,-34
2014,35,AR,184,191,-7
2014,35,AZ,470,455,15
2014,35,CA,2309,2334,-25
2014,35,CO,390,413,-23
2014,35,CT,630,660,-30
2014,35,DC,38,37,1
2014,35,DE,410,414,-4
2014,35,FL,33405,34442,-1037
2014,35,GA,1905,1976,-71
2014,35,HI,2370,1337,1033
2014,35,IA,164,167,-3
2014,35,ID,70,72,-2
2014,35,IL,433,485,-52
2014,35,IN,287,292,-5
2014,35,KS,149,175,-26
2014,35,KY,237,247,-10
2014,35,LA,10339,10512,-173
2014,35,MA,944,859,85
2014,35,MD,1089,1099,-10
2014,35,ME,123,121,2
2014,35,MI,156,141,15
2014,35,MN,130,141,-11
2014,35,MO,242,248,-6
2014,35,MS,1162,1208,-46
2014,35,MT,46,47,-1
2014,35,NC,2685,2786,-101
2014,35,ND,211,229,-18
2014,35,NE,94,96,-2
2014,35,NH,153,163,-10
2014,35,NJ,3318,3364,-46
2014,35,NM,171,162,9
2014,35,NV,144,137,7
2014,35,NY,3381,3437,-56
2014,35,OH,462,469,-7
2014,35,OK,219,233,-14
2014,35,OR,478,508,-30
2014,35,PA,890,901,-11
2014,35,PR,61,149,-88
2014,35,RI,297,289,8
2014,35,SC,3604,3631,-27
2014,35,SD,60,70,-10
2014,35,TN,423,417,6
2014,35,TX,13598,14035,-437
2014,35,UT,65,62,3
2014,35,VA,2269,2335,-66
2014,35,VI,12,11,1
2014,35,VT,39,38,1
2014,35,WA,392,389,3
2014,35,WI,204,216,-12
2014,35,WV,201,222,-21
2014,35,WY,22,25,-3
2014,36,AK,33,36,-3
2014,36,AL,792,835,-43
2014,36,AR,199,207,-8
2014,36,AZ,442,391,51
2014,36,CA,2076,2104,-28
2014,36,CO,540,483,57
2014,36,CT,536,546,-10
2014,36,DC,29,29,0
2014,36,DE,398,403,-5
2014,36,FL,27642,28606,-964
2014,36,GA,1517,1572,-55
2014,36,GU,2,1,1
2014,36,HI,1624,1617,7
2014,36,IA,173,174,-1
2014,36,ID,62,55,7
2014,36,IL,416,445,-29
2014,36,IN,267,288,-21
2014,36,KS,137,133,4
2014,36,KY,259,277,-18
2014,36,LA,7257,7433,-176
2014,36,MA,983,772,211
2014,36,MD,833,794,39
2014,36,ME,133,134,-1
2014,36,MI,239,184,55
2014,36,MN,123,131,-8
2014,36,MO,251,267,-16
2014,36,MS,961,975,-14
2014,36,MT,75,80,-5
2014,36,NC,2471,2480,-9
2014,36,ND,237,231,6
2014,36,NE,85,84,1
2014,36,NH,121,125,-4
2014,36,NJ,2870,2909,-39
2014,36,NM,164,164,0
2014,36,NV,133,122,11
2014,36,NY,3855,3853,2
2014,36,OH,461,447,14
2014,36,OK,182,210,-28
2014,36,OR,282,297,-15
2014,36,PA,813,842,-29
2014,36,PR,103,168,-65
2014,36,RI,423,429,-6
2014,36,SC,3406,3442,-36
2014,36,SD,69,70,-1
2014,36,TN,512,527,-15
2014,36,TX,12088,12511,-423
2014,36,UT,69,57,12
2014,36,VA,2147,2213,-66
2014,36,VI,25,24,1
2014,36,VT,71,74,-3
2014,36,WA,341,357,-16
2014,36,WI,174,184,-10
2014,36,WV,196,224,-28
2014,36,WY,34,39,-5
2014,37,AK,37,39,-2
2014,37,AL,1114,1155,-41
2014,37,AR,204,202,2
2014,37,AZ,606,467,139
2014,37,CA,2146,2425,-279
2014,37,CO,365,326,39
2014,37,CT,626,647,-21
2014,37,DC,39,38,1
2014,37,DE,374,375,-1
2014,37,FL,29188,30778,-1590
2014,37,GA,1678,1741,-63
2014,37,GU,2,2,0
2014,37,HI,1124,1115,9
2014,37,IA,171,176,-5
2014,37,ID,78,73,5
2014,37,IL,447,460,-13
2014,37,IN,276,291,-15
2014,37,KS,133,133,0
2014,37,KY,238,265,-27
2014,37,LA,8153,8308,-155
2014,37,MA,1138,977,161
2014,37,MD,1054,1068,-14
2014,37,ME,138,144,-6
2014,37,MI,249,167,82
2014,37,MN,128,112,16
2014,37,MO,287,297,-10
2014,37,MS,1110,1124,-14
2014,37,MT,58,68,-10
2014,37,NC,2432,2475,-43
2014,37,ND,216,222,-6
2014,37,NE,92,92,0
2014,37,NH,118,127,-9
2014,37,NJ,3357,3404,-47
2014,37,NM,185,182,3
2014,37,NV,133,135,-2
2014,37,NY,3790,3710,80
2014,37,OH,449,436,13
2014,37,OK,249,258,-9
2014,37,OR,415,453,-38
2014,37,PA,884,938,-54
2014,37,PR,78,191,-113
2014,37,RI,279,271,8
2014,37,SC,3750,3762,-12
2014,37,SD,78,76,2
2014,37,TN,466,478,-12
2014,37,TX,11792,12254,-462
2014,37,UT,68,61,7
2014,37,VA,2096,2145,-49
2014,37,VI,12,21,-9
2014,37,VT,41,44,-3
2014,37,WA,416,434,-18
2014,37,WI,187,196,-9
2014,37,WV,194,201,-7
2014,37,WY,13,15,-2
2014,38,AK,45,44,1
2014,38,AL,793,799,-6
2014,38,AR,223,220,3
2014,38,AZ,666,530,136
2014,38,CA,2468,2466,2
2014,38,CO,406,352,54
2014,38,CT,741,762,-21
2014,38,DC,298,301,-3
2014,38,DE,487,495,-8
2014,38,FL,33756,35484,-1728
2014,38,GA,1730,1796,-66
2014,38,GU,2,2,0
2014,38,HI,951,930,21
2014,38,IA,312,319,-7
2014,38,ID,60,54,6
2014,38,IL,539,509,30
2014,38,IN,293,287,6
2014,38,KS,148,162,-14
2014,38,KY,272,282,-10
2014,38,LA,8151,8289,-138
2014,38,MA,1218,1033,185
2014,38,MD,1125,1125,0
2014,38,ME,146,145,1
2014,38,MI,337,275,62
2014,38,MN,122,116,6
2014,38,MO,239,248,-9
2014,38,MS,1083,1103,-20
2014,38,MT,43,48,-5
2014,38,NC,2484,2572,-88
2014,38,ND,204,205,-1
2014,38,NE,93,91,2
2014,38,NH,152,153,-1
2014,38,NJ,3449,3508,-59
2014,38,NM,160,149,11
2014,38,NV,195,205,-10
2014,38,NY,4463,4439,24
2014,38,OH,501,507,-6
2014,38,OK,238,251,-13
2014,38,OR,337,370,-33
2014,38,PA,985,1036,-51
2014,38,PR,83,203,-120
2014,38,RI,381,391,-10
2014,38,SC,4036,4062,-26
2014,38,SD,82,78,4
2014,38,TN,501,503,-2
2014,38,TX,11936,12430,-494
2014,38,UT,76,68,8
2014,38,VA,2367,2472,-105
2014,38,VI,14,23,-9
2014,38,VT,51,41,10
2014,38,WA,514,524,-10
2014,38,WI,166,179,-13
2014,38,WV,175,185,-10
2014,38,WY,23,23,0
2014,39,AK,41,47,-6
2014,39,AL,1012,1019,-7
2014,39,AR,216,230,-14
2014,39,AZ,504,447,57
2014,39,CA,2844,2848,-4
2014,39,CO,374,362,12
2014,39,CT,685,715,-30
2014,39,DC,49,52,-3
2014,39,DE,468,474,-6
2014,39,FL,38479,39837,-1358
2014,39,GA,2069,2148,-79
2014,39,GU,1,1,0
2014,39,HI,1869,1898,-29
2014,39,IA,156,165,-9
2014,39,ID,77,68,9
2014,39,IL,523,528,-5
2014,39,IN,364,351,13
2014,39,KS,165,160,5
2014,39,KY,324,331,-7
2014,39,LA,7720,7890,-170
2014,39,MA,1413,1117,296
2014,39,MD,1551,1577,-26
2014,39,ME,176,168,8
2014,39,MI,212,188,24
2014,39,MN,131,129,2
2014,39,MO,303,314,-11
2014,39,MS,954,988,-34
2014,39,MT,59,64,-5
2014,39,NC,2838,2919,-81
2014,39,ND,212,208,4
2014,39,NE,107,104,3
2014,39,NH,120,122,-2
2014,39,NJ,4037,4122,-85
2014,39,NM,161,154,7
2014,39,NV,176,170,6
2014,39,NY,4207,4281,-74
2014,39,OH,554,521,33
2014,39,OK,237,262,-25
2014,39,OR,432,449,-17
2014,39,PA,1036,1076,-40
2014,39,PR,63,699,-636
2014,39,RI,302,307,-5
2014,39,SC,4825,4929,-104
2014,39,SD,60,63,-3
2014,39,TN,559,560,-1
2014,39,TX,11470,12133,-663
2014,39,UT,83,79,4
2014,39,VA,3176,3287,-111
2014,39,VI,13,13,0
2014,39,VT,55,59,-4
2014,39,WA,597,632,-35
2014,39,WI,195,201,-6
2014,39,WV,205,211,-6
2014,39,WY,23,24,-1
2014,40,AK,37,36,1
2014,40,AL,808,799,9
2014,40,AR,153,150,3
2014,40,AZ,690,362,328
2014,40,CA,2731,2661,70
2014,40,CO,275,274,1
2014,40,CT,604,601,3
2014,40,DC,36,38,-2
2014,40,DE,426,436,-10
2014,40,FL,26931,27485,-554
2014,40,GA,1433,1473,-40
2014,40,HI,974,970,4
2014,40,IA,141,132,9
2014,40,ID,63,53,10
2014,40,IL,396,374,22
2014,40,IN,269,244,25
2014,40,KS,107,106,1
2014,40,KY,201,200,1
2014,40,LA,6061,6173,-112
2014,40,MA,1290,1057,233
2014,40,MD,895,910,-15
2014,40,ME,155,157,-2
2014,40,MI,241,180,61
2014,40,MN,122,118,4
2014,40,MO,225,237,-12
2014,40,MS,848,896,-48
2014,40,MT,48,52,-4
2014,40,NC,2053,2130,-77
2014,40,ND,141,135,6
2014,40,NE,88,76,12
2014,40,NH,93,100,-7
2014,40,NJ,2890,2945,-55
2014,40,NM,131,124,7
2014,40,NV,157,157,0
2014,40,NY,3839,3786,53
2014,40,OH,406,390,16
2014,40,OK,228,232,-4
2014,40,OR,420,413,7
2014,40,PA,1025,1048,-23
2014,40,PR,71,161,-90
2014,40,RI,217,219,-2
2014,40,SC,2710,2733,-23
2014,40,SD,50,54,-4
2014,40,TN,405,393,12
2014,40,TX,9476,9728,-252
2014,40,UT,56,58,-2
2014,40,VA,2004,2048,-44
2014,40,VI,11,9,2
2014,40,VT,70,68,2
2014,40,WA,535,545,-10
2014,40,WI,126,134,-8
2014,40,WV,189,209,-20
2014,40,WY,26,28,-2
2014,41,AK,33,36,-3
2014,41,AL,675,672,3
2014,41,AR,180,184,-4
2014,41,AZ,833,421,412
2014,41,CA,3382,3402,-20
2014,41,CO,561,720,-159
2014,41,CT,604,593,11
2014,41,DC,36,29,7
2014,41,DE,457,448,9
2014,41,FL,26082,27312,-1230
2014,41,GA,1428,1440,-12
2014,41,HI,618,627,-9
2014,41,IA,148,144,4
2014,41,ID,82,88,-6
2014,41,IL,485,477,8
2014,41,IN,292,295,-3
2014,41,KS,125,130,-5
2014,41,KY,249,248,1
2014,41,LA,6409,6492,-83
2014,41,MA,1216,1014,202
2014,41,MD,1152,1145,7
2014,41,ME,217,205,12
2014,41,MI,220,149,71
2014,41,MN,113,117,-4
2014,41,MO,218,220,-2
2014,41,MS,889,884,5
2014,41,MT,44,46,-2
2014,41,NC,2137,2174,-37
2014,41,ND,173,193,-20
2014,41,NE,70,75,-5
2014,41,NH,85,89,-4
2014,41,NJ,3142,3173,-31
2014,41,NM,159,169,-10
2014,41,NV,163,149,14
2014,41,NY,3604,3572,32
2014,41,OH,456,471,-15
2014,41,OK,208,225,-17
2014,41,OR,504,520,-16
2014,41,PA,1107,1168,-61
2014,41,PR,86,97,-11
2014,41,RI,253,258,-5
2014,41,SC,2754,2750,4
2014,41,SD,66,62,4
2014,41,TN,436,424,12
2014,41,TX,9615,9810,-195
2014,41,UT,93,80,13
2014,41,VA,2096,2153,-57
2014,41,VI,21,20,1
2014,41,VT,53,53,0
2014,41,WA,647,679,-32
2014,41,WI,143,159,-16
2014,41,WV,176,194,-18
2014,41,WY,25,31,-6
2014,42,AK,47,49,-2
2014,42,AL,646,645,1
2014,42,AR,189,194,-5
2014,42,AZ,643,503,140
2014,42,CA,3853,3914,-61
2014,42,CO,420,481,-61
2014,42,CT,541,573,-32
2014,42,DC,43,43,0
2014,42,DE,390,379,11
2014,42,FL,24909,26440,-1531
2014,42,GA,1751,1838,-87
2014,42,GU,3,2,1
2014,42,HI,1055,567,488
2014,42,IA,204,209,-5
2014,42,ID,91,90,1
2014,42,IL,440,449,-9
2014,42,IN,324,328,-4
2014,42,KS,146,143,3
2014,42,KY,227,245,-18
2014,42,LA,6074,6281,-207
2014,42,MA,1112,843,269
2014,42,MD,1015,1036,-21
2014,42,ME,140,127,13
2014,42,MI,225,214,11
2014,42,MN,130,131,-1
2014,42,MO,242,238,4
2014,42,MS,954,969,-15
2014,42,MT,48,49,-1
2014,42,NC,1901,1939,-38
2014,42,ND,189,206,-17
2014,42,NE,101,98,3
2014,42,NH,87,82,5
2014,42,NJ,2877,2951,-74
2014,42,NM,153,147,6
2014,42,NV,180,541,-361
2014,42,NY,3014,2910,104
2014,42,OH,469,489,-20
2014,42,OK,218,233,-15
2014,42,OR,465,472,-7
2014,42,PA,1163,1186,-23
2014,42,PR,98,186,-88
2014,42,RI,203,216,-13
2014,42,SC,2714,2693,21
2014,42,SD,54,57,-3
2014,42,TN,428,415,13
2014,42,TX,10175,10601,-426
2014,42,UT,73,76,-3
2014,42,VA,2342,2415,-73
2014,42,VI,7,8,-1
2014,42,VT,71,67,4
2014,42,WA,641,690,-49
2014,42,WI,157,156,1
2014,42,WV,172,178,-6
2014,42,WY,22,22,0
2014,43,AK,49,52,-3
2014,43,AL,870,865,5
2014,43,AR,207,212,-5
2014,43,AZ,508,434,74
2014,43,CA,3950,4055,-105
2014,43,CO,437,451,-14
2014,43,CT,528,536,-8
2014,43,DC,32,31,1
2014,43,DE,592,585,7
2014,43,FL,32619,34188,-1569
2014,43,GA,1776,1832,-56
2014,43,HI,1874,1527,347
2014,43,IA,163,165,-2
2014,43,ID,89,93,-4
2014,43,IL,499,491,8
2014,43,IN,315,310,5
2014,43,KS,148,148,0
2014,43,KY,260,258,2
2014,43,LA,7395,7593,-198
2014,43,MA,1266,999,267
2014,43,MD,1241,1267,-26
2014,43,ME,154,156,-2
2014,43,MI,227,204,23
2014,43,MN,149,145,4
2014,43,MO,259,259,0
2014,43,MP,1,0,1
2014,43,MS,993,1027,-34
2014,43,MT,62,69,-7
2014,43,NC,2136,2225,-89
2014,43,ND,245,244,1
2014,43,NE,89,87,2
2014,43,NH,169,176,-7
2014,43,NJ,3308,3367,-59
2014,43,NM,128,144,-16
2014,43,NV,171,187,-16
2014,43,NY,3401,3372,29
2014,43,OH,497,509,-12
2014,43,OK,282,290,-8
2014,43,OR,553,544,9
2014,43,PA,1386,1455,-69
2014,43,PR,83,99,-16
2014,43,RI,262,265,-3
2014,43,SC,3412,3377,35
2014,43,SD,71,67,4
2014,43,TN,450,458,-8
2014,43,TX,10855,11338,-483
2014,43,UT,75,72,3
2014,43,VA,1995,2030,-35
2014,43,VI,11,120,-109
2014,43,VT,76,73,3
2014,43,WA,1072,1197,-125
2014,43,WI,151,154,-3
2014,43,WV,189,201,-12
2014,43,WY,24,29,-5
2014,44,AK,38,33,5
2014,44,AL,777,784,-7
2014,44,AR,171,172,-1
2014,44,AZ,446,305,141
2014,44,CA,3831,3972,-141
2014,44,CO,266,277,-11
2014,44,CT,488,512,-24
2014,44,DC,31,31,0
2014,44,DE,261,265,-4
2014,44,FL,21341,22186,-845
2014,44,GA,1342,1428,-86
2014,44,HI,644,639,5
2014,44,IA,129,126,3
2014,44,ID,64,63,1
2014,44,IL,389,419,-30
2014,44,IN,280,279,1
2014,44,KS,116,109,7
2014,44,KY,271,273,-2
2014,44,LA,4864,4973,-109
2014,44,MA,863,691,172
2014,44,MD,725,730,-5
2014,44,ME,128,129,-1
2014,44,MI,168,157,11
2014,44,MN,84,89,-5
2014,44,MO,238,246,-8
2014,44,MS,820,844,-24
2014,44,MT,47,44,3
2014,44,NC,1711,1701,10
2014,44,ND,151,148,3
2014,44,NE,60,62,-2
2014,44,NH,136,139,-3
2014,44,NJ,2994,2964,30
2014,44,NM,104,112,-8
2014,44,NV,163,172,-9
2014,44,NY,2560,2493,67
2014,44,OH,371,374,-3
2014,44,OK,163,160,3
2014,44,OR,442,446,-4
2014,44,PA,816,834,-18
2014,44,PR,44,87,-43
2014,44,RI,191,183,8
2014,44,SC,2239,2222,17
2014,44,SD,49,52,-3
2014,44,TN,375,380,-5
2014,44,TX,7450,7704,-254
2014,44,UT,54,47,7
2014,44,VA,1393,1460,-67
2014,44,VI,12,13,-1
2014,44,VT,65,67,-2
2014,44,WA,796,838,-42
2014,44,WI,147,135,12
2014,44,WV,177,190,-13
2014,44,WY,31,31,0
2014,45,AK,23,29,-6
2014,45,AL,710,703,7
2014,45,AR,158,153,5
2014,45,AZ,340,293,47
2014,45,CA,3863,4023,-160
2014,45,CO,295,310,-15
2014,45,CT,617,606,11
2014,45,DC,28,25,3
2014,45,DE,303,301,2
2014,45,FL,20812,22245,-1433
2014,45,GA,1270,1331,-61
2014,45,HI,840,832,8
2014,45,IA,112,115,-3
2014,45,ID,75,71,4
2014,45,IL,369,372,-3
2014,45,IN,227,233,-6
2014,45,KS,120,122,-2
2014,45,KY,191,200,-9
2014,45,LA,5171,5233,-62
2014,45,MA,890,730,160
2014,45,MD,808,833,-25
2014,45,ME,138,144,-6
2014,45,MI,170,148,22
2014,45,MN,96,102,-6
2014,45,MO,229,232,-3
2014,45,MS,916,929,-13
2014,45,MT,45,43,2
2014,45,NC,1916,1930,-14
2014,45,ND,124,129,-5
2014,45,NE,63,67,-4
2014,45,NH,77,77,0
2014,45,NJ,2805,2850,-45
2014,45,NM,96,93,3
2014,45,NV,148,158,-10
2014,45,NY,2659,2594,65
2014,45,OH,354,371,-17
2014,45,OK,200,207,-7
2014,45,OR,467,474,-7
2014,45,PA,881,902,-21
2014,45,PR,45,60,-15
2014,45,RI,163,156,7
2014,45,SC,2510,2425,85
2014,45,SD,44,50,-6
2014,45,TN,321,310,11
2014,45,TX,7302,7541,-239
2014,45,UT,71,58,13
2014,45,VA,1800,1618,182
2014,45,VI,5,5,0
2014,45,VT,54,49,5
2014,45,WA,735,771,-36
2014,45,WI,125,135,-10
2014,45,WV,150,159,-9
2014,45,WY,17,22,-5
2014,46,AK,57,53,4
2014,46,AL,516,476,40
2014,46,AR,152,147,5
2014,46,AZ,376,336,40
2014,46,CA,3885,4074,-189
2014,46,CO,274,352,-78
2014,46,CT,458,451,7
2014,46,DC,28,30,-2
2014,46,DE,342,328,14
2014,46,FL,21073,22688,-1615
2014,46,GA,1214,1259,-45
2014,46,HI,375,375,0
2014,46,IA,103,104,-1
2014,46,ID,52,61,-9
2014,46,IL,426,554,-128
2014,46,IN,263,252,11
2014,46,KS,111,114,-3
2014,46,KY,227,225,2
2014,46,LA,5456,5621,-165
2014,46,MA,905,764,141
2014,46,MD,1008,1002,6
2014,46,ME,137,136,1
2014,46,MI,168,145,23
2014,46,MN,101,100,1
2014,46,MO,250,261,-11
2014,46,MS,952,969,-17
2014,46,MT,42,39,3
2014,46,NC,1745,1780,-35
2014,46,ND,117,112,5
2014,46,NE,60,65,-5
2014,46,NH,60,66,-6
2014,46,NJ,2680,2723,-43
2014,46,NM,121,125,-4
2014,46,NV,174,174,0
2014,46,NY,2721,2680,41
2014,46,OH,428,421,7
2014,46,OK,189,205,-16
2014,46,OR,507,515,-8
2014,46,PA,817,843,-26
2014,46,PR,74,884,-810
2014,46,RI,168,167,1
2014,46,SC,2743,2715,28
2014,46,SD,50,50,0
2014,46,TN,350,385,-35
2014,46,TX,7622,7852,-230
2014,46,UT,58,59,-1
2014,46,VA,1515,1550,-35
2014,46,VI,10,11,-1
2014,46,VT,59,58,1
2014,46,WA,769,816,-47
2014,46,WI,121,125,-4
2014,46,WV,177,176,1
2014,46,WY,20,21,-1
2014,47,AK,31,28,3
2014,47,AL,516,497,19
2014,47,AR,138,142,-4
2014,47,AZ,320,290,30
2014,47,CA,3310,3367,-57
2014,47,CO,236,236,0
2014,47,CT,665,676,-11
2014,47,DC,32,34,-2
2014,47,DE,311,306,5
2014,47,FL,20171,21252,-1081
2014,47,GA,981,995,-14
2014,47,GU,1,1,0
2014,47,HI,1539,1523,16
2014,47,IA,117,114,3
2014,47,ID,56,58,-2
2014,47,IL,365,356,9
2014,47,IN,222,202,20
2014,47,KS,104,117,-13
2014,47,KY,210,202,8
2014,47,LA,4796,4940,-144
2014,47,MA,845,758,87
2014,47,MD,924,959,-35
2014,47,ME,112,114,-2
2014,47,MI,193,177,16
2014,47,MN,93,91,2
2014,47,MO,189,188,1
2014,47,MS,780,790,-10
2014,47,MT,62,52,10
2014,47,NC,1369,1374,-5
2014,47,ND,105,100,5
2014,47,NE,69,71,-2
2014,47,NH,157,163,-6
2014,47,NJ,2280,2316,-36
2014,47,NM,89,91,-2
2014,47,NV,134,140,-6
2014,47,NY,2496,2435,61
2014,47,OH,310,309,1
2014,47,OK,147,158,-11
2014,47,OR,487,499,-12
2014,47,PA,812,820,-8
2014,47,PR,49,62,-13
2014,47,RI,205,204,1
2014,47,SC,1989,1963,26
2014,47,SD,55,46,9
2014,47,TN,440,448,-8
2014,47,TX,6569,6794,-225
2014,47,UT,54,57,-3
2014,47,VA,1468,1510,-42
2014,47,VI,4,6,-2
2014,47,VT,69,75,-6
2014,47,WA,704,731,-27
2014,47,WI,116,124,-8
2014,47,WV,158,157,1
2014,47,WY,14,13,1
2014,48,AK,38,40,-2
2014,48,AL,986,966,20
2014,48,AR,170,178,-8
2014,48,AZ,348,334,14
2014,48,CA,4677,4775,-98
2014,48,CO,255,267,-12
2014,48,CT,905,923,-18
2014,48,DC,39,41,-2
2014,48,DE,357,355,2
2014,48,FL,25202,26833,-1631
2014,48,GA,1287,1300,-13
2014,48,GU,2,2,0
2014,48,HI,674,672,2
2014,48,IA,127,132,-5
2014,48,ID,61,61,0
2014,48,IL,436,459,-23
2014,48,IN,261,254,7
2014,48,KS,121,119,2
2014,48,KY,198,201,-3
2014,48,LA,5139,5250,-111
2014,48,MA,836,749,87
2014,48,MD,808,835,-27
2014,48,ME,156,157,-1
2014,48,MI,372,355,17
2014,48,MN,108,108,0
2014,48,MO,230,231,-1
2014,48,MS,974,1013,-39
2014,48,MT,63,66,-3
2014,48,NC,1684,1701,-17
2014,48,ND,108,98,10
2014,48,NE,78,71,7
2014,48,NH,114,112,2
2014,48,NJ,3074,3084,-10
2014,48,NM,153,161,-8
2014,48,NV,137,137,0
2014,48,NY,2713,2712,1
2014,48,OH,413,426,-13
2014,48,OK,154,182,-28
2014,48,OR,505,523,-18
2014,48,PA,908,920,-12
2014,48,PR,48,272,-224
2014,48,RI,148,145,3
2014,48,SC,2589,2644,-55
2014,48,SD,58,56,2
2014,48,TN,345,348,-3
2014,48,TX,7437,7765,-328
2014,48,UT,76,67,9
2014,48,VA,2115,2196,-81
2014,48,VI,43,42,1
2014,48,VT,49,51,-2
2014,48,WA,783,759,24
2014,48,WI,118,127,-9
2014,48,WV,158,164,-6
2014,48,WY,17,16,1
2014,49,AK,30,34,-4
2014,49,AL,594,561,33
2014,49,AR,133,130,3
2014,49,AZ,312,286,26
2014,49,CA,3882,3893,-11
2014,49,CO,236,246,-10
2014,49,CT,380,377,3
2014,49,DC,27,28,-1
2014,49,DE,332,324,8
2014,49,FL,19037,20445,-1408
2014,49,GA,1005,1054,-49
2014,49,HI,592,590,2
2014,49,IA,132,135,-3
2014,49,ID,69,69,0
2014,49,IL,351,360,-9
2014,49,IN,201,190,11
2014,49,KS,102,103,-1
2014,49,KY,188,196,-8
2014,49,LA,4615,4660,-45
2014,49,MA,655,568,87
2014,49,MD,957,954,3
2014,49,ME,114,118,-4
2014,49,MI,187,177,10
2014,49,MN,80,80,0
2014,49,MO,211,197,14
2014,49,MS,752,777,-25
2014,49,MT,46,48,-2
2014,49,NC,1456,1492,-36
2014,49,ND,116,102,14
2014,49,NE,66,65,1
2014,49,NH,85,88,-3
2014,49,NJ,2505,2551,-46
2014,49,NM,136,138,-2
2014,49,NV,132,121,11
2014,49,NY,2754,2763,-9
2014,49,OH,344,351,-7
2014,49,OK,183,195,-12
2014,49,OR,455,481,-26
2014,49,PA,766,761,5
2014,49,PR,43,49,-6
2014,49,RI,222,220,2
2014,49,SC,1941,1926,15
2014,49,SD,50,48,2
2014,49,TN,319,335,-16
2014,49,TX,5844,6121,-277
2014,49,UT,39,40,-1
2014,49,VA,1205,1240,-35
2014,49,VI,2,2,0
2014,49,VT,39,36,3
2014,49,WA,592,633,-41
2014,49,WI,122,128,-6
2014,49,WV,148,150,-2
2014,49,WY,18,17,1
2014,50,AK,26,26,0
2014,50,AL,568,525,43
2014,50,AR,247,184,63
2014,50,AZ,385,350,35
2014,50,CA,4256,4510,-254
2014,50,CO,279,268,11
2014,50,CT,519,527,-8
2014,50,DC,35,41,-6
2014,50,DE,356,363,-7
2014,50,FL,25471,27361,-1890
2014,50,GA,1213,1242,-29
2014,50,HI,1909,1865,44
2014,50,IA,136,142,-6
2014,50,ID,61,70,-9
2014,50,IL,472,466,6
2014,50,IN,249,250,-1
2014,50,KS,109,107,2
2014,50,KY,258,262,-4
2014,50,LA,5434,5522,-88
2014,50,MA,907,841,66
2014,50,MD,863,863,0
2014,50,ME,137,132,5
2014,50,MI,217,199,18
2014,50,MN,91,88,3
2014,50,MO,232,234,-2
2014,50,MP,1,1,0
2014,50,MS,813,819,-6
2014,50,MT,46,46,0
2014,50,NC,1776,1825,-49
2014,50,ND,119,114,5
2014,50,NE,74,79,-5
2014,50,NH,79,85,-6
2014,50,NJ,3209,3275,-66
2014,50,NM,111,121,-10
2014,50,NV,137,140,-3
2014,50,NY,3363,3264,99
2014,50,OH,491,498,-7
2014,50,OK,198,220,-22
2014,50,OR,533,569,-36
2014,50,PA,829,821,8
2014,50,PR,43,157,-114
2014,50,RI,151,171,-20
2014,50,SC,2801,2792,9
2014,50,SD,48,48,0
2014,50,TN,338,346,-8
2014,50,TX,6754,7113,-359
2014,50,UT,61,57,4
2014,50,VA,1919,1941,-22
2014,50,VI,8,10,-2
2014,50,VT,40,39,1
2014,50,WA,745,752,-7
2014,50,WI,132,134,-2
2014,50,WV,154,153,1
2014,50,WY,22,24,-2
2014,51,AK,24,25,-1
2014,51,AL,389,345,44
2014,51,AR,86,92,-6
2014,51,AZ,248,242,6
2014,51,CA,2791,2895,-104
2014,51,CO,267,242,25
2014,51,CT,365,367,-2
2014,51,DC,20,21,-1
2014,51,DE,209,210,-1
2014,51,FL,15715,17138,-1423
2014,51,GA,724,726,-2
2014,51,GU,1,1,0
2014,51,HI,1003,985,18
2014,51,IA,99,97,2
2014,51,ID,44,45,-1
2014,51,IL,219,228,-9
2014,51,IN,199,185,14
2014,51,KS,81,87,-6
2014,51,KY,192,197,-5
2014,51,LA,3678,3721,-43
2014,51,MA,533,460,73
2014,51,MD,1183,1181,2
2014,51,ME,86,78,8
2014,51,MI,145,122,23
2014,51,MN,56,61,-5
2014,51,MO,141,146,-5
2014,51,MS,574,589,-15
2014,51,MT,29,28,1
2014,51,NC,1003,1016,-13
2014,51,ND,94,81,13
2014,51,NE,64,75,-11
2014,51,NH,64,60,4
2014,51,NJ,2007,2032,-25
2014,51,NM,95,103,-8
2014,51,NV,103,106,-3
2014,51,NY,2303,2288,15
2014,51,OH,238,241,-3
2014,51,OK,117,127,-10
2014,51,OR,311,342,-31
2014,51,PA,514,500,14
2014,51,PR,35,53,-18
2014,51,RI,108,114,-6
2014,51,SC,1435,1425,10
2014,51,SD,45,47,-2
2014,51,TN,323,307,16
2014,51,TX,4625,4774,-149
2014,51,UN,1,1,0
2014,51,UT,48,46,2
2014,51,VA,918,918,0
2014,51,VI,30,32,-2
2014,51,VT,27,25,2
2014,51,WA,572,593,-21
2014,51,WI,58,68,-10
2014,51,WV,128,130,-2
2014,51,WY,23,20,3
2014,52,AK,9,12,-3
2014,52,AL,338,333,5
2014,52,AR,67,72,-5
2014,52,AZ,202,195,7
2014,52,CA,2033,2106,-73
2014,52,CO,152,150,2
2014,52,CT,185,187,-2
2014,52,DC,22,25,-3
2014,52,DE,149,153,-4
2014,52,FL,17187,18858,-1671
2014,52,GA,605,621,-16
2014,52,HI,183,188,-5
2014,52,IA,67,67,0
2014,52,ID,32,31,1
2014,52,IL,166,181,-15
2014,52,IN,128,132,-4
2014,52,KS,56,62,-6
2014,52,KY,91,104,-13
2014,52,LA,3487,3595,-108
2014,52,MA,723,698,25
2014,52,MD,427,422,5
2014,52,ME,53,55,-2
2014,52,MI,116,116,0
2014,52,MN,58,54,4
2014,52,MO,124,118,6
2014,52,MS,475,502,-27
2014,52,MT,14,20,-6
2014,52,NC,817,822,-5
2014,52,ND,120,68,52
2014,52,NE,71,72,-1
2014,52,NH,42,42,0
2014,52,NJ,1258,1294,-36
2014,52,NM,56,58,-2
2014,52,NV,72,72,0
2014,52,NY,1612,1655,-43
2014,52,OH,198,205,-7
2014,52,OK,87,101,-14
2014,52,OR,244,225,19
2014,52,PA,437,440,-3
2014,52,PR,74,85,-11
2014,52,RI,76,67,9
2014,52,SC,2007,1749,258
2014,52,SD,34,28,6
2014,52,TN,172,174,-2
2014,52,TX,3768,3950,-182
2014,52,UT,26,28,-2
2014,52,VA,774,797,-23
2014,52,VI,3,5,-2
2014,52,VT,19,25,-6
2014,52,WA,333,344,-11
2014,52,WI,62,62,0
2014,52,WV,77,77,0
2014,52,WY,16,14,2
2015,0,AK,3,8,-5
2015,0,AL,177,170,7
2015,0,AR,58,58,0
2015,0,AZ,159,169,-10
2015,0,CA,2144,2149,-5
2015,0,CO,109,123,-14
2015,0,CT,196,210,-14
2015,0,DC,12,15,-3
2015,0,DE,230,227,3
2015,0,FL,16082,16574,-492
2015,0,GA,854,854,0
2015,0,GU,2,2,0
2015,0,HI,232,207,25
2015,0,IA,67,69,-2
2015,0,ID,31,27,4
2015,0,IL,170,172,-2
2015,0,IN,105,104,1
2015,0,KS,46,42,4
2015,0,KY,92,93,-1
2015,0,LA,2045,2062,-17
2015,0,MA,252,216,36
2015,0,MD,342,342,0
2015,0,ME,37,33,4
2015,0,MI,62,54,8
2015,0,MN,35,32,3
2015,0,MO,68,68,0
2015,0,MS,266,282,-16
2015,0,MT,31,22,9
2015,0,NC,840,847,-7
2015,0,ND,72,38,34
2015,0,NE,38,40,-2
2015,0,NH,35,35,0
2015,0,NJ,878,859,19
2015,0,NM,48,50,-2
2015,0,NV,61,55,6
2015,0,NY,1111,1089,22
2015,0,OH,135,126,9
2015,0,OK,61,63,-2
2015,0,OR,217,214,3
2015,0,PA,331,328,3
2015,0,PR,17,15,2
2015,0,RI,60,59,1
2015,0,SC,957,949,8
2015,0,SD,31,32,-1
2015,0,TN,129,135,-6
2015,0,TX,2755,2784,-29
2015,0,UT,22,19,3
2015,0,VA,924,924,0
2015,0,VI,2,2,0
2015,0,VT,16,16,0
2015,0,WA,245,243,2
2015,0,WI,121,122,-1
2015,0,WV,65,67,-2
2015,0,WY,5,4,1
2015,1,AK,19,18,1
2015,1,AL,550,522,28
2015,1,AR,106,107,-1
2015,1,AZ,332,321,11
2015,1,CA,4335,3942,393
2015,1,CO,284,293,-9
2015,1,CT,510,504,6
2015,1,DC,24,28,-4
2015,1,DE,271,258,13
2015,1,FL,18389,19323,-934
2015,1,GA,906,893,13
2015,1,HI,361,265,96
2015,1,IA,127,136,-9
2015,1,ID,66,68,-2
2015,1,IL,599,609,-10
2015,1,IN,235,213,22
2015,1,KS,145,149,-4
2015,1,KY,194,192,2
2015,1,LA,4094,4163,-69
2015,1,MA,669,693,-24
2015,1,MD,706,702,4
2015,1,ME,105,108,-3
2015,1,MI,166,141,25
2015,1,MN,78,75,3
2015,1,MO,164,171,-7
2015,1,MS,740,766,-26
2015,1,MT,44,44,0
2015,1,NC,1293,1309,-16
2015,1,ND,250,85,165
2015,1,NE,70,65,5
2015,1,NH,63,77,-14
2015,1,NJ,2029,2059,-30
2015,1,NM,107,108,-1
2015,1,NV,156,158,-2
2015,1,NY,2533,2461,72
2015,1,OH,300,312,-12
2015,1,OK,140,147,-7
2015,1,OR,444,456,-12
2015,1,PA,665,635,30
2015,1,PR,38,46,-8
2015,1,RI,132,133,-1
2015,1,SC,1799,1764,35
2015,1,SD,40,36,4
2015,1,TN,308,319,-11
2015,1,TX,6318,6419,-101
2015,1,UT,58,58,0
2015,1,VA,1028,1052,-24
2015,1,VI,7,9,-2
2015,1,VT,40,38,2
2015,1,WA,539,516,23
2015,1,WI,112,120,-8
2015,1,WV,133,141,-8
2015,1,WY,17,19,-2
2015,2,AK,36,36,0
2015,2,AL,532,504,28
2015,2,AR,145,153,-8
2015,2,AZ,285,266,19
2015,2,CA,3317,3115,202
2015,2,CO,205,193,12
2015,2,CT,419,427,-8
2015,2,DC,30,40,-10
2015,2,DE,267,256,11
2015,2,FL,20660,21737,-1077
2015,2,GA,978,997,-19
2015,2,HI,1360,1338,22
2015,2,IA,117,112,5
2015,2,ID,41,42,-1
2015,2,IL,308,306,2
2015,2,IN,240,214,26
2015,2,KS,105,98,7
2015,2,KY,170,162,8
2015,2,LA,4865,4925,-60
2015,2,MA,559,524,35
2015,2,MD,836,842,-6
2015,2,ME,124,116,8
2015,2,MI,166,152,14
2015,2,MN,75,82,-7
2015,2,MO,180,171,9
2015,2,MS,723,742,-19
2015,2,MT,53,59,-6
2015,2,NC,1560,1581,-21
2015,2,ND,452,146,306
2015,2,NE,69,73,-4
2015,2,NH,94,96,-2
2015,2,NJ,2235,2270,-35
2015,2,NM,106,109,-3
2015,2,NV,146,143,3
2015,2,NY,2962,2876,86
2015,2,OH,407,423,-16
2015,2,OK,151,162,-11
2015,2,OR,353,369,-16
2015,2,PA,811,790,21
2015,2,PR,39,46,-7
2015,2,RI,313,318,-5
2015,2,SC,2309,2272,37
2015,2,SD,44,42,2
2015,2,TN,271,279,-8
2015,2,TX,5381,5502,-121
2015,2,UT,39,37,2
2015,2,VA,1399,1556,-157
2015,2,VI,6,8,-2
2015,2,VT,40,48,-8
2015,2,WA,667,613,54
2015,2,WI,222,150,72
2015,2,WV,143,151,-8
2015,2,WY,12,13,-1
2015,3,AK,34,34,0
2015,3,AL,446,448,-2
2015,3,AR,132,121,11
2015,3,AZ,251,236,15
2015,3,CA,2499,2525,-26
2015,3,CO,196,187,9
2015,3,CT,338,339,-1
2015,3,DC,23,24,-1
2015,3,DE,363,363,0
2015,3,FL,17172,18574,-1402
2015,3,GA,817,795,22
2015,3,HI,609,587,22
2015,3,IA,91,86,5
2015,3,ID,44,47,-3
2015,3,IL,258,266,-8
2015,3,IN,174,164,10
2015,3,KS,87,88,-1
2015,3,KY,155,159,-4
2015,3,LA,3970,4010,-40
2015,3,MA,555,501,54
2015,3,MD,831,813,18
2015,3,ME,51,59,-8
2015,3,MI,145,147,-2
2015,3,MN,67,72,-5
2015,3,MO,159,165,-6
2015,3,MS,644,662,-18
2015,3,MT,39,40,-1
2015,3,NC,1493,1503,-10
2015,3,ND,181,76,105
2015,3,NE,55,54,1
2015,3,NH,51,48,3
2015,3,NJ,1998,2060,-62
2015,3,NM,88,88,0
2015,3,NV,113,118,-5
2015,3,NY,1902,1923,-21
2015,3,OH,296,294,2
2015,3,OK,125,142,-17
2015,3,OR,327,331,-4
2015,3,PA,891,895,-4
2015,3,PR,29,31,-2
2015,3,RI,102,96,6
2015,3,SC,1781,1742,39
2015,3,SD,28,30,-2
2015,3,TN,226,236,-10
2015,3,TX,4756,4852,-96
2015,3,UT,34,28,6
2015,3,VA,883,905,-22
2015,3,VI,23,20,3
2015,3,VT,27,29,-2
2015,3,WA,404,426,-22
2015,3,WI,82,81,1
2015,3,WV,106,111,-5
2015,3,WY,14,16,-2
2015,4,AK,37,32,5
2015,4,AL,474,472,2
2015,4,AR,121,140,-19
2015,4,AZ,306,308,-2
2015,4,CA,2919,3017,-98
2015,4,CO,222,201,21
2015,4,CT,399,402,-3
2015,4,DC,47,47,0
2015,4,DE,269,269,0
2015,4,FL,21236,24113,-2877
2015,4,GA,967,987,-20
2015,4,GU,1,1,0
2015,4,HI,529,538,-9
2015,4,IA,115,115,0
2015,4,ID,57,59,-2
2015,4,IL,373,387,-14
2015,4,IN,236,211,25
2015,4,KS,103,116,-13
2015,4,KY,155,162,-7
2015,4,LA,5323,5503,-180
2015,4,MA,537,519,18
2015,4,MD,772,783,-11
2015,4,ME,108,99,9
2015,4,MI,167,161,6
2015,4,MN,75,78,-3
2015,4,MO,181,190,-9
2015,4,MS,722,735,-13
2015,4,MT,58,62,-4
2015,4,NC,1378,1423,-45
2015,4,ND,153,97,56
2015,4,NE,97,89,8
2015,4,NH,67,66,1
2015,4,NJ,2365,2423,-58
2015,4,NM,121,131,-10
2015,4,NV,177,177,0
2015,4,NY,2005,2033,-28
2015,4,OH,288,283,5
2015,4,OK,131,141,-10
2015,4,OR,379,385,-6
2015,4,PA,752,752,0
2015,4,PR,345,373,-28
2015,4,RI,126,128,-2
2015,4,SC,2216,2231,-15
2015,4,SD,49,50,-1
2015,4,TN,277,290,-13
2015,4,TX,5510,5798,-288
2015,4,UT,41,36,5
2015,4,VA,1136,1151,-15
2015,4,VI,9,10,-1
2015,4,VT,35,37,-2
2015,4,WA,480,481,-1
2015,4,WI,103,96,7
2015,4,WV,118,136,-18
2015,4,WY,15,16,-1
2015,5,AK,22,23,-1
2015,5,AL,1148,1124,24
2015,5,AR,212,220,-8
2015,5,AZ,342,329,13
2015,5,CA,3739,3816,-77
2015,5,CO,256,253,3
2015,5,CT,339,337,2
2015,5,DC,39,40,-1
2015,5,DE,210,207,3
2015,5,FL,20507,21347,-840
2015,5,GA,946,939,7
2015,5,HI,1781,1766,15
2015,5,IA,140,133,7
2015,5,ID,92,94,-2
2015,5,IL,362,387,-25
2015,5,IN,264,249,15
2015,5,KS,118,113,5
2015,5,KY,208,204,4
2015,5,LA,4562,4611,-49
2015,5,MA,587,564,23
2015,5,MD,597,574,23
2015,5,ME,119,118,1
2015,5,MI,182,177,5
2015,5,MN,118,128,-10
2015,5,MO,178,186,-8
2015,5,MS,1172,1184,-12
2015,5,MT,60,56,4
2015,5,NC,1297,1323,-26
2015,5,ND,216,114,102
2015,5,NE,67,71,-4
2015,5,NH,74,77,-3
2015,5,NJ,2532,2573,-41
2015,5,NM,103,100,3
2015,5,NV,167,173,-6
2015,5,NY,2700,2691,9
2015,5,OH,391,390,1
2015,5,OK,131,140,-9
2015,5,OR,565,573,-8
2015,5,PA,996,1007,-11
2015,5,PR,20,24,-4
2015,5,RI,130,129,1
2015,5,SC,1932,1912,20
2015,5,SD,56,57,-1
2015,5,TN,297,303,-6
2015,5,TX,6469,6633,-164
2015,5,UT,45,45,0
2015,5,VA,1027,1017,10
2015,5,VI,3,6,-3
2015,5,VT,44,48,-4
2015,5,WA,530,512,18
2015,5,WI,114,120,-6
2015,5,WV,198,209,-11
2015,5,WY,18,18,0
2015,6,AK,43,36,7
2015,6,AL,775,735,40
2015,6,AR,142,156,-14
2015,6,AZ,357,344,13
2015,6,CA,3802,3948,-146
2015,6,CO,226,224,2
2015,6,CT,303,307,-4
2015,6,DC,34,39,-5
2015,6,DE,282,295,-13
2015,6,FL,20515,21527,-1012
2015,6,GA,961,993,-32
2015,6,HI,986,976,10
2015,6,IA,135,143,-8
2015,6,ID,95,101,-6
2015,6,IL,395,421,-26
2015,6,IN,290,291,-1
2015,6,KS,129,129,0
2015,6,KY,194,198,-4
2015,6,LA,5207,5360,-153
2015,6,MA,849,821,28
2015,6,MD,550,532,18
2015,6,ME,82,85,-3
2015,6,MI,199,193,6
2015,6,MN,127,130,-3
2015,6,MO,199,215,-16
2015,6,MS,870,894,-24
2015,6,MT,80,84,-4
2015,6,NC,1450,1487,-37
2015,6,ND,471,164,307
2015,6,NE,89,99,-10
2015,6,NH,93,85,8
2015,6,NJ,2190,2223,-33
2015,6,NM,115,105,10
2015,6,NV,207,210,-3
2015,6,NY,2400,2398,2
2015,6,OH,406,429,-23
2015,6,OK,145,148,-3
2015,6,OR,366,387,-21
2015,6,PA,853,865,-12
2015,6,PR,47,67,-20
2015,6,RI,140,148,-8
2015,6,SC,2032,2006,26
2015,6,SD,38,41,-3
2015,6,TN,322,323,-1
2015,6,TX,5982,6181,-199
2015,6,UN,1,1,0
2015,6,UT,123,120,3
2015,6,VA,1128,1115,13
2015,6,VI,2,4,-2
2015,6,VT,40,40,0
2015,6,WA,542,551,-9
2015,6,WI,137,140,-3
2015,6,WV,199,215,-16
2015,6,WY,23,21,2
2015,7,AK,27,29,-2
2015,7,AL,760,740,20
2015,7,AR,176,183,-7
2015,7,AZ,311,310,1
2015,7,CA,2955,3050,-95
2015,7,CO,186,201,-15
2015,7,CT,327,319,8
2015,7,DC,33,32,1
2015,7,DE,249,241,8
2015,7,FL,21995,22610,-615
2015,7,GA,1013,1044,-31
2015,7,HI,332,323,9
2015,7,IA,146,154,-8
2015,7,ID,89,87,2
2015,7,IL,706,715,-9
2015,7,IN,251,248,3
2015,7,KS,85,89,-4
2015,7,KY,238,237,1
2015,7,LA,5354,5470,-116
2015,7,MA,616,447,169
2015,7,MD,772,774,-2
2015,7,ME,93,86,7
2015,7,MI,208,214,-6
2015,7,MN,136,152,-16
2015,7,MO,194,194,0
2015,7,MS,844,882,-38
2015,7,MT,70,66,4
2015,7,NC,1510,1582,-72
2015,7,ND,238,225,13
2015,7,NE,118,121,-3
2015,7,NH,84,81,3
2015,7,NJ,2094,2124,-30
2015,7,NM,101,105,-4
2015,7,NV,195,202,-7
2015,7,NY,2848,2832,16
2015,7,OH,508,521,-13
2015,7,OK,159,155,4
2015,7,OR,337,348,-11
2015,7,PA,1051,1040,11
2015,7,PR,34,52,-18
2015,7,RI,112,109,3
2015,7,SC,1896,1987,-91
2015,7,SD,57,60,-3
2015,7,TN,281,300,-19
2015,7,TX,6224,6429,-205
2015,7,UT,66,68,-2
2015,7,VA,1136,1157,-21
2015,7,VI,49,49,0
2015,7,VT,39,36,3
2015,7,WA,516,516,0
2015,7,WI,128,131,-3
2015,7,WV,184,194,-10
2015,7,WY,21,24,-3
2015,8,AK,37,42,-5
2015,8,AL,564,578,-14
2015,8,AR,159,158,1
2015,8,AZ,375,372,3
2015,8,CA,3193,3342,-149
2015,8,CO,251,253,-2
2015,8,CT,366,376,-10
2015,8,DC,42,40,2
2015,8,DE,262,257,5
2015,8,FL,26383,28312,-1929
2015,8,GA,1436,1470,-34
2015,8,HI,2162,2158,4
2015,8,IA,220,234,-14
2015,8,ID,94,95,-1
2015,8,IL,424,450,-26
2015,8,IN,332,323,9
2015,8,KS,117,117,0
2015,8,KY,226,238,-12
2015,8,LA,7611,7732,-121
2015,8,MA,552,499,53
2015,8,MD,996,1003,-7
2015,8,ME,96,102,-6
2015,8,MI,256,351,-95
2015,8,MN,182,200,-18
2015,8,MO,223,244,-21
2015,8,MS,1123,1179,-56
2015,8,MT,102,102,0
2015,8,NC,1983,2009,-26
2015,8,ND,316,336,-20
2015,8,NE,106,106,0
2015,8,NH,94,95,-1
2015,8,NJ,2504,2563,-59
2015,8,NM,104,107,-3
2015,8,NV,321,336,-15
2015,8,NY,2772,2789,-17
2015,8,OH,421,426,-5
2015,8,OK,187,196,-9
2015,8,OR,457,460,-3
2015,8,PA,1092,1097,-5
2015,8,PR,44,63,-19
2015,8,RI,361,358,3
2015,8,SC,2511,2481,30
2015,8,SD,83,84,-1
2015,8,TN,434,455,-21
2015,8,TX,7964,8163,-199
2015,8,UT,87,84,3
2015,8,VA,1503,1572,-69
2015,8,VI,9,9,0
2015,8,VT,40,36,4
2015,8,WA,508,535,-27
2015,8,WI,141,140,1
2015,8,WV,213,219,-6
2015,8,WY,29,33,-4
2015,9,AK,35,34,1
2015,9,AL,629,640,-11
2015,9,AR,172,182,-10
2015,9,AZ,324,325,-1
2015,9,CA,2905,2934,-29
2015,9,CO,343,313,30
2015,9,CT,474,487,-13
2015,9,DC,41,45,-4
2015,9,DE,256,257,-1
2015,9,FL,26555,28931,-2376
2015,9,GA,1337,1343,-6
2015,9,GU,2,2,0
2015,9,HI,569,563,6
2015,9,IA,222,232,-10
2015,9,ID,143,151,-8
2015,9,IL,531,553,-22
2015,9,IN,291,281,10
2015,9,KS,113,120,-7
2015,9,KY,244,260,-16
2015,9,LA,5971,6058,-87
2015,9,MA,493,520,-27
2015,9,MD,877,881,-4
2015,9,ME,115,119,-4
2015,9,MI,229,237,-8
2015,9,MN,282,337,-55
2015,9,MO,228,236,-8
2015,9,MS,1164,1185,-21
2015,9,MT,83,85,-2
2015,9,NC,1871,1903,-32
2015,9,ND,551,575,-24
2015,9,NE,106,117,-11
2015,9,NH,59,57,2
2015,9,NJ,2562,2593,-31
2015,9,NM,134,127,7
2015,9,NV,214,217,-3
2015,9,NY,2641,2527,114
2015,9,OH,390,398,-8
2015,9,OK,202,211,-9
2015,9,OR,334,338,-4
2015,9,PA,946,969,-23
2015,9,PR,30,33,-3
2015,9,RI,190,192,-2
2015,9,SC,2571,2539,32
2015,9,SD,61,69,-8
2015,9,TN,467,491,-24
2015,9,TX,6411,6519,-108
2015,9,UT,51,56,-5
2015,9,VA,1354,1362,-8
2015,9,VI,6,8,-2
2015,9,VT,59,67,-8
2015,9,WA,563,561,2
2015,9,WI,171,188,-17
2015,9,WV,190,192,-2
2015,9,WY,24,26,-2
2015,10,AK,28,31,-3
2015,10,AL,563,541,22
2015,10,AR,151,157,-6
2015,10,AZ,264,243,21
2015,10,CA,2802,2827,-25
2015,10,CO,284,294,-10
2015,10,CT,394,405,-11
2015,10,DC,30,28,2
2015,10,DE,258,262,-4
2015,10,FL,22815,23868,-1053
2015,10,GA,1051,1081,-30
2015,10,HI,765,768,-3
2015,10,IA,261,273,-12
2015,10,ID,100,99,1
2015,10,IL,582,620,-38
2015,10,IN,331,333,-2
2015,10,KS,125,132,-7
2015,10,KY,228,236,-8
2015,10,LA,5822,5921,-99
2015,10,MA,580,520,60
2015,10,MD,591,603,-12
2015,10,ME,114,111,3
2015,10,MI,215,238,-23
2015,10,MN,297,328,-31
2015,10,MO,225,228,-3
2015,10,MS,963,991,-28
2015,10,MT,98,99,-1
2015,10,NC,1623,1660,-37
2015,10,ND,613,655,-42
2015,10,NE,88,100,-12
2015,10,NH,141,143,-2
2015,10,NJ,1916,1968,-52
2015,10,NM,121,119,2
2015,10,NV,253,253,0
2015,10,NY,3078,2906,172
2015,10,OH,462,486,-24
2015,10,OK,197,201,-4
2015,10,OR,314,315,-1
2015,10,PA,890,929,-39
2015,10,PR,32,39,-7
2015,10,RI,127,127,0
2015,10,SC,2814,2756,58
2015,10,SD,61,67,-6
2015,10,TN,415,435,-20
2015,10,TX,6257,6552,-295
2015,10,UT,62,66,-4
2015,10,VA,1260,1249,11
2015,10,VI,12,13,-1
2015,10,VT,48,45,3
2015,10,WA,535,545,-10
2015,10,WI,168,177,-9
2015,10,WV,189,201,-12
2015,10,WY,32,31,1
2015,11,AK,31,33,-2
2015,11,AL,599,592,7
2015,11,AR,165,169,-4
2015,11,AZ,267,269,-2
2015,11,CA,2295,2335,-40
2015,11,CO,256,274,-18
2015,11,CT,431,408,23
2015,11,DC,36,33,3
2015,11,DE,1005,993,12
2015,11,FL,23273,24605,-1332
2015,11,GA,1094,1095,-1
2015,11,GU,1,0,1
2015,11,HI,1195,1195,0
2015,11,IA,250,271,-21
2015,11,ID,101,101,0
2015,11,IL,526,608,-82
2015,11,IN,340,356,-16
2015,11,KS,129,128,1
2015,11,KY,247,238,9
2015,11,LA,6426,6645,-219
2015,11,MA,864,666,198
2015,11,MD,1254,1253,1
2015,11,ME,115,106,9
2015,11,MI,285,374,-89
2015,11,MN,370,417,-47
2015,11,MO,236,250,-14
2015,11,MS,1147,1174,-27
2015,11,MT,99,110,-11
2015,11,NC,1555,1581,-26
2015,11,ND,622,655,-33
2015,11,NE,103,103,0
2015,11,NH,96,74,22
2015,11,NJ,2155,2235,-80
2015,11,NM,139,132,7
2015,11,NV,164,178,-14
2015,11,NY,2183,2199,-16
2015,11,OH,424,444,-20
2015,11,OK,186,210,-24
2015,11,OR,358,374,-16
2015,11,PA,973,984,-11
2015,11,PR,38,42,-4
2015,11,RI,160,105,55
2015,11,SC,2687,2658,29
2015,11,SD,104,114,-10
2015,11,TN,444,468,-24
2015,11,TX,6439,6572,-133
2015,11,UT,61,65,-4
2015,11,VA,1304,1239,65
2015,11,VI,27,29,-2
2015,11,VT,58,56,2
2015,11,WA,436,456,-20
2015,11,WI,174,204,-30
2015,11,WV,193,196,-3
2015,11,WY,24,26,-2
2015,12,AK,26,28,-2
2015,12,AL,863,856,7
2015,12,AR,207,224,-17
2015,12,AZ,293,284,9
2015,12,CA,2883,2931,-48
2015,12,CO,375,323,52
2015,12,CT,394,395,-1
2015,12,DC,32,25,7
2015,12,DE,311,309,2
2015,12,FL,24820,26592,-1772
2015,12,GA,1204,1236,-32
2015,12,HI,605,220,385
2015,12,IA,361,415,-54
2015,12,ID,127,130,-3
2015,12,IL,696,780,-84
2015,12,IN,326,326,0
2015,12,KS,131,133,-2
2015,12,KY,271,277,-6
2015,12,LA,7237,7328,-91
2015,12,MA,687,527,160
2015,12,MD,1010,1031,-21
2015,12,ME,113,102,11
2015,12,MI,298,398,-100
2015,12,MN,402,532,-130
2015,12,MO,375,290,85
2015,12,MS,1264,1339,-75
2015,12,MT,121,135,-14
2015,12,NC,1880,1891,-11
2015,12,ND,654,704,-50
2015,12,NE,146,150,-4
2015,12,NH,107,77,30
2015,12,NJ,2067,2126,-59
2015,12,NM,127,124,3
2015,12,NV,151,165,-14
2015,12,NY,2654,2601,53
2015,12,OH,462,456,6
2015,12,OK,189,210,-21
2015,12,OR,284,304,-20
2015,12,PA,1264,1250,14
2015,12,PR,45,73,-28
2015,12,RI,151,143,8
2015,12,SC,2486,2473,13
2015,12,SD,134,154,-20
2015,12,TN,454,444,10
2015,12,TX,7611,7848,-237
2015,12,UT,70,70,0
2015,12,VA,2191,2177,14
2015,12,VI,9,10,-1
2015,12,VT,49,46,3
2015,12,WA,450,462,-12
2015,12,WI,213,253,-40
2015,12,WV,212,221,-9
2015,12,WY,28,30,-2
2015,13,AK,34,35,-1
2015,13,AL,851,854,-3
2015,13,AR,243,257,-14
2015,13,AZ,329,309,20
2015,13,CA,2287,2440,-153
2015,13,CO,339,362,-23
2015,13,CT,431,422,9
2015,13,DC,40,34,6
2015,13,DE,269,272,-3
2015,13,FL,34073,37032,-2959
2015,13,GA,1587,1590,-3
2015,13,GU,2,0,2
2015,13,HI,474,493,-19
2015,13,IA,288,352,-64
2015,13,ID,91,111,-20
2015,13,IL,907,996,-89
2015,13,IN,327,355,-28
2015,13,KS,159,172,-13
2015,13,KY,287,263,24
2015,13,LA,7767,8079,-312
2015,13,MA,753,644,109
2015,13,MD,1022,1035,-13
2015,13,ME,144,150,-6
2015,13,MI,277,323,-46
2015,13,MN,487,699,-212
2015,13,MO,344,368,-24
2015,13,MS,1144,1213,-69
2015,13,MT,131,203,-72
2015,13,NC,2324,2394,-70
2015,13,ND,532,588,-56
2015,13,NE,138,152,-14
2015,13,NH,130,120,10
2015,13,NJ,2550,2631,-81
2015,13,NM,171,173,-2
2015,13,NV,143,156,-13
2015,13,NY,3036,3021,15
2015,13,OH,499,511,-12
2015,13,OK,214,212,2
2015,13,OR,924,709,215
2015,13,PA,968,1000,-32
2015,13,PR,35,68,-33
2015,13,RI,141,138,3
2015,13,SC,3505,3474,31
2015,13,SD,109,128,-19
2015,13,TN,698,739,-41
2015,13,TX,8937,9374,-437
2015,13,UN,2,2,0
2015,13,UT,91,97,-6
2015,13,VA,1397,1401,-4
2015,13,VI,4,4,0
2015,13,VT,49,48,1
2015,13,WA,437,464,-27
2015,13,WI,239,305,-66
2015,13,WV,269,271,-2
2015,13,WY,40,47,-7
2015,14,AK,34,37,-3
2015,14,AL,574,627,-53
2015,14,AR,198,208,-10
2015,14,AZ,303,327,-24
2015,14,CA,1988,2196,-208
2015,14,CO,319,369,-50
2015,14,CT,402,408,-6
2015,14,DC,20,17,3
2015,14,DE,270,288,-18
2015,14,FL,25079,27471,-2392
2015,14,GA,1031,1106,-75
2015,14,GU,1,1,0
2015,14,HI,512,506,6
2015,14,IA,295,358,-63
2015,14,ID,71,87,-16
2015,14,IL,478,561,-83
2015,14,IN,305,313,-8
2015,14,KS,151,156,-5
2015,14,KY,252,257,-5
2015,14,LA,6530,6877,-347
2015,14,MA,494,465,29
2015,14,MD,751,786,-35
2015,14,ME,151,160,-9
2015,14,MI,234,273,-39
2015,14,MN,396,577,-181
2015,14,MO,290,320,-30
2015,14,MS,1117,1234,-117
2015,14,MT,142,254,-112
2015,14,NC,1690,1797,-107
2015,14,ND,447,547,-100
2015,14,NE,86,114,-28
2015,14,NH,103,106,-3
2015,14,NJ,2021,2120,-99
2015,14,NM,118,117,1
2015,14,NV,125,131,-6
2015,14,NY,2439,2504,-65
2015,14,OH,426,487,-61
2015,14,OK,186,203,-17
2015,14,OR,279,300,-21
2015,14,PA,822,847,-25
2015,14,PR,37,128,-91
2015,14,RI,204,197,7
2015,14,SC,2499,2572,-73
2015,14,SD,82,108,-26
2015,14,TN,389,414,-25
2015,14,TX,6720,7195,-475
2015,14,UT,55,63,-8
2015,14,VA,1145,1174,-29
2015,14,VI,6,5,1
2015,14,VT,47,50,-3
2015,14,WA,365,401,-36
2015,14,WI,234,328,-94
2015,14,WV,190,208,-18
2015,14,WY,41,54,-13
2015,15,AK,43,51,-8
2015,15,AL,1095,1112,-17
2015,15,AR,175,188,-13
2015,15,AZ,296,294,2
2015,15,CA,2182,2370,-188
2015,15,CO,386,436,-50
2015,15,CT,400,404,-4
2015,15,DC,18,16,2
2015,15,DE,309,304,5
2015,15,FL,29537,32546,-3009
2015,15,GA,1213,1290,-77
2015,15,GU,1,1,0
2015,15,HI,541,556,-15
2015,15,IA,249,291,-42
2015,15,ID,84,88,-4
2015,15,IL,546,621,-75
2015,15,IN,318,329,-11
2015,15,KS,141,153,-12
2015,15,KY,250,273,-23
2015,15,LA,7648,8102,-454
2015,15,MA,548,574,-26
2015,15,MD,687,713,-26
2015,15,ME,131,147,-16
2015,15,MI,260,266,-6
2015,15,MN,229,306,-77
2015,15,MO,302,337,-35
2015,15,MS,1192,1315,-123
2015,15,MT,87,151,-64
2015,15,NC,1858,1915,-57
2015,15,ND,390,411,-21
2015,15,NE,108,134,-26
2015,15,NH,91,93,-2
2015,15,NJ,2328,2400,-72
2015,15,NM,141,138,3
2015,15,NV,122,133,-11
2015,15,NY,2139,2279,-140
2015,15,OH,403,449,-46
2015,15,OK,217,241,-24
2015,15,OR,332,360,-28
2015,15,PA,696,756,-60
2015,15,PR,35,56,-21
2015,15,RI,135,146,-11
2015,15,SC,2438,2497,-59
2015,15,SD,80,97,-17
2015,15,TN,435,454,-19
2015,15,TX,7849,8363,-514
2015,15,UT,54,54,0
2015,15,VA,1351,1460,-109
2015,15,VI,57,58,-1
2015,15,VT,65,70,-5
2015,15,WA,418,452,-34
2015,15,WI,216,261,-45
2015,15,WV,171,194,-23
2015,15,WY,42,53,-11
2015,16,AK,41,43,-2
2015,16,AL,664,716,-52
2015,16,AR,158,171,-13
2015,16,AZ,270,280,-10
2015,16,CA,2215,2431,-216
2015,16,CO,466,570,-104
2015,16,CT,408,426,-18
2015,16,DC,19,20,-1
2015,16,DE,290,280,10
2015,16,FL,26796,29420,-2624
2015,16,GA,1159,1242,-83
2015,16,HI,586,602,-16
2015,16,IA,219,251,-32
2015,16,ID,93,101,-8
2015,16,IL,875,957,-82
2015,16,IN,293,313,-20
2015,16,KS,163,197,-34
2015,16,KY,268,280,-12
2015,16,LA,8139,8631,-492
2015,16,MA,612,633,-21
2015,16,MD,723,769,-46
2015,16,ME,113,132,-19
2015,16,MI,226,227,-1
2015,16,MN,181,248,-67
2015,16,MO,350,367,-17
2015,16,MS,1256,1372,-116
2015,16,MT,105,182,-77
2015,16,NC,1891,2035,-144
2015,16,ND,267,299,-32
2015,16,NE,122,139,-17
2015,16,NH,93,100,-7
2015,16,NJ,2403,2534,-131
2015,16,NM,162,165,-3
2015,16,NV,127,141,-14
2015,16,NY,2805,2906,-101
2015,16,OH,449,470,-21
2015,16,OK,222,234,-12
2015,16,OR,275,296,-21
2015,16,PA,752,816,-64
2015,16,PR,37,70,-33
2015,16,RI,184,196,-12
2015,16,SC,2846,2930,-84
2015,16,SD,50,57,-7
2015,16,TN,391,412,-21
2015,16,TX,8624,9162,-538
2015,16,UT,66,71,-5
2015,16,VA,1317,1400,-83
2015,16,VI,11,13,-2
2015,16,VT,45,49,-4
2015,16,WA,410,469,-59
2015,16,WI,226,263,-37
2015,16,WV,190,204,-14
2015,16,WY,45,67,-22
2015,17,AK,44,46,-2
2015,17,AL,1525,1563,-38
2015,17,AR,181,200,-19
2015,17,AZ,390,407,-17
2015,17,CA,2412,2829,-417
2015,17,CO,416,498,-82
2015,17,CT,446,475,-29
2015,17,DC,36,35,1
2015,17,DE,399,378,21
2015,17,FL,43867,46486,-2619
2015,17,GA,1609,1717,-108
2015,17,GU,1,1,0
2015,17,HI,2705,2790,-85
2015,17,IA,186,196,-10
2015,17,ID,642,659,-17
2015,17,IL,580,652,-72
2015,17,IN,328,323,5
2015,17,KS,179,201,-22
2015,17,KY,243,266,-23
2015,17,LA,10544,11142,-598
2015,17,MA,730,761,-31
2015,17,MD,862,945,-83
2015,17,ME,146,167,-21
2015,17,MI,260,265,-5
2015,17,MN,162,192,-30
2015,17,MO,334,429,-95
2015,17,MS,1434,1572,-138
2015,17,MT,89,168,-79
2015,17,NC,2559,2721,-162
2015,17,ND,175,176,-1
2015,17,NE,116,135,-19
2015,17,NH,103,114,-11
2015,17,NJ,3139,3333,-194
2015,17,NM,159,163,-4
2015,17,NV,147,159,-12
2015,17,NY,2569,2579,-10
2015,17,OH,431,459,-28
2015,17,OK,212,243,-31
2015,17,OR,615,695,-80
2015,17,PA,854,923,-69
2015,17,PR,51,92,-41
2015,17,RI,160,171,-11
2015,17,SC,3535,4140,-605
2015,17,SD,61,65,-4
2015,17,TN,425,459,-34
2015,17,TX,10992,11729,-737
2015,17,UT,70,72,-2
2015,17,VA,1699,1796,-97
2015,17,VI,7,10,-3
2015,17,VT,52,63,-11
2015,17,WA,469,506,-37
2015,17,WI,187,218,-31
2015,17,WV,194,209,-15
2015,17,WY,39,41,-2
2015,18,AK,30,36,-6
2015,18,AL,741,771,-30
2015,18,AR,191,208,-17
2015,18,AZ,275,265,10
2015,18,CA,1986,2143,-157
2015,18,CO,507,547,-40
2015,18,CT,337,361,-24
2015,18,DC,24,30,-6
2015,18,DE,310,300,10
2015,18,FL,26547,29089,-2542
2015,18,GA,1101,1176,-75
2015,18,HI,331,336,-5
2015,18,IA,141,152,-11
2015,18,ID,93,103,-10
2015,18,IL,423,469,-46
2015,18,IN,274,298,-24
2015,18,KS,125,126,-1
2015,18,KY,252,247,5
2015,18,LA,7741,8251,-510
2015,18,MA,649,677,-28
2015,18,MD,697,683,14
2015,18,ME,67,79,-12
2015,18,MI,191,216,-25
2015,18,MN,123,151,-28
2015,18,MO,252,275,-23
2015,18,MS,1193,1306,-113
2015,18,MT,86,131,-45
2015,18,NC,1744,1880,-136
2015,18,ND,105,109,-4
2015,18,NE,97,107,-10
2015,18,NH,89,83,6
2015,18,NJ,2124,2245,-121
2015,18,NM,117,127,-10
2015,18,NV,100,114,-14
2015,18,NY,2433,2512,-79
2015,18,OH,326,353,-27
2015,18,OK,219,230,-11
2015,18,OR,271,284,-13
2015,18,PA,675,729,-54
2015,18,PR,32,68,-36
2015,18,RI,134,140,-6
2015,18,SC,2226,2412,-186
2015,18,SD,62,65,-3
2015,18,TN,294,309,-15
2015,18,TX,8030,8662,-632
2015,18,UN,1,1,0
2015,18,UT,141,147,-6
2015,18,VA,1201,1325,-124
2015,18,VI,15,16,-1
2015,18,VT,59,60,-1
2015,18,WA,377,395,-18
2015,18,WI,132,157,-25
2015,18,WV,144,161,-17
2015,18,WY,35,54,-19
2015,19,AK,52,57,-5
2015,19,AL,822,837,-15
2015,19,AR,160,169,-9
2015,19,AZ,293,298,-5
2015,19,CA,2008,2164,-156
2015,19,CO,439,508,-69
2015,19,CT,384,433,-49
2015,19,DC,31,31,0
2015,19,DE,383,315,68
2015,19,FL,28857,31535,-2678
2015,19,GA,1263,1340,-77
2015,19,HI,876,885,-9
2015,19,IA,140,164,-24
2015,19,ID,81,89,-8
2015,19,IL,545,565,-20
2015,19,IN,263,250,13
2015,19,KS,142,148,-6
2015,19,KY,252,244,8
2015,19,LA,8209,8661,-452
2015,19,MA,540,569,-29
2015,19,MD,656,686,-30
2015,19,ME,100,106,-6
2015,19,MI,289,282,7
2015,19,MN,122,145,-23
2015,19,MO,280,282,-2
2015,19,MS,1239,1288,-49
2015,19,MT,87,145,-58
2015,19,NC,1961,2044,-83
2015,19,ND,127,136,-9
2015,19,NE,84,93,-9
2015,19,NH,83,93,-10
2015,19,NJ,2409,2521,-112
2015,19,NM,103,118,-15
2015,19,NV,109,113,-4
2015,19,NY,3445,3558,-113
2015,19,OH,355,403,-48
2015,19,OK,202,220,-18
2015,19,OR,270,293,-23
2015,19,PA,719,752,-33
2015,19,PR,38,57,-19
2015,19,RI,139,144,-5
2015,19,SC,3008,3065,-57
2015,19,SD,52,62,-10
2015,19,TN,329,342,-13
2015,19,TX,9242,9859,-617
2015,19,UT,55,59,-4
2015,19,VA,1520,1625,-105
2015,19,VI,6,5,1
2015,19,VT,49,42,7
2015,19,WA,326,339,-13
2015,19,WI,152,178,-26
2015,19,WV,164,186,-22
2015,19,WY,42,46,-4
2015,20,AK,30,37,-7
2015,20,AL,816,858,-42
2015,20,AR,168,181,-13
2015,20,AZ,285,295,-10
2015,20,CA,1950,2138,-188
2015,20,CO,486,533,-47
2015,20,CT,388,414,-26
2015,20,DC,20,27,-7
2015,20,DE,329,303,26
2015,20,FL,29033,31715,-2682
2015,20,GA,1310,1378,-68
2015,20,GU,1,1,0
2015,20,HI,408,418,-10
2015,20,IA,242,243,-1
2015,20,ID,80,85,-5
2015,20,IL,556,631,-75
2015,20,IN,277,282,-5
2015,20,KS,139,136,3
2015,20,KY,251,252,-1
2015,20,LA,8704,9184,-480
2015,20,MA,533,564,-31
2015,20,MD,670,715,-45
2015,20,ME,80,89,-9
2015,20,MI,195,208,-13
2015,20,MN,109,125,-16
2015,20,MO,268,305,-37
2015,20,MS,1324,1474,-150
2015,20,MT,102,131,-29
2015,20,NC,2132,2236,-104
2015,20,ND,93,102,-9
2015,20,NE,90,95,-5
2015,20,NH,87,90,-3
2015,20,NJ,2750,2754,-4
2015,20,NM,144,145,-1
2015,20,NV,134,143,-9
2015,20,NY,2312,2334,-22
2015,20,OH,306,334,-28
2015,20,OK,217,240,-23
2015,20,OR,271,304,-33
2015,20,PA,855,903,-48
2015,20,PR,44,61,-17
2015,20,RI,148,157,-9
2015,20,SC,3118,3390,-272
2015,20,SD,77,82,-5
2015,20,TN,318,330,-12
2015,20,TX,10537,10818,-281
2015,20,UN,1,1,0
2015,20,UT,49,65,-16
2015,20,VA,1550,1639,-89
2015,20,VI,9,9,0
2015,20,VT,38,39,-1
2015,20,WA,370,400,-30
2015,20,WI,164,174,-10
2015,20,WV,136,157,-21
2015,20,WY,38,48,-10
2015,21,AK,31,32,-1
2015,21,AL,1027,1120,-93
2015,21,AR,216,249,-33
2015,21,AZ,331,325,6
2015,21,CA,1885,2025,-140
2015,21,CO,343,401,-58
2015,21,CT,458,481,-23
2015,21,DC,24,22,2
2015,21,DE,499,458,41
2015,21,FL,32709,36569,-3860
2015,21,GA,1455,1529,-74
2015,21,GU,2,2,0
2015,21,HI,1012,1072,-60
2015,21,IA,160,181,-21
2015,21,ID,61,73,-12
2015,21,IL,494,579,-85
2015,21,IN,295,324,-29
2015,21,KS,149,145,4
2015,21,KY,234,257,-23
2015,21,LA,10457,11040,-583
2015,21,MA,642,672,-30
2015,21,MD,995,1068,-73
2015,21,ME,116,117,-1
2015,21,MI,185,200,-15
2015,21,MN,124,143,-19
2015,21,MO,293,301,-8
2015,21,MS,1608,1798,-190
2015,21,MT,89,127,-38
2015,21,NC,2233,2381,-148
2015,21,ND,134,139,-5
2015,21,NE,123,133,-10
2015,21,NH,99,101,-2
2015,21,NJ,2839,2934,-95
2015,21,NM,131,135,-4
2015,21,NV,104,106,-2
2015,21,NY,3264,3334,-70
2015,21,OH,408,439,-31
2015,21,OK,221,224,-3
2015,21,OR,277,301,-24
2015,21,PA,774,837,-63
2015,21,PR,46,78,-32
2015,21,RI,211,227,-16
2015,21,SC,3850,3948,-98
2015,21,SD,63,75,-12
2015,21,TN,511,562,-51
2015,21,TX,13316,13940,-624
2015,21,UT,86,92,-6
2015,21,VA,1644,1763,-119
2015,21,VI,19,6,13
2015,21,VT,23,27,-4
2015,21,WA,445,464,-19
2015,21,WI,146,159,-13
2015,21,WV,143,161,-18
2015,21,WY,39,45,-6
2015,22,AK,42,44,-2
2015,22,AL,1124,1174,-50
2015,22,AR,316,373,-57
2015,22,AZ,334,335,-1
2015,22,CA,2256,2435,-179
2015,22,CO,422,442,-20
2015,22,CT,411,445,-34
2015,22,DC,35,39,-4
2015,22,DE,505,475,30
2015,22,FL,39257,42856,-3599
2015,22,GA,1817,1925,-108
2015,22,GU,1,2,-1
2015,22,HI,798,810,-12
2015,22,IA,179,187,-8
2015,22,ID,57,68,-11
2015,22,IL,595,652,-57
2015,22,IN,302,320,-18
2015,22,KS,158,166,-8
2015,22,KY,261,271,-10
2015,22,LA,10817,11642,-825
2015,22,MA,744,855,-111
2015,22,MD,856,904,-48
2015,22,ME,76,86,-10
2015,22,MI,210,204,6
2015,22,MN,114,128,-14
2015,22,MO,284,315,-31
2015,22,MS,1708,1951,-243
2015,22,MT,88,129,-41
2015,22,NC,2475,2611,-136
2015,22,ND,107,109,-2
2015,22,NE,119,116,3
2015,22,NH,85,89,-4
2015,22,NJ,3051,3177,-126
2015,22,NM,123,130,-7
2015,22,NV,123,131,-8
2015,22,NY,2550,2655,-105
2015,22,OH,421,424,-3
2015,22,OK,297,270,27
2015,22,OR,439,437,2
2015,22,PA,741,780,-39
2015,22,PR,48,61,-13
2015,22,RI,177,187,-10
2015,22,SC,4497,4631,-134
2015,22,SD,125,148,-23
2015,22,TN,782,906,-124
2015,22,TX,13235,13883,-648
2015,22,UN,1,1,0
2015,22,UT,56,74,-18
2015,22,VA,2223,2384,-161
2015,22,VI,12,11,1
2015,22,VT,29,35,-6
2015,22,WA,415,436,-21
2015,22,WI,154,171,-17
2015,22,WV,190,218,-28
2015,22,WY,48,54,-6
2015,23,AK,28,29,-1
2015,23,AL,888,955,-67
2015,23,AR,221,245,-24
2015,23,AZ,315,319,-4
2015,23,CA,2075,2162,-87
2015,23,CO,504,469,35
2015,23,CT,364,398,-34
2015,23,DC,258,264,-6
2015,23,DE,334,283,51
2015,23,FL,30317,33309,-2992
2015,23,GA,1315,1409,-94
2015,23,GU,1,1,0
2015,23,HI,1026,975,51
2015,23,IA,165,178,-13
2015,23,ID,71,70,1
2015,23,IL,693,690,3
2015,23,IN,285,302,-17
2015,23,KS,157,150,7
2015,23,KY,321,318,3
2015,23,LA,10227,10958,-731
2015,23,MA,704,748,-44
2015,23,MD,692,847,-155
2015,23,ME,103,103,0
2015,23,MI,189,193,-4
2015,23,MN,109,114,-5
2015,23,MO,293,276,17
2015,23,MS,1363,1476,-113
2015,23,MT,83,88,-5
2015,23,NC,2224,2354,-130
2015,23,ND,132,105,27
2015,23,NE,109,116,-7
2015,23,NH,82,82,0
2015,23,NJ,2261,2350,-89
2015,23,NM,100,99,1
2015,23,NV,133,149,-16
2015,23,NY,2886,2650,236
2015,23,OH,362,389,-27
2015,23,OK,325,254,71
2015,23,OR,278,301,-23
2015,23,PA,711,735,-24
2015,23,PR,46,61,-15
2015,23,RI,152,171,-19
2015,23,SC,3464,3595,-131
2015,23,SD,50,68,-18
2015,23,TN,648,732,-84
2015,23,TX,13814,13795,19
2015,23,UT,57,55,2
2015,23,VA,1759,1900,-141
2015,23,VI,18,18,0
2015,23,VT,33,32,1
2015,23,WA,306,332,-26
2015,23,WI,124,133,-9
2015,23,WV,126,153,-27
2015,23,WY,40,46,-6
2015,24,AK,36,38,-2
2015,24,AL,790,826,-36
2015,24,AR,204,212,-8
2015,24,AZ,367,330,37
2015,24,CA,2112,2226,-114
2015,24,CO,686,656,30
2015,24,CT,423,468,-45
2015,24,DC,33,41,-8
2015,24,DE,367,348,19
2015,24,FL,35819,39349,-3530
2015,24,GA,1681,1771,-90
2015,24,HI,751,763,-12
2015,24,IA,177,190,-13
2015,24,ID,66,63,3
2015,24,IL,498,539,-41
2015,24,IN,262,272,-10
2015,24,KS,177,188,-11
2015,24,KY,268,258,10
2015,24,LA,10472,11053,-581
2015,24,MA,601,629,-28
2015,24,MD,903,1002,-99
2015,24,ME,83,95,-12
2015,24,MI,234,246,-12
2015,24,MN,128,144,-16
2015,24,MO,252,258,-6
2015,24,MS,1516,1633,-117
2015,24,MT,88,105,-17
2015,24,NC,2621,2858,-237
2015,24,ND,127,118,9
2015,24,NE,106,110,-4
2015,24,NH,91,92,-1
2015,24,NJ,2507,2582,-75
2015,24,NM,143,145,-2
2015,24,NV,104,108,-4
2015,24,NY,3421,3484,-63
2015,24,OH,414,461,-47
2015,24,OK,298,251,47
2015,24,OR,273,384,-111
2015,24,PA,813,844,-31
2015,24,PR,32,55,-23
2015,24,RI,215,228,-13
2015,24,SC,3841,3981,-140
2015,24,SD,62,66,-4
2015,24,TN,599,599,0
2015,24,TX,15845,15963,-118
2015,24,UT,60,66,-6
2015,24,VA,1972,2183,-211
2015,24,VI,104,104,0
2015,24,VT,42,45,-3
2015,24,WA,351,380,-29
2015,24,WI,190,199,-9
2015,24,WV,171,187,-16
2015,24,WY,33,40,-7
2015,25,AK,31,30,1
2015,25,AL,938,978,-40
2015,25,AR,196,203,-7
2015,25,AZ,472,415,57
2015,25,CA,1908,1905,3
2015,25,CO,361,362,-1
2015,25,CT,454,484,-30
2015,25,DC,280,281,-1
2015,25,DE,362,345,17
2015,25,FL,34443,37995,-3552
2015,25,GA,1592,1717,-125
2015,25,GU,2,2,0
2015,25,HI,908,872,36
2015,25,IA,131,141,-10
2015,25,ID,72,73,-1
2015,25,IL,738,755,-17
2015,25,IN,285,285,0
2015,25,KS,172,165,7
2015,25,KY,182,192,-10
2015,25,LA,10620,11159,-539
2015,25,MA,577,613,-36
2015,25,MD,945,1019,-74
2015,25,ME,120,129,-9
2015,25,MI,222,215,7
2015,25,MN,91,102,-11
2015,25,MO,276,252,24
2015,25,MS,1418,1535,-117
2015,25,MT,179,178,1
2015,25,NC,2422,2539,-117
2015,25,ND,220,270,-50
2015,25,NE,107,120,-13
2015,25,NH,66,71,-5
2015,25,NJ,3062,3163,-101
2015,25,NM,120,121,-1
2015,25,NV,105,111,-6
2015,25,NY,2710,3109,-399
2015,25,OH,429,458,-29
2015,25,OK,289,194,95
2015,25,OR,249,259,-10
2015,25,PA,727,753,-26
2015,25,PR,43,66,-23
2015,25,RI,199,223,-24
2015,25,SC,3924,4037,-113
2015,25,SD,90,107,-17
2015,25,TN,563,613,-50
2015,25,TX,20322,17700,2622
2015,25,UT,47,50,-3
2015,25,VA,2105,2299,-194
2015,25,VI,8,9,-1
2015,25,VT,44,47,-3
2015,25,WA,325,355,-30
2015,25,WI,124,147,-23
2015,25,WV,144,161,-17
2015,25,WY,30,35,-5
2015,26,AK,31,40,-9
2015,26,AL,1111,1140,-29
2015,26,AR,180,184,-4
2015,26,AZ,451,381,70
2015,26,CA,2107,2193,-86
2015,26,CO,447,465,-18
2015,26,CT,589,617,-28
2015,26,DC,55,37,18
2015,26,DE,427,422,5
2015,26,FL,44354,48491,-4137
2015,26,GA,2144,2256,-112
2015,26,GU,1,1,0
2015,26,HI,1287,1297,-10
2015,26,IA,361,423,-62
2015,26,ID,73,66,7
2015,26,IL,602,638,-36
2015,26,IN,345,353,-8
2015,26,KS,199,214,-15
2015,26,KY,238,246,-8
2015,26,LA,13476,14235,-759
2015,26,MA,1034,1082,-48
2015,26,MD,1812,1892,-80
2015,26,ME,106,105,1
2015,26,MI,233,232,1
2015,26,MN,134,146,-12
2015,26,MO,317,333,-16
2015,26,MS,1661,1807,-146
2015,26,MT,96,106,-10
2015,26,NC,2985,3217,-232
2015,26,ND,188,220,-32
2015,26,NE,199,204,-5
2015,26,NH,134,142,-8
2015,26,NJ,3241,3362,-121
2015,26,NM,142,147,-5
2015,26,NV,146,131,15
2015,26,NY,3630,3753,-123
2015,26,OH,523,489,34
2015,26,OK,349,294,55
2015,26,OR,314,323,-9
2015,26,PA,885,933,-48
2015,26,PR,58,75,-17
2015,26,RI,233,252,-19
2015,26,SC,5248,5402,-154
2015,26,SD,153,181,-28
2015,26,TN,492,496,-4
2015,26,TX,26188,24320,1868
2015,26,UT,55,66,-11
2015,26,VA,2596,2722,-126
2015,26,VI,9,11,-2
2015,26,VT,52,60,-8
2015,26,WA,387,427,-40
2015,26,WI,143,158,-15
2015,26,WV,186,208,-22
2015,26,WY,32,40,-8
2015,27,AK,28,32,-4
2015,27,AL,1105,1136,-31
2015,27,AR,165,192,-27
2015,27,AZ,445,384,61
2015,27,CA,1871,1897,-26
2015,27,CO,375,394,-19
2015,27,CT,399,437,-38
2015,27,DC,35,32,3
2015,27,DE,352,350,2
2015,27,FL,34658,37850,-3192
2015,27,GA,1898,2008,-110
2015,27,HI,398,404,-6
2015,27,IA,227,252,-25
2015,27,ID,54,59,-5
2015,27,IL,469,488,-19
2015,27,IN,300,303,-3
2015,27,KS,164,157,7
2015,27,KY,230,250,-20
2015,27,LA,10614,11224,-610
2015,27,MA,729,749,-20
2015,27,MD,832,870,-38
2015,27,ME,111,128,-17
2015,27,MI,191,178,13
2015,27,MN,98,113,-15
2015,27,MO,277,301,-24
2015,27,MS,1367,1456,-89
2015,27,MT,73,75,-2
2015,27,NC,2511,2694,-183
2015,27,ND,66,78,-12
2015,27,NE,103,109,-6
2015,27,NH,81,86,-5
2015,27,NJ,2671,2781,-110
2015,27,NM,136,128,8
2015,27,NV,108,106,2
2015,27,NY,3122,3190,-68
2015,27,OH,403,401,2
2015,27,OK,239,242,-3
2015,27,OR,350,375,-25
2015,27,PA,688,721,-33
2015,27,PR,56,73,-17
2015,27,RI,210,223,-13
2015,27,SC,4095,4348,-253
2015,27,SD,75,72,3
2015,27,TN,414,440,-26
2015,27,TX,20430,20547,-117
2015,27,UT,58,58,0
2015,27,VA,2064,2239,-175
2015,27,VI,16,18,-2
2015,27,VT,31,36,-5
2015,27,WA,327,349,-22
2015,27,WI,128,143,-15
2015,27,WV,141,157,-16
2015,27,WY,38,33,5
2015,28,AK,36,39,-3
2015,28,AL,819,957,-138
2015,28,AR,175,184,-9
2015,28,AZ,516,518,-2
2015,28,CA,2409,2428,-19
2015,28,CO,389,316,73
2015,28,CT,476,504,-28
2015,28,DC,32,38,-6
2015,28,DE,350,366,-16
2015,28,FL,34178,37240,-3062
2015,28,GA,1882,1999,-117
2015,28,GU,1,1,0
2015,28,HI,349,358,-9
2015,28,IA,233,256,-23
2015,28,ID,45,53,-8
2015,28,IL,537,516,21
2015,28,IN,388,394,-6
2015,28,KS,222,188,34
2015,28,KY,255,244,11
2015,28,LA,10953,11246,-293
2015,28,MA,763,804,-41
2015,28,MD,5153,5029,124
2015,28,ME,108,117,-9
2015,28,MI,493,278,215
2015,28,MN,136,154,-18
2015,28,MO,283,290,-7
2015,28,MS,1302,1395,-93
2015,28,MT,90,103,-13
2015,28,NC,2966,3140,-174
2015,28,ND,95,107,-12
2015,28,NE,140,148,-8
2015,28,NH,155,162,-7
2015,28,NJ,4051,4168,-117
2015,28,NM,144,141,3
2015,28,NV,120,127,-7
2015,28,NY,2992,3154,-162
2015,28,OH,462,463,-1
2015,28,OK,289,264,25
2015,28,OR,287,305,-18
2015,28,PA,768,786,-18
2015,28,PR,54,76,-22
2015,28,RI,214,225,-11
2015,28,SC,3925,4105,-180
2015,28,SD,52,67,-15
2015,28,TN,480,498,-18
2015,28,TX,24333,22041,2292
2015,28,UT,58,51,7
2015,28,VA,2178,2332,-154
2015,28,VI,3,3,0
2015,28,VT,54,56,-2
2015,28,WA,345,368,-23
2015,28,WI,181,202,-21
2015,28,WV,170,180,-10
2015,28,WY,24,25,-1
2015,29,AK,41,40,1
2015,29,AL,1105,1158,-53
2015,29,AR,185,207,-22
2015,29,AZ,440,420,20
2015,29,CA,2010,1969,41
2015,29,CO,351,292,59
2015,29,CT,502,518,-16
2015,29,DC,28,28,0
2015,29,DE,347,345,2
2015,29,FL,31866,34765,-2899
2015,29,GA,1762,1870,-108
2015,29,HI,740,739,1
2015,29,IA,230,240,-10
2015,29,ID,59,61,-2
2015,29,IL,607,633,-26
2015,29,IN,362,370,-8
2015,29,KS,174,185,-11
2015,29,KY,260,253,7
2015,29,LA,11434,11887,-453
2015,29,MA,745,779,-34
2015,29,MD,1346,1364,-18
2015,29,ME,118,126,-8
2015,29,MI,237,237,0
2015,29,MN,157,197,-40
2015,29,MO,284,274,10
2015,29,MS,1202,1230,-28
2015,29,MT,84,103,-19
2015,29,NC,2396,2610,-214
2015,29,ND,111,103,8
2015,29,NE,112,120,-8
2015,29,NH,108,112,-4
2015,29,NJ,2546,2634,-88
2015,29,NM,128,141,-13
2015,29,NV,126,131,-5
2015,29,NY,3231,3390,-159
2015,29,OH,492,465,27
2015,29,OK,257,238,19
2015,29,OR,281,294,-13
2015,29,PA,780,805,-25
2015,29,PR,44,93,-49
2015,29,RI,208,238,-30
2015,29,SC,3677,3764,-87
2015,29,SD,67,74,-7
2015,29,TN,430,444,-14
2015,29,TX,19219,19639,-420
2015,29,UT,53,50,3
2015,29,VA,2292,2429,-137
2015,29,VI,7,8,-1
2015,29,VT,56,54,2
2015,29,WA,372,378,-6
2015,29,WI,183,211,-28
2015,29,WV,150,166,-16
2015,29,WY,24,27,-3
2015,30,AK,36,38,-2
2015,30,AL,1269,1294,-25
2015,30,AR,187,201,-14
2015,30,AZ,514,519,-5
2015,30,CA,2359,2475,-116
2015,30,CO,421,386,35
2015,30,CT,574,619,-45
2015,30,DC,57,56,1
2015,30,DE,450,460,-10
2015,30,FL,40793,45239,-4446
2015,30,GA,2160,2302,-142
2015,30,HI,726,743,-17
2015,30,IA,232,269,-37
2015,30,ID,57,60,-3
2015,30,IL,662,692,-30
2015,30,IN,412,411,1
2015,30,KS,201,221,-20
2015,30,KY,269,274,-5
2015,30,LA,11677,12214,-537
2015,30,MA,996,1062,-66
2015,30,MD,1343,1375,-32
2015,30,ME,122,131,-9
2015,30,MI,238,230,8
2015,30,MN,168,198,-30
2015,30,MO,347,397,-50
2015,30,MS,1454,1508,-54
2015,30,MT,76,85,-9
2015,30,NC,2994,3175,-181
2015,30,ND,107,132,-25
2015,30,NE,132,138,-6
2015,30,NH,142,144,-2
2015,30,NJ,3394,3519,-125
2015,30,NM,220,233,-13
2015,30,NV,183,191,-8
2015,30,NY,3383,3522,-139
2015,30,OH,532,525,7
2015,30,OK,291,294,-3
2015,30,OR,296,319,-23
2015,30,PA,957,1033,-76
2015,30,PR,71,88,-17
2015,30,RI,309,329,-20
2015,30,SC,4523,4604,-81
2015,30,SD,87,88,-1
2015,30,TN,510,562,-52
2015,30,TX,19696,20402,-706
2015,30,UT,68,70,-2
2015,30,VA,2885,3143,-258
2015,30,VI,15,14,1
2015,30,VT,54,49,5
2015,30,WA,387,428,-41
2015,30,WI,193,203,-10
2015,30,WV,170,193,-23
2015,30,WY,32,33,-1
2015,31,AK,27,38,-11
2015,31,AL,719,754,-35
2015,31,AR,175,177,-2
2015,31,AZ,446,461,-15
2015,31,CA,1950,1877,73
2015,31,CO,365,408,-43
2015,31,CT,475,498,-23
2015,31,DC,33,277,-244
2015,31,DE,315,332,-17
2015,31,FL,25785,28221,-2436
2015,31,GA,1565,1714,-149
2015,31,HI,952,966,-14
2015,31,IA,172,182,-10
2015,31,ID,74,71,3
2015,31,IL,424,446,-22
2015,31,IN,317,317,0
2015,31,KS,129,133,-4
2015,31,KY,245,242,3
2015,31,LA,7772,8246,-474
2015,31,MA,706,734,-28
2015,31,MD,1218,1255,-37
2015,31,ME,90,101,-11
2015,31,MI,160,162,-2
2015,31,MN,101,107,-6
2015,31,MO,221,205,16
2015,31,MS,1002,1045,-43
2015,31,MT,45,47,-2
2015,31,NC,2314,2512,-198
2015,31,ND,75,91,-16
2015,31,NE,72,73,-1
2015,31,NH,82,84,-2
2015,31,NJ,2227,2309,-82
2015,31,NM,153,153,0
2015,31,NV,159,146,13
2015,31,NY,2360,2505,-145
2015,31,OH,419,390,29
2015,31,OK,229,234,-5
2015,31,OR,210,242,-32
2015,31,PA,738,791,-53
2015,31,PR,54,156,-102
2015,31,RI,237,242,-5
2015,31,SC,3089,3250,-161
2015,31,SD,53,55,-2
2015,31,TN,388,415,-27
2015,31,TX,14153,14799,-646
2015,31,UT,45,51,-6
2015,31,VA,1964,2039,-75
2015,31,VI,12,15,-3
2015,31,VT,27,38,-11
2015,31,WA,280,308,-28
2015,31,WI,139,153,-14
2015,31,WV,118,129,-11
2015,31,WY,32,28,4
2015,32,AK,38,45,-7
2015,32,AL,787,848,-61
2015,32,AR,175,188,-13
2015,32,AZ,486,497,-11
2015,32,CA,2141,1932,209
2015,32,CO,459,509,-50
2015,32,CT,528,569,-41
2015,32,DC,42,39,3
2015,32,DE,455,474,-19
2015,32,FL,32484,35213,-2729
2015,32,GA,2005,2102,-97
2015,32,HI,653,666,-13
2015,32,IA,158,172,-14
2015,32,ID,61,67,-6
2015,32,IL,393,421,-28
2015,32,IN,342,318,24
2015,32,KS,167,172,-5
2015,32,KY,238,226,12
2015,32,LA,8989,9511,-522
2015,32,MA,821,877,-56
2015,32,MD,868,894,-26
2015,32,ME,114,118,-4
2015,32,MI,253,248,5
2015,32,MN,118,125,-7
2015,32,MO,450,447,3
2015,32,MS,1158,1242,-84
2015,32,MT,73,78,-5
2015,32,NC,2678,3002,-324
2015,32,ND,148,160,-12
2015,32,NE,94,104,-10
2015,32,NH,75,75,0
2015,32,NJ,3530,3620,-90
2015,32,NM,189,189,0
2015,32,NV,165,166,-1
2015,32,NY,3250,3409,-159
2015,32,OH,503,483,20
2015,32,OK,254,261,-7
2015,32,OR,302,316,-14
2015,32,PA,843,937,-94
2015,32,PR,29,36,-7
2015,32,RI,485,504,-19
2015,32,SC,4018,4089,-71
2015,32,SD,53,73,-20
2015,32,TN,471,491,-20
2015,32,TX,15279,16172,-893
2015,32,UT,50,51,-1
2015,32,VA,2276,2420,-144
2015,32,VI,21,12,9
2015,32,VT,54,55,-1
2015,32,WA,366,390,-24
2015,32,WI,182,189,-7
2015,32,WV,188,192,-4
2015,32,WY,31,28,3
2015,33,AK,24,23,1
2015,33,AL,782,829,-47
2015,33,AR,192,183,9
2015,33,AZ,534,541,-7
2015,33,CA,2304,1984,320
2015,33,CO,352,389,-37
2015,33,CT,704,753,-49
2015,33,DC,56,56,0
2015,33,DE,353,362,-9
2015,33,FL,29739,32161,-2422
2015,33,GA,1716,1906,-190
2015,33,GU,3,3,0
2015,33,HI,1559,1556,3
2015,33,IA,167,194,-27
2015,33,ID,55,62,-7
2015,33,IL,602,638,-36
2015,33,IN,328,331,-3
2015,33,KS,135,139,-4
2015,33,KY,252,240,12
2015,33,LA,8512,8958,-446
2015,33,MA,884,866,18
2015,33,MD,930,966,-36
2015,33,ME,114,116,-2
2015,33,MI,211,185,26
2015,33,MN,107,133,-26
2015,33,MO,239,236,3
2015,33,MS,1266,1320,-54
2015,33,MT,66,76,-10
2015,33,NC,2641,2792,-151
2015,33,ND,116,131,-15
2015,33,NE,97,94,3
2015,33,NH,78,82,-4
2015,33,NJ,2863,2958,-95
2015,33,NM,146,148,-2
2015,33,NV,181,176,5
2015,33,NY,3025,3283,-258
2015,33,OH,422,427,-5
2015,33,OK,198,207,-9
2015,33,OR,295,283,12
2015,33,PA,1083,1158,-75
2015,33,PR,85,106,-21
2015,33,RI,302,319,-17
2015,33,SC,3632,3743,-111
2015,33,SD,97,109,-12
2015,33,TN,448,468,-20
2015,33,TX,14541,15485,-944
2015,33,UT,51,45,6
2015,33,VA,2028,2166,-138
2015,33,VI,20,20,0
2015,33,VT,36,42,-6
2015,33,WA,351,365,-14
2015,33,WI,146,164,-18
2015,33,WV,184,202,-18
2015,33,WY,55,56,-1
2015,34,AK,39,42,-3
2015,34,AL,1034,1077,-43
2015,34,AR,208,207,1
2015,34,AZ,502,498,4
2015,34,CA,2549,2235,314
2015,34,CO,416,447,-31
2015,34,CT,512,547,-35
2015,34,DC,96,98,-2
2015,34,DE,551,569,-18
2015,34,FL,30415,33161,-2746
2015,34,GA,1765,2029,-264
2015,34,GU,1,1,0
2015,34,HI,2538,2525,13
2015,34,IA,152,173,-21
2015,34,ID,65,73,-8
2015,34,IL,452,510,-58
2015,34,IN,296,297,-1
2015,34,KS,123,134,-11
2015,34,KY,287,274,13
2015,34,LA,9292,9808,-516
2015,34,MA,1182,1233,-51
2015,34,MD,1016,1074,-58
2015,34,ME,119,135,-16
2015,34,MI,209,215,-6
2015,34,MN,104,114,-10
2015,34,MO,237,243,-6
2015,34,MS,1209,1277,-68
2015,34,MT,60,65,-5
2015,34,NC,2648,2817,-169
2015,34,ND,161,185,-24
2015,34,NE,101,104,-3
2015,34,NH,90,79,11
2015,34,NJ,2952,3082,-130
2015,34,NM,180,189,-9
2015,34,NV,166,183,-17
2015,34,NY,3787,3954,-167
2015,34,OH,527,525,2
2015,34,OK,199,203,-4
2015,34,OR,485,469,16
2015,34,PA,834,910,-76
2015,34,PR,48,62,-14
2015,34,RI,361,378,-17
2015,34,SC,3966,4114,-148
2015,34,SD,106,104,2
2015,34,TN,465,499,-34
2015,34,TX,13690,14513,-823
2015,34,UT,46,49,-3
2015,34,VA,2677,2869,-192
2015,34,VI,5,9,-4
2015,34,VT,45,45,0
2015,34,WA,381,394,-13
2015,34,WI,183,204,-21
2015,34,WV,158,171,-13
2015,34,WY,20,25,-5
2015,35,AK,52,48,4
2015,35,AL,871,929,-58
2015,35,AR,198,182,16
2015,35,AZ,484,467,17
2015,35,CA,2617,2300,317
2015,35,CO,387,445,-58
2015,35,CT,676,686,-10
2015,35,DC,38,33,5
2015,35,DE,384,399,-15
2015,35,FL,32509,35147,-2638
2015,35,GA,1930,2031,-101
2015,35,GU,1,1,0
2015,35,HI,2526,2551,-25
2015,35,IA,187,194,-7
2015,35,ID,56,64,-8
2015,35,IL,435,472,-37
2015,35,IN,290,291,-1
2015,35,KS,150,149,1
2015,35,KY,237,250,-13
2015,35,LA,8642,9184,-542
2015,35,MA,952,945,7
2015,35,MD,1191,1264,-73
2015,35,ME,112,133,-21
2015,35,MI,165,169,-4
2015,35,MN,134,150,-16
2015,35,MO,238,251,-13
2015,35,MS,1079,1178,-99
2015,35,MT,48,45,3
2015,35,NC,2823,2970,-147
2015,35,ND,222,247,-25
2015,35,NE,91,101,-10
2015,35,NH,140,155,-15
2015,35,NJ,3375,3550,-175
2015,35,NM,170,180,-10
2015,35,NV,162,163,-1
2015,35,NY,3472,3529,-57
2015,35,OH,525,521,4
2015,35,OK,227,244,-17
2015,35,OR,475,481,-6
2015,35,PA,863,920,-57
2015,35,PR,55,164,-109
2015,35,RI,295,313,-18
2015,35,SC,3510,3648,-138
2015,35,SD,99,96,3
2015,35,TN,402,418,-16
2015,35,TX,13944,14761,-817
2015,35,UT,68,65,3
2015,35,VA,2294,2439,-145
2015,35,VI,11,12,-1
2015,35,VT,38,40,-2
2015,35,WA,407,441,-34
2015,35,WI,171,188,-17
2015,35,WV,203,221,-18
2015,35,WY,23,26,-3
2015,36,AK,33,34,-1
2015,36,AL,748,796,-48
2015,36,AR,178,186,-8
2015,36,AZ,413,430,-17
2015,36,CA,2358,2032,326
2015,36,CO,306,323,-17
2015,36,CT,505,522,-17
2015,36,DC,27,26,1
2015,36,DE,530,546,-16
2015,36,FL,26064,27710,-1646
2015,36,GA,1406,1492,-86
2015,36,GU,1,2,-1
2015,36,HI,1570,1574,-4
2015,36,IA,144,162,-18
2015,36,ID,51,53,-2
2015,36,IL,398,430,-32
2015,36,IN,229,250,-21
2015,36,KS,143,153,-10
2015,36,KY,240,249,-9
2015,36,LA,6961,7259,-298
2015,36,MA,917,958,-41
2015,36,MD,734,791,-57
2015,36,ME,120,126,-6
2015,36,MI,211,219,-8
2015,36,MN,107,109,-2
2015,36,MO,235,248,-13
2015,36,MS,911,968,-57
2015,36,MT,70,69,1
2015,36,NC,2237,2391,-154
2015,36,ND,205,226,-21
2015,36,NE,69,71,-2
2015,36,NH,88,88,0
2015,36,NJ,2673,2782,-109
2015,36,NM,153,158,-5
2015,36,NV,123,121,2
2015,36,NY,3257,3525,-268
2015,36,OH,424,451,-27
2015,36,OK,180,180,0
2015,36,OR,308,278,30
2015,36,PA,773,833,-60
2015,36,PR,60,73,-13
2015,36,RI,335,345,-10
2015,36,SC,2987,3086,-99
2015,36,SD,60,65,-5
2015,36,TN,410,493,-83
2015,36,TX,11000,11637,-637
2015,36,UT,56,61,-5
2015,36,VA,1986,2137,-151
2015,36,VI,14,16,-2
2015,36,VT,64,72,-8
2015,36,WA,317,327,-10
2015,36,WI,151,166,-15
2015,36,WV,181,191,-10
2015,36,WY,29,32,-3
2015,37,AK,31,27,4
2015,37,AL,973,994,-21
2015,37,AR,203,199,4
2015,37,AZ,600,565,35
2015,37,CA,3270,2160,1110
2015,37,CO,388,402,-14
2015,37,CT,646,668,-22
2015,37,DC,39,40,-1
2015,37,DE,375,378,-3
2015,37,FL,26798,28942,-2144
2015,37,GA,1583,1652,-69
2015,37,GU,2,2,0
2015,37,HI,1665,1576,89
2015,37,IA,165,168,-3
2015,37,ID,68,71,-3
2015,37,IL,428,436,-8
2015,37,IN,273,294,-21
2015,37,KS,123,136,-13
2015,37,KY,259,248,11
2015,37,LA,7551,7764,-213
2015,37,MA,1029,1069,-40
2015,37,MD,980,1041,-61
2015,37,ME,126,137,-11
2015,37,MI,207,234,-27
2015,37,MN,131,119,12
2015,37,MO,283,276,7
2015,37,MS,1064,1112,-48
2015,37,MT,62,60,2
2015,37,NC,2275,2416,-141
2015,37,ND,196,219,-23
2015,37,NE,89,98,-9
2015,37,NH,104,119,-15
2015,37,NJ,2972,3095,-123
2015,37,NM,174,184,-10
2015,37,NV,139,122,17
2015,37,NY,3717,3848,-131
2015,37,OH,420,429,-9
2015,37,OK,215,242,-27
2015,37,OR,312,323,-11
2015,37,PA,801,880,-79
2015,37,PR,68,75,-7
2015,37,RI,246,264,-18
2015,37,SC,3323,3346,-23
2015,37,SD,64,72,-8
2015,37,TN,394,438,-44
2015,37,TX,11558,11982,-424
2015,37,UT,53,67,-14
2015,37,VA,1910,2038,-128
2015,37,VI,23,31,-8
2015,37,VT,38,35,3
2015,37,WA,405,412,-7
2015,37,WI,156,180,-24
2015,37,WV,173,205,-32
2015,37,WY,20,24,-4
2015,38,AK,53,47,6
2015,38,AL,733,773,-40
2015,38,AR,198,198,0
2015,38,AZ,660,706,-46
2015,38,CA,3357,2555,802
2015,38,CO,344,381,-37
2015,38,CT,668,692,-24
2015,38,DC,269,297,-28
2015,38,DE,460,475,-15
2015,38,FL,30388,32167,-1779
2015,38,GA,1706,1740,-34
2015,38,GU,1,2,-1
2015,38,HI,1178,1181,-3
2015,38,IA,285,304,-19
2015,38,ID,67,68,-1
2015,38,IL,549,587,-38
2015,38,IN,279,291,-12
2015,38,KS,147,159,-12
2015,38,KY,247,268,-21
2015,38,LA,7528,7871,-343
2015,38,MA,1166,1204,-38
2015,38,MD,1046,1088,-42
2015,38,ME,131,141,-10
2015,38,MI,313,338,-25
2015,38,MN,153,116,37
2015,38,MO,221,234,-13
2015,38,MS,1001,1049,-48
2015,38,MT,63,51,12
2015,38,NC,2393,2475,-82
2015,38,ND,183,196,-13
2015,38,NE,78,84,-6
2015,38,NH,145,151,-6
2015,38,NJ,3417,3542,-125
2015,38,NM,151,169,-18
2015,38,NV,181,194,-13
2015,38,NY,3936,4063,-127
2015,38,OH,455,482,-27
2015,38,OK,230,221,9
2015,38,OR,314,327,-13
2015,38,PA,892,943,-51
2015,38,PR,74,84,-10
2015,38,RI,359,370,-11
2015,38,SC,3941,3958,-17
2015,38,SD,62,79,-17
2015,38,TN,473,503,-30
2015,38,TX,10781,11605,-824
2015,38,UT,73,75,-2
2015,38,VA,2139,2257,-118
2015,38,VI,11,10,1
2015,38,VT,51,50,1
2015,38,WA,451,489,-38
2015,38,WI,146,163,-17
2015,38,WV,170,180,-10
2015,38,WY,20,18,2
2015,39,AK,46,48,-2
2015,39,AL,1032,1047,-15
2015,39,AR,236,231,5
2015,39,AZ,522,494,28
2015,39,CA,3949,2850,1099
2015,39,CO,325,337,-12
2015,39,CT,682,734,-52
2015,39,DC,48,55,-7
2015,39,DE,476,488,-12
2015,39,FL,36883,38787,-1904
2015,39,GA,1883,1964,-81
2015,39,GU,1,1,0
2015,39,HI,1696,1687,9
2015,39,IA,160,167,-7
2015,39,ID,71,70,1
2015,39,IL,492,528,-36
2015,39,IN,349,357,-8
2015,39,KS,127,134,-7
2015,39,KY,312,326,-14
2015,39,LA,7762,8036,-274
2015,39,MA,1344,1408,-64
2015,39,MD,1465,1523,-58
2015,39,ME,186,184,2
2015,39,MI,201,208,-7
2015,39,MN,161,154,7
2015,39,MO,356,324,32
2015,39,MS,924,989,-65
2015,39,MT,62,64,-2
2015,39,NC,2776,2907,-131
2015,39,ND,189,220,-31
2015,39,NE,114,123,-9
2015,39,NH,119,123,-4
2015,39,NJ,3913,4047,-134
2015,39,NM,134,135,-1
2015,39,NV,161,179,-18
2015,39,NY,4323,4551,-228
2015,39,OH,525,548,-23
2015,39,OK,218,221,-3
2015,39,OR,420,429,-9
2015,39,PA,987,1016,-29
2015,39,PR,60,65,-5
2015,39,RI,291,315,-24
2015,39,SC,5058,4965,93
2015,39,SD,75,72,3
2015,39,TN,537,566,-29
2015,39,TX,12690,13138,-448
2015,39,UT,86,89,-3
2015,39,VA,2985,3081,-96
2015,39,VI,15,15,0
2015,39,VT,47,53,-6
2015,39,WA,585,605,-20
2015,39,WI,197,202,-5
2015,39,WV,182,208,-26
2015,39,WY,23,27,-4
2015,40,AK,36,34,2
2015,40,AL,770,787,-17
2015,40,AR,137,145,-8
2015,40,AZ,579,662,-83
2015,40,CA,3789,2773,1016
2015,40,CO,317,327,-10
2015,40,CT,559,599,-40
2015,40,DC,30,37,-7
2015,40,DE,397,421,-24
2015,40,FL,23447,25255,-1808
2015,40,GA,1646,1698,-52
2015,40,HI,1104,1101,3
2015,40,IA,126,133,-7
2015,40,ID,63,56,7
2015,40,IL,399,427,-28
2015,40,IN,263,271,-8
2015,40,KS,121,139,-18
2015,40,KY,206,194,12
2015,40,LA,5875,5958,-83
2015,40,MA,1178,1208,-30
2015,40,MD,877,922,-45
2015,40,ME,158,166,-8
2015,40,MI,188,206,-18
2015,40,MN,108,117,-9
2015,40,MO,213,215,-2
2015,40,MS,776,848,-72
2015,40,MT,54,53,1
2015,40,NC,1978,2074,-96
2015,40,ND,119,140,-21
2015,40,NE,81,88,-7
2015,40,NH,79,92,-13
2015,40,NJ,2613,2742,-129
2015,40,NM,130,137,-7
2015,40,NV,142,154,-12
2015,40,NY,3672,3788,-116
2015,40,OH,356,388,-32
2015,40,OK,200,220,-20
2015,40,OR,369,355,14
2015,40,PA,948,1034,-86
2015,40,PR,45,60,-15
2015,40,RI,214,230,-16
2015,40,SC,2843,3150,-307
2015,40,SD,42,42,0
2015,40,TN,339,384,-45
2015,40,TX,9022,9508,-486
2015,40,UT,51,49,2
2015,40,VA,1813,1950,-137
2015,40,VI,7,8,-1
2015,40,VT,65,69,-4
2015,40,WA,439,500,-61
2015,40,WI,111,132,-21
2015,40,WV,184,196,-12
2015,40,WY,25,25,0
2015,41,AK,30,31,-1
2015,41,AL,575,665,-90
2015,41,AR,193,182,11
2015,41,AZ,714,818,-104
2015,41,CA,4968,3254,1714
2015,41,CO,468,512,-44
2015,41,CT,584,601,-17
2015,41,DC,44,38,6
2015,41,DE,433,430,3
2015,41,FL,24713,26073,-1360
2015,41,GA,1299,1359,-60
2015,41,HI,372,403,-31
2015,41,IA,149,154,-5
2015,41,ID,76,80,-4
2015,41,IL,438,476,-38
2015,41,IN,321,300,21
2015,41,KS,116,120,-4
2015,41,KY,240,244,-4
2015,41,LA,7129,7253,-124
2015,41,MA,1212,1233,-21
2015,41,MD,1056,1124,-68
2015,41,ME,200,208,-8
2015,41,MI,192,244,-52
2015,41,MN,105,111,-6
2015,41,MO,211,217,-6
2015,41,MS,842,864,-22
2015,41,MT,49,47,2
2015,41,NC,2077,2122,-45
2015,41,ND,162,187,-25
2015,41,NE,63,66,-3
2015,41,NH,80,83,-3
2015,41,NJ,2848,3013,-165
2015,41,NM,157,153,4
2015,41,NV,165,163,2
2015,41,NY,3742,3829,-87
2015,41,OH,450,446,4
2015,41,OK,201,205,-4
2015,41,OR,487,491,-4
2015,41,PA,1064,1114,-50
2015,41,PR,34,88,-54
2015,41,RI,233,255,-22
2015,41,SC,2715,2786,-71
2015,41,SD,62,64,-2
2015,41,TN,417,463,-46
2015,41,TX,9028,9395,-367
2015,41,UT,81,95,-14
2015,41,VA,1990,2091,-101
2015,41,VI,18,26,-8
2015,41,VT,48,57,-9
2015,41,WA,546,629,-83
2015,41,WI,153,145,8
2015,41,WV,165,173,-8
2015,41,WY,22,29,-7
2015,42,AK,54,56,-2
2015,42,AL,569,598,-29
2015,42,AR,203,209,-6
2015,42,AZ,620,644,-24
2015,42,CA,5061,3846,1215
2015,42,CO,384,439,-55
2015,42,CT,457,483,-26
2015,42,DC,39,38,1
2015,42,DE,329,358,-29
2015,42,FL,23807,25212,-1405
2015,42,GA,1580,1656,-76
2015,42,GU,1,3,-2
2015,42,HI,1040,1031,9
2015,42,IA,207,205,2
2015,42,ID,78,93,-15
2015,42,IL,408,432,-24
2015,42,IN,290,316,-26
2015,42,KS,152,158,-6
2015,42,KY,188,206,-18
2015,42,LA,6082,6110,-28
2015,42,MA,1204,1239,-35
2015,42,MD,838,880,-42
2015,42,ME,137,141,-4
2015,42,MI,209,226,-17
2015,42,MN,122,129,-7
2015,42,MO,222,239,-17
2015,42,MS,888,944,-56
2015,42,MT,53,51,2
2015,42,NC,1848,1917,-69
2015,42,ND,173,191,-18
2015,42,NE,94,94,0
2015,42,NH,77,78,-1
2015,42,NJ,2906,2974,-68
2015,42,NM,144,160,-16
2015,42,NV,181,186,-5
2015,42,NY,2832,3027,-195
2015,42,OH,427,447,-20
2015,42,OK,217,209,8
2015,42,OR,449,474,-25
2015,42,PA,1006,1111,-105
2015,42,PR,78,96,-18
2015,42,RI,183,191,-8
2015,42,SC,2853,2837,16
2015,42,SD,45,51,-6
2015,42,TN,391,413,-22
2015,42,TX,9781,10235,-454
2015,42,UT,67,73,-6
2015,42,VA,2225,2308,-83
2015,42,VI,10,9,1
2015,42,VT,58,64,-6
2015,42,WA,641,667,-26
2015,42,WI,133,142,-9
2015,42,WV,156,163,-7
2015,42,WY,33,28,5
2015,43,AK,46,49,-3
2015,43,AL,788,775,13
2015,43,AR,182,196,-14
2015,43,AZ,525,512,13
2015,43,CA,4977,3919,1058
2015,43,CO,405,433,-28
2015,43,CT,622,622,0
2015,43,DC,44,39,5
2015,43,DE,566,566,0
2015,43,FL,28122,30264,-2142
2015,43,GA,1670,1817,-147
2015,43,HI,1330,1327,3
2015,43,IA,139,147,-8
2015,43,ID,78,88,-10
2015,43,IL,442,465,-23
2015,43,IN,315,303,12
2015,43,KS,155,157,-2
2015,43,KY,261,260,1
2015,43,LA,7477,7503,-26
2015,43,MA,1348,1286,62
2015,43,MD,1087,1056,31
2015,43,ME,135,141,-6
2015,43,MI,239,237,2
2015,43,MN,108,120,-12
2015,43,MO,288,312,-24
2015,43,MS,1102,1146,-44
2015,43,MT,66,62,4
2015,43,NC,2153,2118,35
2015,43,ND,214,252,-38
2015,43,NE,85,90,-5
2015,43,NH,112,171,-59
2015,43,NJ,2774,2823,-49
2015,43,NM,135,137,-2
2015,43,NV,175,170,5
2015,43,NY,3186,3053,133
2015,43,OH,476,473,3
2015,43,OK,214,225,-11
2015,43,OR,458,453,5
2015,43,PA,1267,1355,-88
2015,43,PR,79,86,-7
2015,43,RI,234,251,-17
2015,43,SC,3382,3368,14
2015,43,SD,63,59,4
2015,43,TN,435,448,-13
2015,43,TX,10309,10780,-471
2015,43,UT,64,67,-3
2015,43,VA,2203,2029,174
2015,43,VI,9,10,-1
2015,43,VT,71,84,-13
2015,43,WA,900,974,-74
2015,43,WI,167,152,15
2015,43,WV,163,177,-14
2015,43,WY,23,26,-3
2015,44,AK,44,43,1
2015,44,AL,799,795,4
2015,44,AR,180,164,16
2015,44,AZ,480,496,-16
2015,44,CA,5441,3917,1524
2015,44,CO,301,292,9
2015,44,CT,435,510,-75
2015,44,DC,36,30,6
2015,44,DE,305,296,9
2015,44,FL,24530,25831,-1301
2015,44,GA,1495,1446,49
2015,44,HI,1247,1259,-12
2015,44,IA,156,155,1
2015,44,ID,77,66,11
2015,44,IL,411,411,0
2015,44,IN,290,312,-22
2015,44,KS,115,120,-5
2015,44,KY,243,255,-12
2015,44,LA,5429,5330,99
2015,44,MA,960,1003,-43
2015,44,MD,908,913,-5
2015,44,ME,151,146,5
2015,44,MI,161,170,-9
2015,44,MN,89,100,-11
2015,44,MO,246,256,-10
2015,44,MS,827,852,-25
2015,44,MT,57,56,1
2015,44,NC,1896,1803,93
2015,44,ND,139,168,-29
2015,44,NE,54,60,-6
2015,44,NH,90,145,-55
2015,44,NJ,2948,2723,225
2015,44,NM,105,114,-9
2015,44,NV,156,156,0
2015,44,NY,2911,2923,-12
2015,44,OH,381,387,-6
2015,44,OK,197,219,-22
2015,44,OR,457,496,-39
2015,44,PA,870,898,-28
2015,44,PR,36,42,-6
2015,44,RI,215,216,-1
2015,44,SC,3172,2631,541
2015,44,SD,50,55,-5
2015,44,TN,414,401,13
2015,44,TX,8415,8296,119
2015,44,UT,72,65,7
2015,44,VA,1695,1632,63
2015,44,VI,13,13,0
2015,44,VT,67,66,1
2015,44,WA,778,841,-63
2015,44,WI,143,158,-15
2015,44,WV,170,187,-17
2015,44,WY,31,28,3
2015,45,AK,18,20,-2
2015,45,AL,682,689,-7
2015,45,AR,179,176,3
2015,45,AZ,339,316,23
2015,45,CA,5678,3990,1688
2015,45,CO,246,254,-8
2015,45,CT,555,564,-9
2015,45,DC,28,28,0
2015,45,DE,276,291,-15
2015,45,FL,19087,19960,-873
2015,45,GA,1212,1199,13
2015,45,HI,565,642,-77
2015,45,IA,96,100,-4
2015,45,ID,70,72,-2
2015,45,IL,382,376,6
2015,45,IN,260,249,11
2015,45,KS,114,118,-4
2015,45,KY,223,226,-3
2015,45,LA,4838,4869,-31
2015,45,MA,869,840,29
2015,45,MD,702,733,-31
2015,45,ME,130,136,-6
2015,45,MI,176,176,0
2015,45,MN,70,77,-7
2015,45,MO,227,235,-8
2015,45,MS,818,864,-46
2015,45,MT,42,48,-6
2015,45,NC,1998,1932,66
2015,45,ND,103,110,-7
2015,45,NE,62,64,-2
2015,45,NH,79,83,-4
2015,45,NJ,2829,2923,-94
2015,45,NM,98,94,4
2015,45,NV,164,163,1
2015,45,NY,2597,2617,-20
2015,45,OH,349,357,-8
2015,45,OK,176,186,-10
2015,45,OR,451,457,-6
2015,45,PA,768,821,-53
2015,45,PR,41,42,-1
2015,45,RI,152,161,-9
2015,45,SC,2669,2388,281
2015,45,SD,37,39,-2
2015,45,TN,326,321,5
2015,45,TX,6787,7049,-262
2015,45,UT,60,65,-5
2015,45,VA,1689,1717,-28
2015,45,VI,5,5,0
2015,45,VT,51,55,-4
2015,45,WA,691,715,-24
2015,45,WI,106,116,-10
2015,45,WV,143,138,5
2015,45,WY,24,19,5
2015,46,AK,54,59,-5
2015,46,AL,558,551,7
2015,46,AR,179,171,8
2015,46,AZ,466,386,80
2015,46,CA,7770,3910,3860
2015,46,CO,309,345,-36
2015,46,CT,517,532,-15
2015,46,DC,25,27,-2
2015,46,DE,356,379,-23
2015,46,FL,22554,23386,-832
2015,46,GA,1222,1249,-27
2015,46,HI,602,613,-11
2015,46,IA,121,118,3
2015,46,ID,53,56,-3
2015,46,IL,394,435,-41
2015,46,IN,260,253,7
2015,46,KS,120,124,-4
2015,46,KY,250,236,14
2015,46,LA,5841,5788,53
2015,46,MA,876,906,-30
2015,46,MD,1045,1111,-66
2015,46,ME,120,131,-11
2015,46,MI,159,156,3
2015,46,MN,106,113,-7
2015,46,MO,262,249,13
2015,46,MS,997,1023,-26
2015,46,MT,45,44,1
2015,46,NC,1937,1937,0
2015,46,ND,115,127,-12
2015,46,NE,69,59,10
2015,46,NH,64,61,3
2015,46,NJ,2831,2908,-77
2015,46,NM,132,123,9
2015,46,NV,199,172,27
2015,46,NY,2548,2660,-112
2015,46,OH,434,446,-12
2015,46,OK,210,197,13
2015,46,OR,592,512,80
2015,46,PA,1299,1340,-41
2015,46,PR,52,62,-10
2015,46,RI,177,176,1
2015,46,SC,3073,2871,202
2015,46,SD,40,49,-9
2015,46,TN,353,352,1
2015,46,TX,7740,7892,-152
2015,46,UT,71,72,-1
2015,46,VA,1562,1633,-71
2015,46,VI,10,9,1
2015,46,VT,57,59,-2
2015,46,WA,759,786,-27
2015,46,WI,124,129,-5
2015,46,WV,165,186,-21
2015,46,WY,19,20,-1
2015,47,AK,28,30,-2
2015,47,AL,482,481,1
2015,47,AR,121,136,-15
2015,47,AZ,420,330,90
2015,47,CA,17812,3422,14390
2015,47,CO,201,217,-16
2015,47,CT,641,652,-11
2015,47,DC,53,30,23
2015,47,DE,294,305,-11
2015,47,FL,18362,19049,-687
2015,47,GA,1002,983,19
2015,47,GU,1,1,0
2015,47,HI,1182,1094,88
2015,47,IA,109,115,-6
2015,47,ID,62,63,-1
2015,47,IL,357,369,-12
2015,47,IN,230,216,14
2015,47,KS,92,96,-4
2015,47,KY,197,215,-18
2015,47,LA,4742,4696,46
2015,47,MA,903,913,-10
2015,47,MD,874,912,-38
2015,47,ME,101,115,-14
2015,47,MI,167,192,-25
2015,47,MN,73,84,-11
2015,47,MO,179,178,1
2015,47,MS,709,728,-19
2015,47,MT,37,49,-12
2015,47,NC,1421,1363,58
2015,47,ND,104,106,-2
2015,47,NE,56,55,1
2015,47,NH,78,74,4
2015,47,NJ,2172,2243,-71
2015,47,NM,98,89,9
2015,47,NV,182,141,41
2015,47,NY,2621,2725,-104
2015,47,OH,314,321,-7
2015,47,OK,151,140,11
2015,47,OR,460,482,-22
2015,47,PA,767,798,-31
2015,47,PR,47,56,-9
2015,47,RI,192,193,-1
2015,47,SC,2188,2002,186
2015,47,SD,49,50,-1
2015,47,TN,435,441,-6
2015,47,TX,6911,6381,530
2015,47,UT,51,52,-1
2015,47,VA,1348,1430,-82
2015,47,VI,5,3,2
2015,47,VT,62,66,-4
2015,47,WA,637,683,-46
2015,47,WI,101,110,-9
2015,47,WV,154,163,-9
2015,47,WY,18,14,4
2015,48,AK,29,33,-4
2015,48,AL,869,874,-5
2015,48,AR,158,161,-3
2015,48,AZ,432,354,78
2015,48,CA,15766,4713,11053
2015,48,CO,251,259,-8
2015,48,CT,863,871,-8
2015,48,DC,35,36,-1
2015,48,DE,381,390,-9
2015,48,FL,24965,25770,-805
2015,48,GA,1337,1319,18
2015,48,GU,1,2,-1
2015,48,HI,1740,1737,3
2015,48,IA,141,137,4
2015,48,ID,63,56,7
2015,48,IL,475,417,58
2015,48,IN,338,279,59
2015,48,KS,116,120,-4
2015,48,KY,218,203,15
2015,48,LA,5715,5629,86
2015,48,MA,917,826,91
2015,48,MD,821,891,-70
2015,48,ME,125,140,-15
2015,48,MI,381,386,-5
2015,48,MN,116,116,0
2015,48,MO,208,236,-28
2015,48,MS,1000,1010,-10
2015,48,MT,53,57,-4
2015,48,NC,1741,1731,10
2015,48,ND,102,103,-1
2015,48,NE,79,86,-7
2015,48,NH,183,187,-4
2015,48,NJ,2934,3017,-83
2015,48,NM,142,146,-4
2015,48,NV,190,148,42
2015,48,NY,2652,2698,-46
2015,48,OH,380,382,-2
2015,48,OK,163,166,-3
2015,48,OR,505,493,12
2015,48,PA,813,876,-63
2015,48,PR,35,42,-7
2015,48,RI,367,358,9
2015,48,SC,2744,2606,138
2015,48,SD,58,63,-5
2015,48,TN,341,334,7
2015,48,TX,8150,7439,711
2015,48,UT,56,62,-6
2015,48,VA,1633,1689,-56
2015,48,VI,42,42,0
2015,48,VT,59,58,1
2015,48,WA,787,817,-30
2015,48,WI,124,122,2
2015,48,WV,171,167,4
2015,48,WY,21,21,0
2015,49,AK,28,31,-3
2015,49,AL,833,842,-9
2015,49,AR,132,134,-2
2015,49,AZ,386,318,68
2015,49,CA,11612,4073,7539
2015,49,CO,226,227,-1
2015,49,CT,380,392,-12
2015,49,DC,27,28,-1
2015,49,DE,288,325,-37
2015,49,FL,19218,19650,-432
2015,49,GA,1001,967,34
2015,49,HI,527,525,2
2015,49,IA,110,115,-5
2015,49,ID,64,65,-1
2015,49,IL,330,360,-30
2015,49,IN,205,211,-6
2015,49,KS,99,104,-5
2015,49,KY,209,195,14
2015,49,LA,4610,4556,54
2015,49,MA,726,631,95
2015,49,MD,857,899,-42
2015,49,ME,111,117,-6
2015,49,MI,178,187,-9
2015,49,MN,85,87,-2
2015,49,MO,223,220,3
2015,49,MS,714,761,-47
2015,49,MT,42,46,-4
2015,49,NC,1443,1459,-16
2015,49,ND,117,127,-10
2015,49,NE,68,65,3
2015,49,NH,118,112,6
2015,49,NJ,2472,2532,-60
2015,49,NM,110,121,-11
2015,49,NV,138,130,8
2015,49,NY,2663,2733,-70
2015,49,OH,374,381,-7
2015,49,OK,188,192,-4
2015,49,OR,462,472,-10
2015,49,PA,756,799,-43
2015,49,PR,41,46,-5
2015,49,RI,246,226,20
2015,49,SC,2134,2000,134
2015,49,SD,42,41,1
2015,49,TN,315,331,-16
2015,49,TX,6051,5877,174
2015,49,UT,40,39,1
2015,49,VA,1146,1214,-68
2015,49,VI,2,3,-1
2015,49,VT,33,33,0
2015,49,WA,603,598,5
2015,49,WI,120,115,5
2015,49,WV,132,158,-26
2015,49,WY,13,15,-2
2015,50,AK,36,33,3
2015,50,AL,503,511,-8
2015,50,AR,187,246,-59
2015,50,AZ,416,363,53
2015,50,CA,10674,4355,6319
2015,50,CO,251,254,-3
2015,50,CT,495,516,-21
2015,50,DC,27,31,-4
2015,50,DE,370,369,1
2015,50,FL,24040,25067,-1027
2015,50,GA,1189,1193,-4
2015,50,HI,1004,1009,-5
2015,50,IA,138,144,-6
2015,50,ID,66,61,5
2015,50,IL,369,378,-9
2015,50,IN,239,234,5
2015,50,KS,121,117,4
2015,50,KY,227,216,11
2015,50,LA,6086,6033,53
2015,50,MA,814,842,-28
2015,50,MD,748,804,-56
2015,50,ME,118,130,-12
2015,50,MI,206,223,-17
2015,50,MN,89,95,-6
2015,50,MO,204,208,-4
2015,50,MP,1,1,0
2015,50,MS,797,801,-4
2015,50,MT,55,53,2
2015,50,NC,1728,1778,-50
2015,50,ND,120,129,-9
2015,50,NE,78,75,3
2015,50,NH,83,84,-1
2015,50,NJ,3025,3124,-99
2015,50,NM,121,119,2
2015,50,NV,172,146,26
2015,50,NY,3092,3180,-88
2015,50,OH,470,496,-26
2015,50,OK,157,165,-8
2015,50,OR,500,489,11
2015,50,PA,821,839,-18
2015,50,PR,35,41,-6
2015,50,RI,165,158,7
2015,50,SC,2783,2727,56
2015,50,SD,53,52,1
2015,50,TN,349,341,8
2015,50,TX,6755,6681,74
2015,50,UT,48,57,-9
2015,50,VA,1478,1527,-49
2015,50,VI,11,8,3
2015,50,VT,42,45,-3
2015,50,WA,768,760,8
2015,50,WI,129,130,-1
2015,50,WV,154,152,2
2015,50,WY,18,22,-4
2015,51,AK,24,23,1
2015,51,AL,458,472,-14
2015,51,AR,111,105,6
2015,51,AZ,303,279,24
2015,51,CA,7077,3087,3990
2015,51,CO,240,258,-18
2015,51,CT,251,332,-81
2015,51,DC,25,27,-2
2015,51,DE,227,227,0
2015,51,FL,16275,17028,-753
2015,51,GA,811,787,24
2015,51,GU,1,1,0
2015,51,HI,1203,1349,-146
2015,51,IA,100,102,-2
2015,51,ID,47,47,0
2015,51,IL,272,280,-8
2015,51,IN,186,198,-12
2015,51,KS,81,83,-2
2015,51,KY,201,206,-5
2015,51,LA,3848,3752,96
2015,51,MA,595,594,1
2015,51,MD,587,627,-40
2015,51,ME,90,93,-3
2015,51,MI,130,146,-16
2015,51,MN,67,66,1
2015,51,MO,169,173,-4
2015,51,MS,625,639,-14
2015,51,MT,28,27,1
2015,51,NC,1162,1152,10
2015,51,ND,82,102,-20
2015,51,NE,51,60,-9
2015,51,NH,67,66,1
2015,51,NJ,2244,2198,46
2015,51,NM,85,88,-3
2015,51,NV,121,115,6
2015,51,NY,2507,2554,-47
2015,51,OH,263,266,-3
2015,51,OK,117,113,4
2015,51,OR,345,390,-45
2015,51,PA,553,583,-30
2015,51,PR,45,40,5
2015,51,RI,118,120,-2
2015,51,SC,1856,1810,46
2015,51,SD,44,42,2
2015,51,TN,332,348,-16
2015,51,TX,4947,4992,-45
2015,51,UN,1,1,0
2015,51,UT,51,55,-4
2015,51,VA,904,948,-44
2015,51,VI,28,30,-2
2015,51,VT,37,35,2
2015,51,WA,607,635,-28
2015,51,WI,72,67,5
2015,51,WV,123,127,-4
2015,51,WY,24,23,1
2015,52,AK,7,7,0
2015,52,AL,398,397,1
2015,52,AR,79,76,3
2015,52,AZ,284,245,39
2015,52,CA,4096,2423,1673
2015,52,CO,196,199,-3
2015,52,CT,284,278,6
2015,52,DC,23,22,1
2015,52,DE,167,181,-14
2015,52,FL,18917,20023,-1106
2015,52,GA,735,742,-7
2015,52,HI,177,179,-2
2015,52,IA,76,84,-8
2015,52,ID,40,42,-2
2015,52,IL,205,202,3
2015,52,IN,131,145,-14
2015,52,KS,73,71,2
2015,52,KY,121,117,4
2015,52,LA,4610,4585,25
2015,52,MA,768,767,1
2015,52,MD,912,952,-40
2015,52,ME,64,68,-4
2015,52,MI,133,134,-1
2015,52,MN,73,69,4
2015,52,MO,190,199,-9
2015,52,MS,533,551,-18
2015,52,MT,23,20,3
2015,52,NC,1048,1049,-1
2015,52,ND,117,142,-25
2015,52,NE,84,92,-8
2015,52,NH,53,54,-1
2015,52,NJ,1636,1659,-23
2015,52,NM,74,72,2
2015,52,NV,93,91,2
2015,52,NY,1990,2005,-15
2015,52,OH,230,231,-1
2015,52,OK,105,106,-1
2015,52,OR,269,282,-13
2015,52,PA,480,512,-32
2015,52,PR,68,76,-8
2015,52,RI,104,103,1
2015,52,SC,2306,2271,35
2015,52,SD,38,40,-2
2015,52,TN,226,212,14
2015,52,TX,5005,5102,-97
2015,52,UT,35,34,1
2015,52,VA,966,988,-22
2015,52,VI,3,3,0
2015,52,VT,16,20,-4
2015,52,WA,400,395,5
2015,52,WI,69,75,-6
2015,52,WV,83,91,-8
2015,52,WY,18,19,-1
2016,0,AK,28,28,0
2016,0,AL,129,124,5
2016,0,AR,67,70,-3
2016,0,AZ,109,96,13
2016,0,CA,2863,1523,1340
2016,0,CO,60,71,-11
2016,0,CT,127,138,-11
2016,0,DC,6,6,0
2016,0,DE,144,147,-3
2016,0,FL,13864,13790,74
2016,0,GA,635,638,-3
2016,0,HI,118,119,-1
2016,0,IA,36,40,-4
2016,0,ID,17,16,1
2016,0,IL,97,104,-7
2016,0,IN,87,88,-1
2016,0,KS,27,28,-1
2016,0,KY,49,52,-3
2016,0,LA,1048,1030,18
2016,0,MA,172,169,3
2016,0,MD,226,224,2
2016,0,ME,20,20,0
2016,0,MI,41,44,-3
2016,0,MN,24,25,-1
2016,0,MO,47,47,0
2016,0,MS,169,162,7
2016,0,MT,16,17,-1
2016,0,NC,596,665,-69
2016,0,ND,39,57,-18
2016,0,NE,28,28,0
2016,0,NH,24,24,0
2016,0,NJ,545,549,-4
2016,0,NM,31,32,-1
2016,0,NV,41,31,10
2016,0,NY,582,594,-12
2016,0,OH,69,86,-17
2016,0,OK,45,47,-2
2016,0,OR,180,159,21
2016,0,PA,231,246,-15
2016,0,PR,10,12,-2
2016,0,RI,39,33,6
2016,0,SC,739,726,13
2016,0,SD,23,27,-4
2016,0,TN,106,97,9
2016,0,TX,1977,1989,-12
2016,0,UT,15,15,0
2016,0,VA,430,447,-17
2016,0,VI,1,1,0
2016,0,VT,9,12,-3
2016,0,WA,155,155,0
2016,0,WI,108,107,1
2016,0,WV,46,53,-7
2016,0,WY,1,2,-1
2016,1,AK,16,18,-2
2016,1,AL,523,533,-10
2016,1,AR,98,101,-3
2016,1,AZ,401,319,82
2016,1,CA,8024,4601,3423
2016,1,CO,229,240,-11
2016,1,CT,502,506,-4
2016,1,DC,26,22,4
2016,1,DE,317,317,0
2016,1,FL,18497,19145,-648
2016,1,GA,881,899,-18
2016,1,GU,1,2,-1
2016,1,HI,470,475,-5
2016,1,IA,112,127,-15
2016,1,ID,74,72,2
2016,1,IL,587,586,1
2016,1,IN,209,217,-8
2016,1,KS,143,138,5
2016,1,KY,214,214,0
2016,1,LA,4144,4043,101
2016,1,MA,578,601,-23
2016,1,MD,662,709,-47
2016,1,ME,90,96,-6
2016,1,MI,160,156,4
2016,1,MN,69,72,-3
2016,1,MO,193,188,5
2016,1,MS,718,707,11
2016,1,MT,60,68,-8
2016,1,NC,1310,1331,-21
2016,1,ND,152,214,-62
2016,1,NE,74,73,1
2016,1,NH,70,63,7
2016,1,NJ,1927,2011,-84
2016,1,NM,113,114,-1
2016,1,NV,168,159,9
2016,1,NY,2419,2476,-57
2016,1,OH,286,300,-14
2016,1,OK,138,141,-3
2016,1,OR,586,427,159
2016,1,PA,634,669,-35
2016,1,PR,32,36,-4
2016,1,RI,137,139,-2
2016,1,SC,1780,1722,58
2016,1,SD,41,41,0
2016,1,TN,303,310,-7
2016,1,TX,6771,6738,33
2016,1,UT,39,45,-6
2016,1,VA,962,1008,-46
2016,1,VI,3,7,-4
2016,1,VT,31,36,-5
2016,1,WA,622,573,49
2016,1,WI,98,104,-6
2016,1,WV,158,163,-5
2016,1,WY,16,17,-1
2016,2,AK,40,39,1
2016,2,AL,676,665,11
2016,2,AR,169,180,-11
2016,2,AZ,368,297,71
2016,2,CA,6787,3471,3316
2016,2,CO,204,207,-3
2016,2,CT,441,437,4
2016,2,DC,30,33,-3
2016,2,DE,257,269,-12
2016,2,FL,19970,20593,-623
2016,2,GA,927,926,1
2016,2,HI,1098,1101,-3
2016,2,IA,120,122,-2
2016,2,ID,51,47,4
2016,2,IL,328,335,-7
2016,2,IN,240,241,-1
2016,2,KS,102,120,-18
2016,2,KY,214,194,20
2016,2,LA,4726,4625,101
2016,2,MA,540,538,2
2016,2,MD,711,721,-10
2016,2,ME,119,127,-8
2016,2,MI,169,167,2
2016,2,MN,87,83,4
2016,2,MO,211,195,16
2016,2,MS,757,763,-6
2016,2,MT,51,51,0
2016,2,NC,1406,1455,-49
2016,2,ND,281,386,-105
2016,2,NE,84,85,-1
2016,2,NH,90,90,0
2016,2,NJ,2125,2234,-109
2016,2,NM,113,113,0
2016,2,NV,145,130,15
2016,2,NY,2917,2973,-56
2016,2,OH,392,395,-3
2016,2,OK,145,143,2
2016,2,OR,440,374,66
2016,2,PA,778,801,-23
2016,2,PR,29,37,-8
2016,2,RI,313,315,-2
2016,2,SC,2405,2361,44
2016,2,SD,39,45,-6
2016,2,TN,265,272,-7
2016,2,TX,5213,5076,137
2016,2,UT,44,42,2
2016,2,VA,928,997,-69
2016,2,VI,6,8,-2
2016,2,VT,37,39,-2
2016,2,WA,705,697,8
2016,2,WI,225,230,-5
2016,2,WV,129,139,-10
2016,2,WY,15,13,2
2016,3,AK,33,35,-2
2016,3,AL,536,542,-6
2016,3,AR,133,134,-1
2016,3,AZ,297,281,16
2016,3,CA,4527,2774,1753
2016,3,CO,201,210,-9
2016,3,CT,353,359,-6
2016,3,DC,21,26,-5
2016,3,DE,373,381,-8
2016,3,FL,18950,19563,-613
2016,3,GA,872,863,9
2016,3,HI,498,490,8
2016,3,IA,106,107,-1
2016,3,ID,31,33,-2
2016,3,IL,262,259,3
2016,3,IN,196,199,-3
2016,3,KS,96,93,3
2016,3,KY,156,159,-3
2016,3,LA,4349,4219,130
2016,3,MA,526,523,3
2016,3,MD,1001,1037,-36
2016,3,ME,67,69,-2
2016,3,MI,162,159,3
2016,3,MN,53,58,-5
2016,3,MO,230,215,15
2016,3,MS,646,668,-22
2016,3,MT,44,49,-5
2016,3,NC,1634,1650,-16
2016,3,ND,179,229,-50
2016,3,NE,60,63,-3
2016,3,NH,59,64,-5
2016,3,NJ,1822,1894,-72
2016,3,NM,90,90,0
2016,3,NV,138,142,-4
2016,3,NY,2096,2090,6
2016,3,OH,280,279,1
2016,3,OK,121,118,3
2016,3,OR,396,367,29
2016,3,PA,925,936,-11
2016,3,PR,30,34,-4
2016,3,RI,106,112,-6
2016,3,SC,1953,1928,25
2016,3,SD,31,34,-3
2016,3,TN,212,218,-6
2016,3,TX,4946,5003,-57
2016,3,UT,37,40,-3
2016,3,VA,862,892,-30
2016,3,VI,18,21,-3
2016,3,VT,33,27,6
2016,3,WA,452,437,15
2016,3,WI,106,101,5
2016,3,WV,107,107,0
2016,3,WY,14,15,-1
2016,4,AK,23,25,-2
2016,4,AL,533,435,98
2016,4,AR,204,126,78
2016,4,AZ,335,307,28
2016,4,CA,4151,2904,1247
2016,4,CO,252,228,24
2016,4,CT,301,380,-79
2016,4,DC,54,48,6
2016,4,DE,222,239,-17
2016,4,FL,19782,20566,-784
2016,4,GA,1026,893,133
2016,4,GU,1,1,0
2016,4,HI,291,223,68
2016,4,IA,104,111,-7
2016,4,ID,58,61,-3
2016,4,IL,436,372,64
2016,4,IN,221,222,-1
2016,4,KS,104,95,9
2016,4,KY,168,162,6
2016,4,LA,5314,4691,623
2016,4,MA,514,515,-1
2016,4,MD,755,776,-21
2016,4,ME,94,100,-6
2016,4,MI,167,154,13
2016,4,MN,79,84,-5
2016,4,MO,234,182,52
2016,4,MS,831,728,103
2016,4,MT,60,57,3
2016,4,NC,1340,1300,40
2016,4,ND,126,151,-25
2016,4,NE,82,94,-12
2016,4,NH,56,61,-5
2016,4,NJ,2268,2286,-18
2016,4,NM,114,119,-5
2016,4,NV,168,170,-2
2016,4,NY,2026,1960,66
2016,4,OH,281,273,8
2016,4,OK,147,131,16
2016,4,OR,370,367,3
2016,4,PA,707,740,-33
2016,4,PR,326,338,-12
2016,4,RI,139,133,6
2016,4,SC,2054,2031,23
2016,4,SD,35,40,-5
2016,4,TN,274,248,26
2016,4,TX,5109,5078,31
2016,4,UT,38,37,1
2016,4,VA,948,992,-44
2016,4,VI,7,9,-2
2016,4,VT,50,39,11
2016,4,WA,407,412,-5
2016,4,WI,95,101,-6
2016,4,WV,108,105,3
2016,4,WY,11,15,-4
2016,5,AK,14,14,0
2016,5,AL,986,947,39
2016,5,AR,182,214,-32
2016,5,AZ,410,304,106
2016,5,CA,5879,3409,2470
2016,5,CO,221,216,5
2016,5,CT,328,316,12
2016,5,DC,20,26,-6
2016,5,DE,199,197,2
2016,5,FL,19559,20203,-644
2016,5,GA,1041,1014,27
2016,5,HI,1757,1755,2
2016,5,IA,113,118,-5
2016,5,ID,95,91,4
2016,5,IL,362,322,40
2016,5,IN,239,231,8
2016,5,KS,104,113,-9
2016,5,KY,197,193,4
2016,5,LA,6954,6492,462
2016,5,MA,614,567,47
2016,5,MD,582,609,-27
2016,5,ME,80,77,3
2016,5,MI,177,181,-4
2016,5,MN,112,115,-3
2016,5,MO,223,192,31
2016,5,MS,915,941,-26
2016,5,MT,81,81,0
2016,5,NC,1408,1417,-9
2016,5,ND,153,188,-35
2016,5,NE,74,74,0
2016,5,NH,66,72,-6
2016,5,NJ,2724,2756,-32
2016,5,NM,99,98,1
2016,5,NV,178,173,5
2016,5,NY,2909,2974,-65
2016,5,OH,347,346,1
2016,5,OK,144,138,6
2016,5,OR,348,521,-173
2016,5,PA,949,964,-15
2016,5,PR,25,30,-5
2016,5,RI,122,127,-5
2016,5,SC,2023,1934,89
2016,5,SD,51,57,-6
2016,5,TN,333,314,19
2016,5,TX,5154,5061,93
2016,5,UT,45,41,4
2016,5,VA,958,1004,-46
2016,5,VI,3,3,0
2016,5,VT,48,41,7
2016,5,WA,516,536,-20
2016,5,WI,111,107,4
2016,5,WV,189,187,2
2016,5,WY,17,14,3
2016,6,AK,39,36,3
2016,6,AL,776,768,8
2016,6,AR,166,144,22
2016,6,AZ,409,372,37
2016,6,CA,4588,3721,867
2016,6,CO,235,241,-6
2016,6,CT,303,297,6
2016,6,DC,30,30,0
2016,6,DE,244,257,-13
2016,6,FL,20780,21421,-641
2016,6,GA,910,912,-2
2016,6,GU,2,0,2
2016,6,HI,548,557,-9
2016,6,IA,125,132,-7
2016,6,ID,93,94,-1
2016,6,IL,441,415,26
2016,6,IN,298,305,-7
2016,6,KS,130,126,4
2016,6,KY,190,202,-12
2016,6,LA,5169,4997,172
2016,6,MA,957,829,128
2016,6,MD,575,591,-16
2016,6,ME,124,120,4
2016,6,MI,196,193,3
2016,6,MN,121,123,-2
2016,6,MO,212,186,26
2016,6,MP,1,0,1
2016,6,MS,859,877,-18
2016,6,MT,72,75,-3
2016,6,NC,1477,1481,-4
2016,6,ND,260,356,-96
2016,6,NE,79,81,-2
2016,6,NH,77,85,-8
2016,6,NJ,2026,2168,-142
2016,6,NM,109,111,-2
2016,6,NV,205,202,3
2016,6,NY,2280,2319,-39
2016,6,OH,367,398,-31
2016,6,OK,144,137,7
2016,6,OR,384,387,-3
2016,6,PA,786,829,-43
2016,6,PR,32,46,-14
2016,6,RI,158,162,-4
2016,6,SC,2304,2241,63
2016,6,SD,36,41,-5
2016,6,TN,315,303,12
2016,6,TX,5812,5901,-89
2016,6,UN,1,1,0
2016,6,UT,124,127,-3
2016,6,VA,1165,1213,-48
2016,6,VI,2,2,0
2016,6,VT,46,39,7
2016,6,WA,583,610,-27
2016,6,WI,129,124,5
2016,6,WV,184,207,-23
2016,6,WY,24,24,0
2016,7,AK,24,33,-9
2016,7,AL,793,779,14
2016,7,AR,182,176,6
2016,7,AZ,315,302,13
2016,7,CA,3653,3097,556
2016,7,CO,189,180,9
2016,7,CT,350,364,-14
2016,7,DC,54,53,1
2016,7,DE,222,237,-15
2016,7,FL,22424,23136,-712
2016,7,GA,989,1015,-26
2016,7,HI,760,450,310
2016,7,IA,149,145,4
2016,7,ID,89,87,2
2016,7,IL,739,732,7
2016,7,IN,236,241,-5
2016,7,KS,100,92,8
2016,7,KY,211,235,-24
2016,7,LA,5321,5257,64
2016,7,MA,605,615,-10
2016,7,MD,568,604,-36
2016,7,ME,83,87,-4
2016,7,MI,205,205,0
2016,7,MN,141,140,1
2016,7,MO,221,198,23
2016,7,MS,778,804,-26
2016,7,MT,64,72,-8
2016,7,NC,1500,1537,-37
2016,7,ND,235,352,-117
2016,7,NE,101,114,-13
2016,7,NH,71,88,-17
2016,7,NJ,2085,2146,-61
2016,7,NM,103,104,-1
2016,7,NV,190,191,-1
2016,7,NY,2758,2815,-57
2016,7,OH,468,516,-48
2016,7,OK,158,164,-6
2016,7,OR,373,354,19
2016,7,PA,997,1029,-32
2016,7,PR,31,35,-4
2016,7,RI,107,105,2
2016,7,SC,2205,2151,54
2016,7,SD,48,53,-5
2016,7,TN,290,307,-17
2016,7,TX,5935,6091,-156
2016,7,UT,67,62,5
2016,7,VA,1130,1181,-51
2016,7,VI,46,48,-2
2016,7,VT,46,39,7
2016,7,WA,560,564,-4
2016,7,WI,130,134,-4
2016,7,WV,185,199,-14
2016,7,WY,18,24,-6
2016,8,AK,32,31,1
2016,8,AL,524,514,10
2016,8,AR,155,148,7
2016,8,AZ,379,353,26
2016,8,CA,3391,3100,291
2016,8,CO,220,226,-6
2016,8,CT,307,322,-15
2016,8,DC,30,30,0
2016,8,DE,243,246,-3
2016,8,FL,21985,22795,-810
2016,8,GA,1896,1890,6
2016,8,HI,1559,1566,-7
2016,8,IA,189,189,0
2016,8,ID,88,85,3
2016,8,IL,386,377,9
2016,8,IN,280,291,-11
2016,8,KS,102,111,-9
2016,8,KY,235,233,2
2016,8,LA,6666,6522,144
2016,8,MA,516,544,-28
2016,8,MD,593,618,-25
2016,8,ME,86,83,3
2016,8,MI,213,225,-12
2016,8,MN,156,162,-6
2016,8,MO,247,226,21
2016,8,MP,1,0,1
2016,8,MS,1015,1062,-47
2016,8,MT,93,97,-4
2016,8,NC,1745,1749,-4
2016,8,ND,252,286,-34
2016,8,NE,97,103,-6
2016,8,NH,73,87,-14
2016,8,NJ,2389,2424,-35
2016,8,NM,104,104,0
2016,8,NV,295,305,-10
2016,8,NY,2677,2702,-25
2016,8,OH,381,384,-3
2016,8,OK,158,167,-9
2016,8,OR,388,387,1
2016,8,PA,962,1001,-39
2016,8,PR,32,43,-11
2016,8,RI,175,181,-6
2016,8,SC,2250,2230,20
2016,8,SD,76,80,-4
2016,8,TN,413,437,-24
2016,8,TX,7083,7272,-189
2016,8,UT,76,82,-6
2016,8,VA,1289,1321,-32
2016,8,VI,5,6,-1
2016,8,VT,30,28,2
2016,8,WA,469,457,12
2016,8,WI,148,145,3
2016,8,WV,184,194,-10
2016,8,WY,30,29,1
2016,9,AK,30,31,-1
2016,9,AL,503,499,4
2016,9,AR,148,146,2
2016,9,AZ,338,342,-4
2016,9,CA,3047,2820,227
2016,9,CO,319,303,16
2016,9,CT,415,425,-10
2016,9,DC,44,46,-2
2016,9,DE,231,234,-3
2016,9,FL,26727,27474,-747
2016,9,GA,1142,1147,-5
2016,9,GU,4,4,0
2016,9,HI,917,917,0
2016,9,IA,201,201,0
2016,9,ID,97,87,10
2016,9,IL,467,470,-3
2016,9,IN,274,274,0
2016,9,KS,103,107,-4
2016,9,KY,192,193,-1
2016,9,LA,8078,7994,84
2016,9,MA,622,459,163
2016,9,MD,1189,1210,-21
2016,9,ME,96,103,-7
2016,9,MI,190,206,-16
2016,9,MN,225,239,-14
2016,9,MO,258,213,45
2016,9,MS,927,939,-12
2016,9,MT,82,76,6
2016,9,NC,1890,1934,-44
2016,9,ND,395,428,-33
2016,9,NE,91,99,-8
2016,9,NH,70,70,0
2016,9,NJ,2241,2282,-41
2016,9,NM,139,134,5
2016,9,NV,176,165,11
2016,9,NY,2287,2310,-23
2016,9,OH,368,380,-12
2016,9,OK,141,156,-15
2016,9,OR,370,356,14
2016,9,PA,1363,1385,-22
2016,9,PR,28,29,-1
2016,9,RI,291,300,-9
2016,9,SC,2544,2488,56
2016,9,SD,50,50,0
2016,9,TN,437,459,-22
2016,9,TX,6687,6743,-56
2016,9,UT,59,44,15
2016,9,VA,1065,1072,-7
2016,9,VI,8,8,0
2016,9,VT,60,61,-1
2016,9,WA,557,564,-7
2016,9,WI,127,135,-8
2016,9,WV,146,163,-17
2016,9,WY,70,72,-2
2016,10,AK,23,27,-4
2016,10,AL,474,472,2
2016,10,AR,156,156,0
2016,10,AZ,275,260,15
2016,10,CA,2728,2627,101
2016,10,CO,276,287,-11
2016,10,CT,339,369,-30
2016,10,DC,21,24,-3
2016,10,DE,237,252,-15
2016,10,FL,21542,22192,-650
2016,10,GA,1065,1108,-43
2016,10,GU,1,1,0
2016,10,HI,1085,1264,-179
2016,10,IA,227,248,-21
2016,10,ID,131,134,-3
2016,10,IL,549,565,-16
2016,10,IN,271,304,-33
2016,10,KS,121,109,12
2016,10,KY,202,197,5
2016,10,LA,6278,6252,26
2016,10,MA,907,546,361
2016,10,MD,508,570,-62
2016,10,ME,104,115,-11
2016,10,MI,210,223,-13
2016,10,MN,259,289,-30
2016,10,MO,237,217,20
2016,10,MS,915,965,-50
2016,10,MT,87,79,8
2016,10,NC,1456,1511,-55
2016,10,ND,458,519,-61
2016,10,NE,92,94,-2
2016,10,NH,114,125,-11
2016,10,NJ,2103,2134,-31
2016,10,NM,115,113,2
2016,10,NV,156,257,-101
2016,10,NY,2859,2926,-67
2016,10,OH,338,357,-19
2016,10,OK,185,193,-8
2016,10,OR,307,306,1
2016,10,PA,811,860,-49
2016,10,PR,29,37,-8
2016,10,RI,138,144,-6
2016,10,SC,2303,2253,50
2016,10,SD,63,62,1
2016,10,TN,375,382,-7
2016,10,TX,6170,6294,-124
2016,10,UT,47,48,-1
2016,10,VA,1164,1206,-42
2016,10,VI,12,12,0
2016,10,VT,57,53,4
2016,10,WA,468,489,-21
2016,10,WI,168,171,-3
2016,10,WV,151,163,-12
2016,10,WY,27,24,3
2016,11,AK,30,27,3
2016,11,AL,627,618,9
2016,11,AR,139,153,-14
2016,11,AZ,326,332,-6
2016,11,CA,2548,2493,55
2016,11,CO,274,275,-1
2016,11,CT,385,433,-48
2016,11,DC,31,32,-1
2016,11,DE,270,270,0
2016,11,FL,21022,22084,-1062
2016,11,GA,1033,1050,-17
2016,11,GU,1,1,0
2016,11,HI,1073,1066,7
2016,11,IA,232,260,-28
2016,11,ID,94,91,3
2016,11,IL,454,465,-11
2016,11,IN,344,373,-29
2016,11,KS,131,131,0
2016,11,KY,265,258,7
2016,11,LA,6302,6240,62
2016,11,MA,799,861,-62
2016,11,MD,1027,1037,-10
2016,11,ME,94,108,-14
2016,11,MI,223,229,-6
2016,11,MN,295,336,-41
2016,11,MO,278,242,36
2016,11,MS,1108,1118,-10
2016,11,MT,129,93,36
2016,11,NC,1597,1637,-40
2016,11,ND,482,565,-83
2016,11,NE,109,103,6
2016,11,NH,80,97,-17
2016,11,NJ,2236,2138,98
2016,11,NM,124,124,0
2016,11,NV,173,173,0
2016,11,NY,2288,2341,-53
2016,11,OH,459,546,-87
2016,11,OK,173,176,-3
2016,11,OR,299,318,-19
2016,11,PA,887,931,-44
2016,11,PR,25,41,-16
2016,11,RI,106,117,-11
2016,11,SC,3101,3151,-50
2016,11,SD,82,84,-2
2016,11,TN,439,466,-27
2016,11,TX,6402,6576,-174
2016,11,UT,63,66,-3
2016,11,VA,1116,1170,-54
2016,11,VI,31,27,4
2016,11,VT,63,64,-1
2016,11,WA,468,479,-11
2016,11,WI,149,158,-9
2016,11,WV,168,198,-30
2016,11,WY,26,23,3
2016,12,AK,25,25,0
2016,12,AL,768,782,-14
2016,12,AR,185,173,12
2016,12,AZ,287,300,-13
2016,12,CA,2937,2875,62
2016,12,CO,304,349,-45
2016,12,CT,437,406,31
2016,12,DC,33,34,-1
2016,12,DE,292,294,-2
2016,12,FL,23303,23918,-615
2016,12,GA,1243,1270,-27
2016,12,HI,918,918,0
2016,12,IA,274,324,-50
2016,12,ID,128,131,-3
2016,12,IL,613,661,-48
2016,12,IN,326,320,6
2016,12,KS,123,125,-2
2016,12,KY,248,240,8
2016,12,LA,6755,6604,151
2016,12,MA,730,831,-101
2016,12,MD,1058,1009,49
2016,12,ME,105,115,-10
2016,12,MI,288,323,-35
2016,12,MN,354,401,-47
2016,12,MO,345,347,-2
2016,12,MS,1159,1193,-34
2016,12,MT,170,116,54
2016,12,NC,1751,1779,-28
2016,12,ND,606,697,-91
2016,12,NE,125,144,-19
2016,12,NH,87,103,-16
2016,12,NJ,1931,1985,-54
2016,12,NM,136,142,-6
2016,12,NV,152,149,3
2016,12,NY,2420,2486,-66
2016,12,OH,427,436,-9
2016,12,OK,169,172,-3
2016,12,OR,320,334,-14
2016,12,PA,1180,1221,-41
2016,12,PR,35,39,-4
2016,12,RI,173,178,-5
2016,12,SC,2299,2291,8
2016,12,SD,117,125,-8
2016,12,TN,409,435,-26
2016,12,TX,7027,7068,-41
2016,12,UT,60,64,-4
2016,12,VA,1731,1869,-138
2016,12,VI,6,5,1
2016,12,VT,38,42,-4
2016,12,WA,382,386,-4
2016,12,WI,194,200,-6
2016,12,WV,190,206,-16
2016,12,WY,29,28,1
2016,13,AK,38,43,-5
2016,13,AL,972,967,5
2016,13,AR,268,272,-4
2016,13,AZ,374,364,10
2016,13,CA,2673,2631,42
2016,13,CO,334,343,-9
2016,13,CT,431,446,-15
2016,13,DC,40,39,1
2016,13,DE,269,275,-6
2016,13,FL,32414,34555,-2141
2016,13,GA,1492,1553,-61
2016,13,HI,348,378,-30
2016,13,IA,275,293,-18
2016,13,ID,99,92,7
2016,13,IL,659,992,-333
2016,13,IN,346,345,1
2016,13,KS,173,165,8
2016,13,KY,288,266,22
2016,13,LA,9848,9758,90
2016,13,MA,738,773,-35
2016,13,MD,861,903,-42
2016,13,ME,131,147,-16
2016,13,MI,281,284,-3
2016,13,MN,379,455,-76
2016,13,MO,330,320,10
2016,13,MS,1171,1203,-32
2016,13,MT,160,117,43
2016,13,NC,2110,2151,-41
2016,13,ND,482,539,-57
2016,13,NE,188,154,34
2016,13,NH,106,124,-18
2016,13,NJ,2557,2617,-60
2016,13,NM,131,135,-4
2016,13,NV,150,156,-6
2016,13,NY,3108,3189,-81
2016,13,OH,479,499,-20
2016,13,OK,213,233,-20
2016,13,OR,596,600,-4
2016,13,PA,1001,1019,-18
2016,13,PR,38,42,-4
2016,13,RI,170,170,0
2016,13,SC,3919,3707,212
2016,13,SD,105,114,-9
2016,13,TN,502,521,-19
2016,13,TX,8459,8696,-237
2016,13,UT,81,83,-2
2016,13,VA,1724,1779,-55
2016,13,VI,7,6,1
2016,13,VT,49,48,1
2016,13,WA,495,497,-2
2016,13,WI,201,236,-35
2016,13,WV,242,268,-26
2016,13,WY,32,32,0
2016,14,AK,31,37,-6
2016,14,AL,537,559,-22
2016,14,AR,171,165,6
2016,14,AZ,242,264,-22
2016,14,CA,2340,2233,107
2016,14,CO,292,298,-6
2016,14,CT,340,357,-17
2016,14,DC,31,31,0
2016,14,DE,256,267,-11
2016,14,FL,20561,21363,-802
2016,14,GA,1762,1779,-17
2016,14,GU,1,2,-1
2016,14,HI,561,574,-13
2016,14,IA,278,308,-30
2016,14,ID,79,79,0
2016,14,IL,479,476,3
2016,14,IN,294,309,-15
2016,14,KS,127,129,-2
2016,14,KY,243,243,0
2016,14,LA,7758,7366,392
2016,14,MA,472,497,-25
2016,14,MD,807,835,-28
2016,14,ME,127,142,-15
2016,14,MI,215,223,-8
2016,14,MN,388,431,-43
2016,14,MO,314,289,25
2016,14,MS,1122,1142,-20
2016,14,MT,122,146,-24
2016,14,NC,1811,1836,-25
2016,14,ND,352,408,-56
2016,14,NE,120,88,32
2016,14,NH,101,110,-9
2016,14,NJ,2018,2075,-57
2016,14,NM,106,114,-8
2016,14,NV,124,127,-3
2016,14,NY,2258,2266,-8
2016,14,OH,403,438,-35
2016,14,OK,187,184,3
2016,14,OR,261,271,-10
2016,14,PA,760,774,-14
2016,14,PR,33,37,-4
2016,14,RI,192,196,-4
2016,14,SC,2265,2230,35
2016,14,SD,87,87,0
2016,14,TN,627,622,5
2016,14,TX,7091,6909,182
2016,14,UT,60,64,-4
2016,14,VA,1115,1125,-10
2016,14,VI,2,4,-2
2016,14,VT,39,40,-1
2016,14,WA,384,365,19
2016,14,WI,203,215,-12
2016,14,WV,185,199,-14
2016,14,WY,52,54,-2
2016,15,AK,31,33,-2
2016,15,AL,1048,1056,-8
2016,15,AR,269,177,92
2016,15,AZ,344,344,0
2016,15,CA,2287,2267,20
2016,15,CO,336,335,1
2016,15,CT,428,467,-39
2016,15,DC,22,22,0
2016,15,DE,285,285,0
2016,15,FL,30214,31289,-1075
2016,15,GA,1186,1198,-12
2016,15,HI,368,366,2
2016,15,IA,230,260,-30
2016,15,ID,81,88,-7
2016,15,IL,563,565,-2
2016,15,IN,307,323,-16
2016,15,KS,173,171,2
2016,15,KY,274,271,3
2016,15,LA,8806,7386,1420
2016,15,MA,820,594,226
2016,15,MD,650,656,-6
2016,15,ME,119,131,-12
2016,15,MI,231,240,-9
2016,15,MN,245,275,-30
2016,15,MO,300,303,-3
2016,15,MS,1248,1212,36
2016,15,MT,91,100,-9
2016,15,NC,1922,1951,-29
2016,15,ND,422,473,-51
2016,15,NE,125,125,0
2016,15,NH,91,105,-14
2016,15,NJ,2371,2331,40
2016,15,NM,131,137,-6
2016,15,NV,121,103,18
2016,15,NY,2195,2218,-23
2016,15,OH,406,415,-9
2016,15,OK,209,201,8
2016,15,OR,328,341,-13
2016,15,PA,834,855,-21
2016,15,PR,38,48,-10
2016,15,RI,134,136,-2
2016,15,SC,2517,2426,91
2016,15,SD,96,96,0
2016,15,TN,431,440,-9
2016,15,TX,7742,7575,167
2016,15,UT,49,55,-6
2016,15,VA,1306,1327,-21
2016,15,VI,57,59,-2
2016,15,VT,73,72,1
2016,15,WA,414,419,-5
2016,15,WI,250,255,-5
2016,15,WV,179,187,-8
2016,15,WY,36,36,0
2016,16,AK,33,37,-4
2016,16,AL,809,824,-15
2016,16,AR,198,183,15
2016,16,AZ,302,296,6
2016,16,CA,2235,2256,-21
2016,16,CO,395,417,-22
2016,16,CT,388,410,-22
2016,16,DC,26,20,6
2016,16,DE,301,306,-5
2016,16,FL,25194,26130,-936
2016,16,GA,1126,1145,-19
2016,16,GU,1,1,0
2016,16,HI,933,955,-22
2016,16,IA,226,236,-10
2016,16,ID,92,90,2
2016,16,IL,528,550,-22
2016,16,IN,361,353,8
2016,16,KS,141,151,-10
2016,16,KY,247,239,8
2016,16,LA,8446,7606,840
2016,16,MA,590,585,5
2016,16,MD,623,655,-32
2016,16,ME,98,103,-5
2016,16,MI,211,223,-12
2016,16,MN,171,180,-9
2016,16,MO,371,349,22
2016,16,MS,1265,1239,26
2016,16,MT,94,105,-11
2016,16,NC,1790,1845,-55
2016,16,ND,211,236,-25
2016,16,NE,113,113,0
2016,16,NH,90,95,-5
2016,16,NJ,2294,2353,-59
2016,16,NM,138,145,-7
2016,16,NV,130,135,-5
2016,16,NY,2606,2653,-47
2016,16,OH,459,465,-6
2016,16,OK,215,222,-7
2016,16,OR,299,312,-13
2016,16,PA,721,719,2
2016,16,PR,24,30,-6
2016,16,RI,142,142,0
2016,16,SC,2623,2614,9
2016,16,SD,49,44,5
2016,16,TN,417,383,34
2016,16,TX,9021,8852,169
2016,16,UT,69,68,1
2016,16,VA,1252,1324,-72
2016,16,VI,8,10,-2
2016,16,VT,51,57,-6
2016,16,WA,398,400,-2
2016,16,WI,188,205,-17
2016,16,WV,178,192,-14
2016,16,WY,46,54,-8
2016,17,AK,48,50,-2
2016,17,AL,1485,1484,1
2016,17,AR,171,194,-23
2016,17,AZ,383,385,-2
2016,17,CA,2706,2751,-45
2016,17,CO,466,483,-17
2016,17,CT,479,498,-19
2016,17,DC,30,32,-2
2016,17,DE,352,358,-6
2016,17,FL,37512,38607,-1095
2016,17,GA,1444,1495,-51
2016,17,HI,1926,1663,263
2016,17,IA,190,194,-4
2016,17,ID,75,71,4
2016,17,IL,534,510,24
2016,17,IN,342,351,-9
2016,17,KS,185,178,7
2016,17,KY,259,261,-2
2016,17,LA,11059,10609,450
2016,17,MA,736,707,29
2016,17,MD,831,867,-36
2016,17,ME,150,152,-2
2016,17,MI,263,248,15
2016,17,MN,166,172,-6
2016,17,MO,348,349,-1
2016,17,MS,1329,1361,-32
2016,17,MT,86,86,0
2016,17,NC,2303,2359,-56
2016,17,ND,181,200,-19
2016,17,NE,113,118,-5
2016,17,NH,90,99,-9
2016,17,NJ,2894,3007,-113
2016,17,NM,146,155,-9
2016,17,NV,139,133,6
2016,17,NY,2435,2481,-46
2016,17,OH,463,452,11
2016,17,OK,223,220,3
2016,17,OR,602,596,6
2016,17,PA,928,906,22
2016,17,PR,53,65,-12
2016,17,RI,153,207,-54
2016,17,SC,3193,3215,-22
2016,17,SD,47,42,5
2016,17,TN,460,456,4
2016,17,TX,10018,10096,-78
2016,17,UT,59,63,-4
2016,17,VA,2038,2077,-39
2016,17,VI,9,8,1
2016,17,VT,41,52,-11
2016,17,WA,564,572,-8
2016,17,WI,188,197,-9
2016,17,WV,200,211,-11
2016,17,WY,38,38,0
2016,18,AK,33,36,-3
2016,18,AL,746,746,0
2016,18,AR,181,169,12
2016,18,AZ,304,313,-9
2016,18,CA,2321,2402,-81
2016,18,CO,516,542,-26
2016,18,CT,438,451,-13
2016,18,DC,27,31,-4
2016,18,DE,301,320,-19
2016,18,FL,29438,31241,-1803
2016,18,GA,1261,1259,2
2016,18,GU,1,1,0
2016,18,HI,788,801,-13
2016,18,IA,145,152,-7
2016,18,ID,343,349,-6
2016,18,IL,534,536,-2
2016,18,IN,298,296,2
2016,18,KS,139,134,5
2016,18,KY,254,257,-3
2016,18,LA,9147,8807,340
2016,18,MA,615,562,53
2016,18,MD,682,689,-7
2016,18,ME,92,93,-1
2016,18,MI,216,224,-8
2016,18,MN,143,152,-9
2016,18,MO,254,258,-4
2016,18,MS,1258,1260,-2
2016,18,MT,75,80,-5
2016,18,NC,2081,2220,-139
2016,18,ND,114,120,-6
2016,18,NE,123,120,3
2016,18,NH,76,80,-4
2016,18,NJ,2131,2169,-38
2016,18,NM,130,145,-15
2016,18,NV,115,113,2
2016,18,NY,2755,2792,-37
2016,18,OH,329,360,-31
2016,18,OK,205,207,-2
2016,18,OR,462,329,133
2016,18,PA,755,717,38
2016,18,PR,42,46,-4
2016,18,RI,140,144,-4
2016,18,SC,2835,2912,-77
2016,18,SD,77,84,-7
2016,18,TN,325,338,-13
2016,18,TX,9177,9244,-67
2016,18,UT,139,140,-1
2016,18,VA,1328,1344,-16
2016,18,VI,13,13,0
2016,18,VT,47,44,3
2016,18,WA,402,401,1
2016,18,WI,142,140,2
2016,18,WV,134,149,-15
2016,18,WY,34,40,-6
2016,19,AK,34,36,-2
2016,19,AL,688,693,-5
2016,19,AR,161,161,0
2016,19,AZ,279,281,-2
2016,19,CA,2043,2062,-19
2016,19,CO,332,336,-4
2016,19,CT,349,355,-6
2016,19,DC,27,29,-2
2016,19,DE,326,328,-2
2016,19,FL,25882,26867,-985
2016,19,GA,1161,1169,-8
2016,19,HI,409,416,-7
2016,19,IA,125,136,-11
2016,19,ID,98,88,10
2016,19,IL,402,408,-6
2016,19,IN,250,243,7
2016,19,KS,124,144,-20
2016,19,KY,224,232,-8
2016,19,LA,7930,7610,320
2016,19,MA,718,646,72
2016,19,MD,700,727,-27
2016,19,ME,86,85,1
2016,19,MI,210,225,-15
2016,19,MN,99,103,-4
2016,19,MO,261,265,-4
2016,19,MS,1224,1241,-17
2016,19,MT,85,89,-4
2016,19,NC,1801,1817,-16
2016,19,ND,89,102,-13
2016,19,NE,83,79,4
2016,19,NH,76,89,-13
2016,19,NJ,2220,2313,-93
2016,19,NM,92,93,-1
2016,19,NV,100,99,1
2016,19,NY,2707,2738,-31
2016,19,OH,353,362,-9
2016,19,OK,197,201,-4
2016,19,OR,251,254,-3
2016,19,PA,823,747,76
2016,19,PR,30,36,-6
2016,19,RI,141,142,-1
2016,19,SC,2465,2484,-19
2016,19,SD,56,57,-1
2016,19,TN,322,307,15
2016,19,TX,8602,8720,-118
2016,19,UN,1,1,0
2016,19,UT,52,52,0
2016,19,VA,1262,1310,-48
2016,19,VI,8,10,-2
2016,19,VT,44,43,1
2016,19,WA,331,327,4
2016,19,WI,135,156,-21
2016,19,WV,144,156,-12
2016,19,WY,39,39,0
2016,20,AK,32,34,-2
2016,20,AL,932,922,10
2016,20,AR,189,190,-1
2016,20,AZ,321,313,8
2016,20,CA,1924,2000,-76
2016,20,CO,396,420,-24
2016,20,CT,402,409,-7
2016,20,DC,22,24,-2
2016,20,DE,340,369,-29
2016,20,FL,28738,29593,-855
2016,20,GA,1329,1352,-23
2016,20,GU,1,1,0
2016,20,HI,629,629,0
2016,20,IA,247,245,2
2016,20,ID,83,85,-2
2016,20,IL,604,631,-27
2016,20,IN,272,284,-12
2016,20,KS,151,148,3
2016,20,KY,283,282,1
2016,20,LA,9197,8720,477
2016,20,MA,695,619,76
2016,20,MD,671,689,-18
2016,20,ME,77,81,-4
2016,20,MI,212,231,-19
2016,20,MN,127,135,-8
2016,20,MO,276,282,-6
2016,20,MS,1347,1377,-30
2016,20,MT,86,93,-7
2016,20,NC,2261,2281,-20
2016,20,ND,98,109,-11
2016,20,NE,89,86,3
2016,20,NH,84,92,-8
2016,20,NJ,2588,2644,-56
2016,20,NM,135,148,-13
2016,20,NV,132,128,4
2016,20,NY,2790,2758,32
2016,20,OH,316,312,4
2016,20,OK,244,246,-2
2016,20,OR,301,288,13
2016,20,PA,712,672,40
2016,20,PR,35,40,-5
2016,20,RI,140,144,-4
2016,20,SC,3504,3514,-10
2016,20,SD,98,100,-2
2016,20,TN,349,347,2
2016,20,TX,14743,10740,4003
2016,20,UT,59,57,2
2016,20,VA,1777,1778,-1
2016,20,VI,7,8,-1
2016,20,VT,46,48,-2
2016,20,WA,362,358,4
2016,20,WI,144,155,-11
2016,20,WV,145,157,-12
2016,20,WY,38,38,0
2016,21,AK,26,31,-5
2016,21,AL,1085,1104,-19
2016,21,AR,175,182,-7
2016,21,AZ,324,320,4
2016,21,CA,2013,1944,69
2016,21,CO,497,518,-21
2016,21,CT,416,436,-20
2016,21,DC,13,15,-2
2016,21,DE,463,479,-16
2016,21,FL,29531,29980,-449
2016,21,GA,1332,1347,-15
2016,21,GU,2,2,0
2016,21,HI,1142,1203,-61
2016,21,IA,149,162,-13
2016,21,ID,65,68,-3
2016,21,IL,459,505,-46
2016,21,IN,283,294,-11
2016,21,KS,146,147,-1
2016,21,KY,243,232,11
2016,21,LA,9677,9517,160
2016,21,MA,582,556,26
2016,21,MD,817,848,-31
2016,21,ME,96,97,-1
2016,21,MI,203,202,1
2016,21,MN,113,110,3
2016,21,MO,260,269,-9
2016,21,MS,1439,1482,-43
2016,21,MT,85,94,-9
2016,21,NC,2316,2364,-48
2016,21,ND,83,113,-30
2016,21,NE,124,121,3
2016,21,NH,74,79,-5
2016,21,NJ,2732,2783,-51
2016,21,NM,117,117,0
2016,21,NV,213,120,93
2016,21,NY,3048,3099,-51
2016,21,OH,345,374,-29
2016,21,OK,192,195,-3
2016,21,OR,329,285,44
2016,21,PA,883,851,32
2016,21,PR,46,54,-8
2016,21,RI,190,199,-9
2016,21,SC,3697,3699,-2
2016,21,SD,63,58,5
2016,21,TN,454,486,-32
2016,21,TX,14766,11341,3425
2016,21,UN,1,1,0
2016,21,UT,52,51,1
2016,21,VA,1422,1495,-73
2016,21,VI,11,24,-13
2016,21,VT,28,32,-4
2016,21,WA,395,414,-19
2016,21,WI,179,164,15
2016,21,WV,137,150,-13
2016,21,WY,39,38,1
2016,22,AK,37,35,2
2016,22,AL,891,930,-39
2016,22,AR,285,302,-17
2016,22,AZ,353,359,-6
2016,22,CA,2076,2158,-82
2016,22,CO,366,378,-12
2016,22,CT,423,451,-28
2016,22,DC,35,36,-1
2016,22,DE,437,437,0
2016,22,FL,38573,40459,-1886
2016,22,GA,2014,2079,-65
2016,22,HI,1452,1458,-6
2016,22,IA,182,188,-6
2016,22,ID,64,59,5
2016,22,IL,509,533,-24
2016,22,IN,289,304,-15
2016,22,KS,172,164,8
2016,22,KY,278,275,3
2016,22,LA,11589,11472,117
2016,22,MA,822,763,59
2016,22,MD,832,841,-9
2016,22,ME,107,109,-2
2016,22,MI,186,192,-6
2016,22,MN,132,133,-1
2016,22,MO,255,270,-15
2016,22,MS,1645,1671,-26
2016,22,MT,84,91,-7
2016,22,NC,2564,2615,-51
2016,22,ND,134,147,-13
2016,22,NE,113,111,2
2016,22,NH,94,106,-12
2016,22,NJ,3512,3559,-47
2016,22,NM,116,122,-6
2016,22,NV,112,114,-2
2016,22,NY,2886,2816,70
2016,22,OH,382,402,-20
2016,22,OK,248,267,-19
2016,22,OR,389,414,-25
2016,22,PA,829,840,-11
2016,22,PR,33,39,-6
2016,22,RI,175,191,-16
2016,22,SC,3447,3708,-261
2016,22,SD,98,108,-10
2016,22,TN,647,679,-32
2016,22,TX,15984,14154,1830
2016,22,UN,1,1,0
2016,22,UT,91,97,-6
2016,22,VA,2184,2267,-83
2016,22,VI,6,7,-1
2016,22,VT,28,31,-3
2016,22,WA,402,407,-5
2016,22,WI,153,166,-13
2016,22,WV,155,159,-4
2016,22,WY,43,45,-2
2016,23,AK,26,28,-2
2016,23,AL,1138,1150,-12
2016,23,AR,210,223,-13
2016,23,AZ,332,330,2
2016,23,CA,1993,2043,-50
2016,23,CO,437,489,-52
2016,23,CT,367,362,5
2016,23,DC,259,260,-1
2016,23,DE,345,362,-17
2016,23,FL,28838,29918,-1080
2016,23,GA,1267,1297,-30
2016,23,GU,1,2,-1
2016,23,HI,814,806,8
2016,23,IA,159,161,-2
2016,23,ID,62,59,3
2016,23,IL,481,501,-20
2016,23,IN,299,267,32
2016,23,KS,134,130,4
2016,23,KY,298,298,0
2016,23,LA,9951,9783,168
2016,23,MA,806,775,31
2016,23,MD,654,698,-44
2016,23,ME,97,93,4
2016,23,MI,191,200,-9
2016,23,MN,100,106,-6
2016,23,MO,290,301,-11
2016,23,MS,1422,1411,11
2016,23,MT,79,83,-4
2016,23,NC,2114,2219,-105
2016,23,ND,128,126,2
2016,23,NE,112,111,1
2016,23,NH,72,78,-6
2016,23,NJ,2280,2288,-8
2016,23,NM,94,91,3
2016,23,NV,135,135,0
2016,23,NY,2639,2707,-68
2016,23,OH,364,382,-18
2016,23,OK,281,328,-47
2016,23,OR,270,278,-8
2016,23,PA,707,731,-24
2016,23,PR,39,52,-13
2016,23,RI,153,155,-2
2016,23,SC,3650,3611,39
2016,23,SD,57,63,-6
2016,23,TN,693,748,-55
2016,23,TX,13847,13138,709
2016,23,UT,56,58,-2
2016,23,VA,1459,1619,-160
2016,23,VI,16,19,-3
2016,23,VT,31,33,-2
2016,23,WA,333,407,-74
2016,23,WI,123,130,-7
2016,23,WV,117,129,-12
2016,23,WY,34,35,-1
2016,24,AK,40,40,0
2016,24,AL,799,794,5
2016,24,AR,234,236,-2
2016,24,AZ,331,331,0
2016,24,CA,2119,2204,-85
2016,24,CO,614,664,-50
2016,24,CT,404,423,-19
2016,24,DC,24,30,-6
2016,24,DE,356,364,-8
2016,24,FL,32795,34076,-1281
2016,24,GA,1516,1549,-33
2016,24,HI,807,817,-10
2016,24,IA,158,154,4
2016,24,ID,67,70,-3
2016,24,IL,632,671,-39
2016,24,IN,281,265,16
2016,24,KS,168,181,-13
2016,24,KY,276,286,-10
2016,24,LA,10551,10394,157
2016,24,MA,662,632,30
2016,24,MD,801,810,-9
2016,24,ME,94,107,-13
2016,24,MI,231,237,-6
2016,24,MN,115,122,-7
2016,24,MO,260,280,-20
2016,24,MS,1560,1555,5
2016,24,MT,83,92,-9
2016,24,NC,2130,2160,-30
2016,24,ND,125,123,2
2016,24,NE,123,122,1
2016,24,NH,89,95,-6
2016,24,NJ,2380,2499,-119
2016,24,NM,125,127,-2
2016,24,NV,123,126,-3
2016,24,NY,3176,3242,-66
2016,24,OH,398,424,-26
2016,24,OK,228,256,-28
2016,24,OR,300,302,-2
2016,24,PA,761,805,-44
2016,24,PR,30,38,-8
2016,24,RI,205,211,-6
2016,24,SC,3463,3491,-28
2016,24,SD,64,57,7
2016,24,TN,609,642,-33
2016,24,TX,15823,15262,561
2016,24,UT,38,47,-9
2016,24,VA,1774,1837,-63
2016,24,VI,98,100,-2
2016,24,VT,34,35,-1
2016,24,WA,309,324,-15
2016,24,WI,188,204,-16
2016,24,WV,149,162,-13
2016,24,WY,35,32,3
2016,25,AK,29,37,-8
2016,25,AL,991,992,-1
2016,25,AR,155,154,1
2016,25,AZ,439,457,-18
2016,25,CA,1909,2044,-135
2016,25,CO,320,337,-17
2016,25,CT,434,448,-14
2016,25,DC,45,44,1
2016,25,DE,358,369,-11
2016,25,FL,32407,33388,-981
2016,25,GA,1536,1554,-18
2016,25,GU,1,2,-1
2016,25,HI,1247,1251,-4
2016,25,IA,121,120,1
2016,25,ID,72,76,-4
2016,25,IL,383,406,-23
2016,25,IN,283,271,12
2016,25,KS,146,155,-9
2016,25,KY,219,217,2
2016,25,LA,10350,10185,165
2016,25,MA,604,578,26
2016,25,MD,891,913,-22
2016,25,ME,111,113,-2
2016,25,MI,199,201,-2
2016,25,MN,116,116,0
2016,25,MO,261,277,-16
2016,25,MS,1413,1431,-18
2016,25,MT,88,88,0
2016,25,NC,2816,2868,-52
2016,25,ND,139,154,-15
2016,25,NE,100,97,3
2016,25,NH,64,68,-4
2016,25,NJ,2963,2974,-11
2016,25,NM,120,125,-5
2016,25,NV,112,112,0
2016,25,NY,2657,2676,-19
2016,25,OH,400,412,-12
2016,25,OK,237,285,-48
2016,25,OR,249,265,-16
2016,25,PA,723,739,-16
2016,25,PR,31,36,-5
2016,25,RI,185,193,-8
2016,25,SC,3677,3760,-83
2016,25,SD,67,77,-10
2016,25,TN,509,550,-41
2016,25,TX,17404,17258,146
2016,25,UT,52,54,-2
2016,25,VA,1910,1977,-67
2016,25,VI,8,10,-2
2016,25,VT,34,35,-1
2016,25,WA,351,350,1
2016,25,WI,114,117,-3
2016,25,WV,157,159,-2
2016,25,WY,30,32,-2
2016,26,AK,30,33,-3
2016,26,AL,1163,1213,-50
2016,26,AR,230,212,18
2016,26,AZ,460,498,-38
2016,26,CA,2151,2346,-195
2016,26,CO,415,457,-42
2016,26,CT,597,618,-21
2016,26,DC,48,49,-1
2016,26,DE,650,471,179
2016,26,FL,44896,46803,-1907
2016,26,GA,2164,2218,-54
2016,26,GU,2,1,1
2016,26,HI,1792,1791,1
2016,26,IA,316,337,-21
2016,26,ID,73,82,-9
2016,26,IL,595,634,-39
2016,26,IN,332,321,11
2016,26,KS,212,204,8
2016,26,KY,242,245,-3
2016,26,LA,15141,14851,290
2016,26,MA,1082,1064,18
2016,26,MD,2023,2186,-163
2016,26,ME,125,134,-9
2016,26,MI,246,270,-24
2016,26,MN,118,122,-4
2016,26,MO,305,317,-12
2016,26,MS,1656,1662,-6
2016,26,MT,181,183,-2
2016,26,NC,3144,3214,-70
2016,26,ND,241,266,-25
2016,26,NE,178,176,2
2016,26,NH,93,99,-6
2016,26,NJ,3523,3587,-64
2016,26,NM,138,142,-4
2016,26,NV,143,152,-9
2016,26,NY,3829,3900,-71
2016,26,OH,510,553,-43
2016,26,OK,301,353,-52
2016,26,OR,309,317,-8
2016,26,PA,903,968,-65
2016,26,PR,53,57,-4
2016,26,RI,232,239,-7
2016,26,SC,5001,4968,33
2016,26,SD,142,151,-9
2016,26,TN,544,572,-28
2016,26,TX,32254,26509,5745
2016,26,UT,56,61,-5
2016,26,VA,2770,2893,-123
2016,26,VI,8,8,0
2016,26,VT,59,57,2
2016,26,WA,369,384,-15
2016,26,WI,155,158,-3
2016,26,WV,177,188,-11
2016,26,WY,24,30,-6
2016,27,AK,23,23,0
2016,27,AL,970,987,-17
2016,27,AR,160,158,2
2016,27,AZ,374,404,-30
2016,27,CA,1687,1763,-76
2016,27,CO,292,334,-42
2016,27,CT,384,389,-5
2016,27,DC,33,32,1
2016,27,DE,301,300,1
2016,27,FL,33270,33407,-137
2016,27,GA,1766,1729,37
2016,27,HI,325,327,-2
2016,27,IA,207,232,-25
2016,27,ID,56,54,2
2016,27,IL,393,402,-9
2016,27,IN,298,272,26
2016,27,KS,146,142,4
2016,27,KY,170,166,4
2016,27,LA,10366,10111,255
2016,27,MA,645,644,1
2016,27,MD,676,701,-25
2016,27,ME,103,105,-2
2016,27,MI,162,170,-8
2016,27,MN,84,99,-15
2016,27,MO,250,255,-5
2016,27,MS,1324,1289,35
2016,27,MT,46,48,-2
2016,27,NC,2507,2530,-23
2016,27,ND,62,67,-5
2016,27,NE,125,124,1
2016,27,NH,84,94,-10
2016,27,NJ,2111,2121,-10
2016,27,NM,132,132,0
2016,27,NV,106,113,-7
2016,27,NY,2421,2521,-100
2016,27,OH,353,364,-11
2016,27,OK,215,239,-24
2016,27,OR,238,254,-16
2016,27,PA,611,634,-23
2016,27,PR,48,52,-4
2016,27,RI,188,195,-7
2016,27,SC,3885,3761,124
2016,27,SD,64,65,-1
2016,27,TN,374,369,5
2016,27,TX,22957,19805,3152
2016,27,UT,53,47,6
2016,27,VA,1916,1921,-5
2016,27,VI,8,9,-1
2016,27,VT,29,28,1
2016,27,WA,286,281,5
2016,27,WI,127,119,8
2016,27,WV,150,145,5
2016,27,WY,34,36,-2
2016,28,AK,35,36,-1
2016,28,AL,828,855,-27
2016,28,AR,165,167,-2
2016,28,AZ,463,478,-15
2016,28,CA,2346,2504,-158
2016,28,CO,382,426,-44
2016,28,CT,456,470,-14
2016,28,DC,25,27,-2
2016,28,DE,330,349,-19
2016,28,FL,34472,35555,-1083
2016,28,GA,1799,1856,-57
2016,28,HI,382,386,-4
2016,28,IA,213,223,-10
2016,28,ID,42,41,1
2016,28,IL,454,516,-62
2016,28,IN,385,368,17
2016,28,KS,182,199,-17
2016,28,KY,268,274,-6
2016,28,LA,10865,10772,93
2016,28,MA,784,759,25
2016,28,MD,1147,1190,-43
2016,28,ME,102,101,1
2016,28,MI,467,494,-27
2016,28,MN,118,126,-8
2016,28,MO,284,307,-23
2016,28,MS,1314,1339,-25
2016,28,MT,82,86,-4
2016,28,NC,2761,2824,-63
2016,28,ND,76,86,-10
2016,28,NE,134,126,8
2016,28,NH,88,91,-3
2016,28,NJ,4021,4110,-89
2016,28,NM,129,131,-2
2016,28,NV,104,111,-7
2016,28,NY,2941,2984,-43
2016,28,OH,402,409,-7
2016,28,OK,243,246,-3
2016,28,OR,332,345,-13
2016,28,PA,715,737,-22
2016,28,PR,53,63,-10
2016,28,RI,227,232,-5
2016,28,SC,3687,3698,-11
2016,28,SD,54,61,-7
2016,28,TN,481,490,-9
2016,28,TX,23455,24064,-609
2016,28,UT,49,55,-6
2016,28,VA,2020,2077,-57
2016,28,VI,7,7,0
2016,28,VT,44,46,-2
2016,28,WA,369,369,0
2016,28,WI,173,178,-5
2016,28,WV,154,164,-10
2016,28,WY,25,24,1
2016,29,AK,40,42,-2
2016,29,AL,777,803,-26
2016,29,AR,169,177,-8
2016,29,AZ,426,459,-33
2016,29,CA,1795,1908,-113
2016,29,CO,299,320,-21
2016,29,CT,435,442,-7
2016,29,DC,29,31,-2
2016,29,DE,335,336,-1
2016,29,FL,29459,30587,-1128
2016,29,GA,1876,1962,-86
2016,29,HI,729,720,9
2016,29,IA,219,230,-11
2016,29,ID,61,62,-1
2016,29,IL,461,503,-42
2016,29,IN,381,372,9
2016,29,KS,142,177,-35
2016,29,KY,241,236,5
2016,29,LA,9774,9558,216
2016,29,MA,810,798,12
2016,29,MD,1243,1266,-23
2016,29,ME,108,118,-10
2016,29,MI,212,222,-10
2016,29,MN,150,154,-4
2016,29,MO,235,266,-31
2016,29,MS,1643,1663,-20
2016,29,MT,88,95,-7
2016,29,NC,2442,2487,-45
2016,29,ND,109,116,-7
2016,29,NE,96,102,-6
2016,29,NH,160,167,-7
2016,29,NJ,2695,2737,-42
2016,29,NM,149,153,-4
2016,29,NV,128,149,-21
2016,29,NY,2697,2817,-120
2016,29,OH,440,488,-48
2016,29,OK,254,291,-37
2016,29,OR,268,272,-4
2016,29,PA,710,772,-62
2016,29,PR,35,45,-10
2016,29,RI,198,201,-3
2016,29,SC,3619,3641,-22
2016,29,SD,55,65,-10
2016,29,TN,402,417,-15
2016,29,TX,19356,19632,-276
2016,29,UT,56,65,-9
2016,29,VA,2004,2265,-261
2016,29,VI,6,6,0
2016,29,VT,50,57,-7
2016,29,WA,361,358,3
2016,29,WI,163,179,-16
2016,29,WV,165,159,6
2016,29,WY,25,28,-3
2016,30,AK,47,44,3
2016,30,AL,918,914,4
2016,30,AR,185,194,-9
2016,30,AZ,446,456,-10
2016,30,CA,2223,2408,-185
2016,30,CO,371,401,-30
2016,30,CT,535,545,-10
2016,30,DC,35,37,-2
2016,30,DE,413,434,-21
2016,30,FL,36975,38333,-1358
2016,30,GA,1903,1951,-48
2016,30,HI,651,659,-8
2016,30,IA,210,214,-4
2016,30,ID,56,65,-9
2016,30,IL,656,686,-30
2016,30,IN,394,395,-1
2016,30,KS,188,186,2
2016,30,KY,259,259,0
2016,30,LA,11309,10923,386
2016,30,MA,846,859,-13
2016,30,MD,1177,1211,-34
2016,30,ME,128,128,0
2016,30,MI,203,222,-19
2016,30,MN,148,157,-9
2016,30,MO,270,291,-21
2016,30,MS,1254,1297,-43
2016,30,MT,48,56,-8
2016,30,NC,2666,2722,-56
2016,30,ND,91,110,-19
2016,30,NE,142,143,-1
2016,30,NH,90,97,-7
2016,30,NJ,2919,3024,-105
2016,30,NM,165,180,-15
2016,30,NV,142,167,-25
2016,30,NY,3336,3400,-64
2016,30,OH,508,541,-33
2016,30,OK,248,252,-4
2016,30,OR,263,263,0
2016,30,PA,841,895,-54
2016,30,PR,46,60,-14
2016,30,RI,239,256,-17
2016,30,SC,4110,4042,68
2016,30,SD,62,73,-11
2016,30,TN,411,432,-21
2016,30,TX,18839,19077,-238
2016,30,UT,48,44,4
2016,30,VA,2542,2641,-99
2016,30,VI,5,6,-1
2016,30,VT,49,57,-8
2016,30,WA,470,480,-10
2016,30,WI,166,173,-7
2016,30,WV,175,151,24
2016,30,WY,24,26,-2
2016,31,AK,28,30,-2
2016,31,AL,1062,1083,-21
2016,31,AR,165,168,-3
2016,31,AZ,405,429,-24
2016,31,CA,2121,2259,-138
2016,31,CO,326,374,-48
2016,31,CT,473,497,-24
2016,31,DC,45,46,-1
2016,31,DE,320,329,-9
2016,31,FL,28777,29622,-845
2016,31,GA,1673,1728,-55
2016,31,HI,1035,1041,-6
2016,31,IA,164,191,-27
2016,31,ID,59,64,-5
2016,31,IL,485,511,-26
2016,31,IN,296,296,0
2016,31,KS,165,153,12
2016,31,KY,243,244,-1
2016,31,LA,8994,8780,214
2016,31,MA,843,864,-21
2016,31,MD,1095,1130,-35
2016,31,ME,94,93,1
2016,31,MI,211,225,-14
2016,31,MN,104,117,-13
2016,31,MO,247,246,1
2016,31,MS,1122,1170,-48
2016,31,MT,48,61,-13
2016,31,NC,2311,2365,-54
2016,31,ND,74,75,-1
2016,31,NE,80,84,-4
2016,31,NH,79,78,1
2016,31,NJ,2884,2895,-11
2016,31,NM,220,192,28
2016,31,NV,143,154,-11
2016,31,NY,2538,2574,-36
2016,31,OH,422,444,-22
2016,31,OK,224,245,-21
2016,31,OR,255,269,-14
2016,31,PA,748,800,-52
2016,31,PR,43,57,-14
2016,31,RI,239,250,-11
2016,31,SC,3666,3669,-3
2016,31,SD,58,71,-13
2016,31,TN,433,439,-6
2016,31,TX,15486,15789,-303
2016,31,UT,57,60,-3
2016,31,VA,2224,2278,-54
2016,31,VI,16,18,-2
2016,31,VT,30,26,4
2016,31,WA,332,328,4
2016,31,WI,138,146,-8
2016,31,WV,154,139,15
2016,31,WY,26,33,-7
2016,32,AK,32,30,2
2016,32,AL,865,882,-17
2016,32,AR,178,186,-8
2016,32,AZ,464,507,-43
2016,32,CA,1967,2151,-184
2016,32,CO,390,430,-40
2016,32,CT,521,519,2
2016,32,DC,30,37,-7
2016,32,DE,406,414,-8
2016,32,FL,30848,31994,-1146
2016,32,GA,1833,1917,-84
2016,32,HI,683,690,-7
2016,32,IA,135,153,-18
2016,32,ID,58,57,1
2016,32,IL,408,440,-32
2016,32,IN,346,353,-7
2016,32,KS,151,148,3
2016,32,KY,259,262,-3
2016,32,LA,9221,8919,302
2016,32,MA,845,868,-23
2016,32,MD,827,849,-22
2016,32,ME,105,106,-1
2016,32,MI,221,226,-5
2016,32,MN,115,126,-11
2016,32,MO,451,466,-15
2016,32,MS,1133,1143,-10
2016,32,MT,51,61,-10
2016,32,NC,2652,2689,-37
2016,32,ND,117,126,-9
2016,32,NE,98,108,-10
2016,32,NH,63,74,-11
2016,32,NJ,3228,3229,-1
2016,32,NM,193,171,22
2016,32,NV,157,168,-11
2016,32,NY,2857,2876,-19
2016,32,OH,419,476,-57
2016,32,OK,235,242,-7
2016,32,OR,273,272,1
2016,32,PA,1050,1083,-33
2016,32,PR,29,35,-6
2016,32,RI,265,268,-3
2016,32,SC,3748,3770,-22
2016,32,SD,43,48,-5
2016,32,TN,468,464,4
2016,32,TX,14948,15129,-181
2016,32,UT,41,40,1
2016,32,VA,1993,2074,-81
2016,32,VI,15,13,2
2016,32,VT,54,56,-2
2016,32,WA,332,319,13
2016,32,WI,157,159,-2
2016,32,WV,200,186,14
2016,32,WY,24,26,-2
2016,33,AK,34,37,-3
2016,33,AL,714,749,-35
2016,33,AR,178,184,-6
2016,33,AZ,467,501,-34
2016,33,CA,2038,2240,-202
2016,33,CO,350,386,-36
2016,33,CT,696,721,-25
2016,33,DC,30,30,0
2016,33,DE,340,342,-2
2016,33,FL,29108,30320,-1212
2016,33,GA,1779,1843,-64
2016,33,GU,1,2,-1
2016,33,HI,1348,1347,1
2016,33,IA,194,192,2
2016,33,ID,56,56,0
2016,33,IL,406,407,-1
2016,33,IN,305,335,-30
2016,33,KS,120,127,-7
2016,33,KY,271,257,14
2016,33,LA,9133,8783,350
2016,33,MA,781,794,-13
2016,33,MD,969,1000,-31
2016,33,ME,116,115,1
2016,33,MI,216,221,-5
2016,33,MN,113,115,-2
2016,33,MO,255,242,13
2016,33,MS,1214,1242,-28
2016,33,MT,82,86,-4
2016,33,NC,2655,2732,-77
2016,33,ND,108,112,-4
2016,33,NE,92,98,-6
2016,33,NH,73,76,-3
2016,33,NJ,3180,3151,29
2016,33,NM,173,167,6
2016,33,NV,166,184,-18
2016,33,NY,2838,2961,-123
2016,33,OH,437,461,-24
2016,33,OK,205,233,-28
2016,33,OR,278,297,-19
2016,33,PA,1109,1134,-25
2016,33,PR,43,75,-32
2016,33,RI,504,526,-22
2016,33,SC,3793,3821,-28
2016,33,SD,69,89,-20
2016,33,TN,455,470,-15
2016,33,TX,15188,15381,-193
2016,33,UT,42,48,-6
2016,33,VA,1997,2199,-202
2016,33,VI,14,15,-1
2016,33,VT,77,77,0
2016,33,WA,397,396,1
2016,33,WI,155,163,-8
2016,33,WV,206,178,28
2016,33,WY,24,27,-3
2016,34,AK,40,35,5
2016,34,AL,1076,1084,-8
2016,34,AR,208,208,0
2016,34,AZ,492,523,-31
2016,34,CA,2240,2638,-398
2016,34,CO,399,388,11
2016,34,CT,520,527,-7
2016,34,DC,22,24,-2
2016,34,DE,547,554,-7
2016,34,FL,28569,29442,-873
2016,34,GA,1594,1658,-64
2016,34,GU,1,1,0
2016,34,HI,2652,2653,-1
2016,34,IA,167,170,-3
2016,34,ID,59,70,-11
2016,34,IL,587,592,-5
2016,34,IN,298,321,-23
2016,34,KS,124,123,1
2016,34,KY,273,278,-5
2016,34,LA,9338,8839,499
2016,34,MA,1143,1128,15
2016,34,MD,853,878,-25
2016,34,ME,130,139,-9
2016,34,MI,213,230,-17
2016,34,MN,95,94,1
2016,34,MO,234,244,-10
2016,34,MS,1193,1200,-7
2016,34,MT,51,53,-2
2016,34,NC,2657,2666,-9
2016,34,ND,143,149,-6
2016,34,NE,98,104,-6
2016,34,NH,82,83,-1
2016,34,NJ,2703,2709,-6
2016,34,NM,175,173,2
2016,34,NV,173,179,-6
2016,34,NY,3279,3399,-120
2016,34,OH,443,466,-23
2016,34,OK,188,188,0
2016,34,OR,366,379,-13
2016,34,PA,796,835,-39
2016,34,PR,35,45,-10
2016,34,RI,302,331,-29
2016,34,SC,4063,3704,359
2016,34,SD,90,99,-9
2016,34,TN,413,409,4
2016,34,TX,12951,13064,-113
2016,34,UT,45,50,-5
2016,34,VA,2181,2221,-40
2016,34,VI,18,15,3
2016,34,VT,50,52,-2
2016,34,WA,374,375,-1
2016,34,WI,180,190,-10
2016,34,WV,196,178,18
2016,34,WY,52,58,-6
2016,35,AK,57,63,-6
2016,35,AL,898,914,-16
2016,35,AR,181,203,-22
2016,35,AZ,492,492,0
2016,35,CA,2450,2769,-319
2016,35,CO,390,422,-32
2016,35,CT,645,685,-40
2016,35,DC,107,103,4
2016,35,DE,375,406,-31
2016,35,FL,32455,33492,-1037
2016,35,GA,1864,1921,-57
2016,35,GU,2,1,1
2016,35,HI,3224,3233,-9
2016,35,IA,169,160,9
2016,35,ID,61,63,-2
2016,35,IL,471,466,5
2016,35,IN,328,325,3
2016,35,KS,155,146,9
2016,35,KY,253,254,-1
2016,35,LA,10260,9745,515
2016,35,MA,1166,1152,14
2016,35,MD,1208,1178,30
2016,35,ME,109,117,-8
2016,35,MI,188,191,-3
2016,35,MN,138,133,5
2016,35,MO,244,248,-4
2016,35,MS,1457,1507,-50
2016,35,MT,54,56,-2
2016,35,NC,3067,3114,-47
2016,35,ND,177,215,-38
2016,35,NE,94,102,-8
2016,35,NH,139,139,0
2016,35,NJ,3326,3350,-24
2016,35,NM,179,179,0
2016,35,NV,191,185,6
2016,35,NY,3547,3631,-84
2016,35,OH,500,559,-59
2016,35,OK,242,231,11
2016,35,OR,354,366,-12
2016,35,PA,864,893,-29
2016,35,PR,56,67,-11
2016,35,RI,346,369,-23
2016,35,SC,3939,3935,4
2016,35,SD,112,127,-15
2016,35,TN,456,473,-17
2016,35,TX,14261,14125,136
2016,35,UT,67,63,4
2016,35,VA,2640,2828,-188
2016,35,VI,9,11,-2
2016,35,VT,34,34,0
2016,35,WA,416,410,6
2016,35,WI,176,180,-4
2016,35,WV,247,220,27
2016,35,WY,24,22,2
2016,36,AK,39,41,-2
2016,36,AL,1059,694,365
2016,36,AR,156,155,1
2016,36,AZ,463,412,51
2016,36,CA,2173,2405,-232
2016,36,CO,270,281,-11
2016,36,CT,526,542,-16
2016,36,DC,35,32,3
2016,36,DE,387,386,1
2016,36,FL,25178,25696,-518
2016,36,GA,1429,1465,-36
2016,36,HI,508,318,190
2016,36,IA,138,144,-6
2016,36,ID,42,40,2
2016,36,IL,339,342,-3
2016,36,IN,223,230,-7
2016,36,KS,132,131,1
2016,36,KY,215,225,-10
2016,36,LA,7115,6740,375
2016,36,MA,849,877,-28
2016,36,MD,726,717,9
2016,36,ME,115,108,7
2016,36,MI,168,177,-9
2016,36,MN,84,100,-16
2016,36,MO,214,203,11
2016,36,MS,904,898,6
2016,36,MT,53,56,-3
2016,36,NC,2196,2239,-43
2016,36,ND,175,189,-14
2016,36,NE,64,67,-3
2016,36,NH,77,85,-8
2016,36,NJ,2619,2631,-12
2016,36,NM,144,135,9
2016,36,NV,103,116,-13
2016,36,NY,2816,2960,-144
2016,36,OH,404,430,-26
2016,36,OK,170,176,-6
2016,36,OR,442,447,-5
2016,36,PA,712,732,-20
2016,36,PR,38,54,-16
2016,36,RI,310,319,-9
2016,36,SC,2922,2935,-13
2016,36,SD,59,57,2
2016,36,TN,340,378,-38
2016,36,TX,10971,11051,-80
2016,36,UT,57,72,-15
2016,36,VA,1861,1940,-79
2016,36,VI,10,10,0
2016,36,VT,62,65,-3
2016,36,WA,338,334,4
2016,36,WI,145,149,-4
2016,36,WV,186,178,8
2016,36,WY,24,26,-2
2016,37,AK,33,33,0
2016,37,AL,898,1071,-173
2016,37,AR,218,214,4
2016,37,AZ,488,514,-26
2016,37,CA,2395,3032,-637
2016,37,CO,388,397,-9
2016,37,CT,601,593,8
2016,37,DC,67,69,-2
2016,37,DE,391,380,11
2016,37,FL,27365,27806,-441
2016,37,GA,1522,1502,20
2016,37,GU,1,1,0
2016,37,HI,1817,1815,2
2016,37,IA,147,148,-1
2016,37,ID,67,74,-7
2016,37,IL,412,416,-4
2016,37,IN,300,274,26
2016,37,KS,125,123,2
2016,37,KY,251,244,7
2016,37,LA,13169,7481,5688
2016,37,MA,934,933,1
2016,37,MD,1028,1024,4
2016,37,ME,138,135,3
2016,37,MI,236,232,4
2016,37,MN,134,142,-8
2016,37,MO,229,241,-12
2016,37,MS,1130,1001,129
2016,37,MT,70,74,-4
2016,37,NC,2346,2278,68
2016,37,ND,200,216,-16
2016,37,NE,80,83,-3
2016,37,NH,113,119,-6
2016,37,NJ,2945,2945,0
2016,37,NM,179,165,14
2016,37,NV,137,152,-15
2016,37,NY,3649,3811,-162
2016,37,OH,434,443,-9
2016,37,OK,176,190,-14
2016,37,OR,312,315,-3
2016,37,PA,765,775,-10
2016,37,PR,49,61,-12
2016,37,RI,245,266,-21
2016,37,SC,3242,3187,55
2016,37,SD,44,50,-6
2016,37,TN,406,382,24
2016,37,TX,12719,11589,1130
2016,37,UT,50,45,5
2016,37,VA,1921,1888,33
2016,37,VI,26,24,2
2016,37,VT,52,44,8
2016,37,WA,379,377,2
2016,37,WI,158,164,-6
2016,37,WV,203,191,12
2016,37,WY,19,19,0
2016,38,AK,52,53,-1
2016,38,AL,798,696,102
2016,38,AR,207,197,10
2016,38,AZ,629,644,-15
2016,38,CA,2607,3203,-596
2016,38,CO,330,318,12
2016,38,CT,525,537,-12
2016,38,DC,39,37,2
2016,38,DE,445,437,8
2016,38,FL,27293,27015,278
2016,38,GA,1733,1646,87
2016,38,GU,1,3,-2
2016,38,HI,682,679,3
2016,38,IA,163,154,9
2016,38,ID,72,70,2
2016,38,IL,418,430,-12
2016,38,IN,275,270,5
2016,38,KS,144,130,14
2016,38,KY,228,240,-12
2016,38,LA,16115,7543,8572
2016,38,MA,1129,1166,-37
2016,38,MD,1056,993,63
2016,38,ME,126,125,1
2016,38,MI,298,305,-7
2016,38,MN,115,131,-16
2016,38,MO,263,264,-1
2016,38,MS,1210,1011,199
2016,38,MT,64,64,0
2016,38,NC,2350,2271,79
2016,38,ND,146,159,-13
2016,38,NE,83,83,0
2016,38,NH,131,138,-7
2016,38,NJ,3332,3348,-16
2016,38,NM,155,143,12
2016,38,NV,146,147,-1
2016,38,NY,3260,3353,-93
2016,38,OH,431,434,-3
2016,38,OK,212,203,9
2016,38,OR,294,284,10
2016,38,PA,1031,1066,-35
2016,38,PR,56,72,-16
2016,38,RI,350,363,-13
2016,38,SC,3755,3627,128
2016,38,SD,67,70,-3
2016,38,TN,510,475,35
2016,38,TX,12185,10904,1281
2016,38,UT,62,60,2
2016,38,VA,2114,2035,79
2016,38,VI,9,11,-2
2016,38,VT,47,47,0
2016,38,WA,441,429,12
2016,38,WI,146,149,-3
2016,38,WV,176,164,12
2016,38,WY,22,25,-3
2016,39,AK,50,49,1
2016,39,AL,1311,1206,105
2016,39,AR,237,233,4
2016,39,AZ,551,580,-29
2016,39,CA,3248,3927,-679
2016,39,CO,328,315,13
2016,39,CT,710,832,-122
2016,39,DC,39,283,-244
2016,39,DE,503,507,-4
2016,39,FL,39915,39750,165
2016,39,GA,2054,1967,87
2016,39,HI,2611,2612,-1
2016,39,IA,327,315,12
2016,39,ID,79,77,2
2016,39,IL,518,536,-18
2016,39,IN,359,351,8
2016,39,KS,159,141,18
2016,39,KY,326,333,-7
2016,39,LA,27263,20738,6525
2016,39,MA,1301,1319,-18
2016,39,MD,1488,1492,-4
2016,39,ME,148,150,-2
2016,39,MI,221,222,-1
2016,39,MN,157,189,-32
2016,39,MO,306,305,1
2016,39,MS,1255,1088,167
2016,39,MT,57,66,-9
2016,39,NC,3053,2933,120
2016,39,ND,222,236,-14
2016,39,NE,118,127,-9
2016,39,NH,133,134,-1
2016,39,NJ,4016,4088,-72
2016,39,NM,148,143,5
2016,39,NV,158,176,-18
2016,39,NY,4806,4820,-14
2016,39,OH,511,493,18
2016,39,OK,261,279,-18
2016,39,OR,422,419,3
2016,39,PA,1200,1056,144
2016,39,PR,62,71,-9
2016,39,RI,270,287,-17
2016,39,SC,5358,5222,136
2016,39,SD,76,79,-3
2016,39,TN,519,513,6
2016,39,TX,13566,12555,1011
2016,39,UT,76,87,-11
2016,39,VA,3110,3131,-21
2016,39,VI,11,11,0
2016,39,VT,48,50,-2
2016,39,WA,652,638,14
2016,39,WI,199,194,5
2016,39,WV,176,168,8
2016,39,WY,24,25,-1
2016,40,AK,34,37,-3
2016,40,AL,745,737,8
2016,40,AR,160,156,4
2016,40,AZ,427,452,-25
2016,40,CA,2781,3391,-610
2016,40,CO,315,308,7
2016,40,CT,525,545,-20
2016,40,DC,20,22,-2
2016,40,DE,379,378,1
2016,40,FL,23177,23508,-331
2016,40,GA,1436,1422,14
2016,40,HI,1179,1182,-3
2016,40,IA,123,133,-10
2016,40,ID,64,64,0
2016,40,IL,374,381,-7
2016,40,IN,255,253,2
2016,40,KS,108,107,1
2016,40,KY,184,217,-33
2016,40,LA,8322,5695,2627
2016,40,MA,1177,1190,-13
2016,40,MD,862,868,-6
2016,40,ME,163,162,1
2016,40,MI,153,173,-20
2016,40,MN,100,106,-6
2016,40,MO,234,241,-7
2016,40,MS,764,728,36
2016,40,MT,37,45,-8
2016,40,NC,2072,2044,28
2016,40,ND,113,120,-7
2016,40,NE,62,63,-1
2016,40,NH,63,61,2
2016,40,NJ,2493,2552,-59
2016,40,NM,125,133,-8
2016,40,NV,123,135,-12
2016,40,NY,3113,3200,-87
2016,40,OH,382,401,-19
2016,40,OK,187,185,2
2016,40,OR,342,353,-11
2016,40,PA,870,910,-40
2016,40,PR,26,46,-20
2016,40,RI,379,392,-13
2016,40,SC,2766,2663,103
2016,40,SD,33,40,-7
2016,40,TN,327,344,-17
2016,40,TX,8959,8799,160
2016,40,UT,53,57,-4
2016,40,VA,1800,1814,-14
2016,40,VI,5,9,-4
2016,40,VT,51,57,-6
2016,40,WA,422,419,3
2016,40,WI,111,124,-13
2016,40,WV,165,182,-17
2016,40,WY,26,24,2
2016,41,AK,28,28,0
2016,41,AL,551,548,3
2016,41,AR,181,173,8
2016,41,AZ,576,665,-89
2016,41,CA,3702,4741,-1039
2016,41,CO,333,374,-41
2016,41,CT,552,575,-23
2016,41,DC,43,51,-8
2016,41,DE,379,398,-19
2016,41,FL,24461,25087,-626
2016,41,GA,1373,1361,12
2016,41,GU,1,0,1
2016,41,HI,283,266,17
2016,41,IA,142,143,-1
2016,41,ID,68,74,-6
2016,41,IL,421,432,-11
2016,41,IN,293,310,-17
2016,41,KS,123,113,10
2016,41,KY,212,235,-23
2016,41,LA,9126,6777,2349
2016,41,MA,1163,1177,-14
2016,41,MD,1186,1204,-18
2016,41,ME,142,147,-5
2016,41,MI,207,206,1
2016,41,MN,96,97,-1
2016,41,MO,225,233,-8
2016,41,MS,817,852,-35
2016,41,MT,54,54,0
2016,41,NC,2274,2254,20
2016,41,ND,135,141,-6
2016,41,NE,64,61,3
2016,41,NH,82,83,-1
2016,41,NJ,2942,2991,-49
2016,41,NM,157,152,5
2016,41,NV,160,167,-7
2016,41,NY,3898,4080,-182
2016,41,OH,416,414,2
2016,41,OK,183,195,-12
2016,41,OR,364,448,-84
2016,41,PA,906,964,-58
2016,41,PR,33,36,-3
2016,41,RI,205,219,-14
2016,41,SC,2746,2691,55
2016,41,SD,58,60,-2
2016,41,TN,402,404,-2
2016,41,TX,9242,9123,119
2016,41,UT,61,68,-7
2016,41,VA,1948,1995,-47
2016,41,VI,15,15,0
2016,41,VT,54,59,-5
2016,41,WA,504,514,-10
2016,41,WI,137,149,-12
2016,41,WV,160,182,-22
2016,41,WY,21,21,0
2016,42,AK,40,44,-4
2016,42,AL,555,568,-13
2016,42,AR,228,229,-1
2016,42,AZ,582,659,-77
2016,42,CA,4125,5257,-1132
2016,42,CO,391,429,-38
2016,42,CT,485,503,-18
2016,42,DC,34,43,-9
2016,42,DE,321,362,-41
2016,42,FL,23106,23634,-528
2016,42,GA,1442,1427,15
2016,42,HI,560,556,4
2016,42,IA,202,208,-6
2016,42,ID,65,72,-7
2016,42,IL,373,389,-16
2016,42,IN,288,303,-15
2016,42,KS,141,136,5
2016,42,KY,199,207,-8
2016,42,LA,8348,6519,1829
2016,42,MA,1155,1162,-7
2016,42,MD,1024,1041,-17
2016,42,ME,195,205,-10
2016,42,MI,173,178,-5
2016,42,MN,129,124,5
2016,42,MO,231,211,20
2016,42,MS,874,872,2
2016,42,MT,44,44,0
2016,42,NC,1890,1867,23
2016,42,ND,171,180,-9
2016,42,NE,82,89,-7
2016,42,NH,66,70,-4
2016,42,NJ,2653,2726,-73
2016,42,NM,133,136,-3
2016,42,NV,151,175,-24
2016,42,NY,2768,2865,-97
2016,42,OH,387,426,-39
2016,42,OK,200,201,-1
2016,42,OR,426,450,-24
2016,42,PA,872,923,-51
2016,42,PR,32,42,-10
2016,42,RI,188,191,-3
2016,42,SC,2903,2884,19
2016,42,SD,46,46,0
2016,42,TN,358,399,-41
2016,42,TX,9686,9845,-159
2016,42,UT,62,65,-3
2016,42,VA,2086,2075,11
2016,42,VI,10,12,-2
2016,42,VT,54,55,-1
2016,42,WA,578,619,-41
2016,42,WI,120,124,-4
2016,42,WV,151,156,-5
2016,42,WY,17,23,-6
2016,43,AK,44,47,-3
2016,43,AL,825,742,83
2016,43,AR,183,183,0
2016,43,AZ,451,546,-95
2016,43,CA,3946,4752,-806
2016,43,CO,386,425,-39
2016,43,CT,503,535,-32
2016,43,DC,41,39,2
2016,43,DE,549,556,-7
2016,43,FL,23515,24335,-820
2016,43,GA,1537,1571,-34
2016,43,GU,1,1,0
2016,43,HI,1897,1902,-5
2016,43,IA,161,135,26
2016,43,ID,71,75,-4
2016,43,IL,430,437,-7
2016,43,IN,268,297,-29
2016,43,KS,136,150,-14
2016,43,KY,220,238,-18
2016,43,LA,8186,6761,1425
2016,43,MA,1186,1185,1
2016,43,MD,878,933,-55
2016,43,ME,150,150,0
2016,43,MI,229,233,-4
2016,43,MN,121,109,12
2016,43,MO,231,231,0
2016,43,MS,918,921,-3
2016,43,MT,58,61,-3
2016,43,NC,1958,1967,-9
2016,43,ND,171,191,-20
2016,43,NE,77,85,-8
2016,43,NH,95,104,-9
2016,43,NJ,2580,2624,-44
2016,43,NM,148,149,-1
2016,43,NV,152,184,-32
2016,43,NY,2771,2882,-111
2016,43,OH,460,467,-7
2016,43,OK,202,232,-30
2016,43,OR,433,433,0
2016,43,PA,1258,1320,-62
2016,43,PR,51,96,-45
2016,43,RI,215,224,-9
2016,43,SC,2816,2823,-7
2016,43,SD,52,65,-13
2016,43,TN,403,422,-19
2016,43,TX,9597,9767,-170
2016,43,UT,62,65,-3
2016,43,VA,1795,1825,-30
2016,43,VI,6,7,-1
2016,43,VT,54,59,-5
2016,43,WA,648,670,-22
2016,43,WI,159,161,-2
2016,43,WV,162,165,-3
2016,43,WY,22,23,-1
2016,44,AK,33,43,-10
2016,44,AL,903,900,3
2016,44,AR,179,181,-2
2016,44,AZ,437,499,-62
2016,44,CA,4259,5180,-921
2016,44,CO,271,298,-27
2016,44,CT,471,475,-4
2016,44,DC,27,37,-10
2016,44,DE,380,360,20
2016,44,FL,28062,27960,102
2016,44,GA,1722,1637,85
2016,44,HI,1922,1867,55
2016,44,IA,165,172,-7
2016,44,ID,66,71,-5
2016,44,IL,432,442,-10
2016,44,IN,255,273,-18
2016,44,KS,123,130,-7
2016,44,KY,268,263,5
2016,44,LA,7896,6804,1092
2016,44,MA,1124,1118,6
2016,44,MD,1072,1067,5
2016,44,ME,149,151,-2
2016,44,MI,169,181,-12
2016,44,MN,136,129,7
2016,44,MO,228,239,-11
2016,44,MS,891,894,-3
2016,44,MT,40,47,-7
2016,44,NC,2238,2121,117
2016,44,ND,139,153,-14
2016,44,NE,72,66,6
2016,44,NH,118,124,-6
2016,44,NJ,3207,3399,-192
2016,44,NM,122,103,19
2016,44,NV,137,172,-35
2016,44,NY,3067,3195,-128
2016,44,OH,386,411,-25
2016,44,OK,196,211,-15
2016,44,OR,603,615,-12
2016,44,PA,916,966,-50
2016,44,PR,33,55,-22
2016,44,RI,191,204,-13
2016,44,SC,3756,3572,184
2016,44,SD,51,48,3
2016,44,TN,415,400,15
2016,44,TX,9651,9706,-55
2016,44,UT,63,65,-2
2016,44,VA,2217,1908,309
2016,44,VI,14,14,0
2016,44,VT,68,74,-6
2016,44,WA,752,934,-182
2016,44,WI,139,149,-10
2016,44,WV,174,181,-7
2016,44,WY,23,26,-3
2016,45,AK,25,26,-1
2016,45,AL,662,664,-2
2016,45,AR,166,180,-14
2016,45,AZ,318,347,-29
2016,45,CA,3980,5336,-1356
2016,45,CO,227,255,-28
2016,45,CT,347,348,-1
2016,45,DC,35,37,-2
2016,45,DE,245,249,-4
2016,45,FL,19549,19515,34
2016,45,GA,1220,1225,-5
2016,45,HI,644,636,8
2016,45,IA,104,105,-1
2016,45,ID,73,72,1
2016,45,IL,322,352,-30
2016,45,IN,244,259,-15
2016,45,KS,96,93,3
2016,45,KY,224,233,-9
2016,45,LA,6180,5123,1057
2016,45,MA,853,890,-37
2016,45,MD,660,645,15
2016,45,ME,118,129,-11
2016,45,MI,163,170,-7
2016,45,MN,79,74,5
2016,45,MO,246,259,-13
2016,45,MS,764,756,8
2016,45,MT,32,34,-2
2016,45,NC,1882,1670,212
2016,45,ND,93,97,-4
2016,45,NE,53,59,-6
2016,45,NH,75,77,-2
2016,45,NJ,2714,2776,-62
2016,45,NM,110,104,6
2016,45,NV,121,148,-27
2016,45,NY,2438,2500,-62
2016,45,OH,328,359,-31
2016,45,OK,156,161,-5
2016,45,OR,415,417,-2
2016,45,PA,705,738,-33
2016,45,PR,37,37,0
2016,45,RI,161,160,1
2016,45,SC,2921,2935,-14
2016,45,SD,37,36,1
2016,45,TN,387,376,11
2016,45,TX,6769,6711,58
2016,45,UT,59,65,-6
2016,45,VA,1545,1450,95
2016,45,VI,6,7,-1
2016,45,VT,39,43,-4
2016,45,WA,792,744,48
2016,45,WI,97,106,-9
2016,45,WV,134,130,4
2016,45,WY,24,29,-5
2016,46,AK,18,20,-2
2016,46,AL,726,514,212
2016,46,AR,167,175,-8
2016,46,AZ,360,408,-48
2016,46,CA,4743,7003,-2260
2016,46,CO,288,300,-12
2016,46,CT,634,654,-20
2016,46,DC,18,20,-2
2016,46,DE,353,350,3
2016,46,FL,21266,21352,-86
2016,46,GA,1206,1198,8
2016,46,HI,369,391,-22
2016,46,IA,121,119,2
2016,46,ID,51,52,-1
2016,46,IL,416,444,-28
2016,46,IN,236,237,-1
2016,46,KS,123,121,2
2016,46,KY,212,235,-23
2016,46,LA,6953,6063,890
2016,46,MA,875,900,-25
2016,46,MD,886,897,-11
2016,46,ME,132,132,0
2016,46,MI,171,176,-5
2016,46,MN,85,91,-6
2016,46,MO,191,200,-9
2016,46,MS,984,1008,-24
2016,46,MT,50,47,3
2016,46,NC,2267,2123,144
2016,46,ND,100,110,-10
2016,46,NE,149,156,-7
2016,46,NH,82,80,2
2016,46,NJ,2744,2775,-31
2016,46,NM,129,132,-3
2016,46,NV,169,201,-32
2016,46,NY,2505,2557,-52
2016,46,OH,379,401,-22
2016,46,OK,166,192,-26
2016,46,OR,546,540,6
2016,46,PA,785,832,-47
2016,46,PR,44,54,-10
2016,46,RI,147,165,-18
2016,46,SC,3089,3048,41
2016,46,SD,34,36,-2
2016,46,TN,363,350,13
2016,46,TX,7499,7572,-73
2016,46,UT,75,74,1
2016,46,VA,1822,1649,173
2016,46,VI,8,9,-1
2016,46,VT,52,60,-8
2016,46,WA,724,726,-2
2016,46,WI,117,117,0
2016,46,WV,163,172,-9
2016,46,WY,22,17,5
2016,47,AK,55,53,2
2016,47,AL,499,491,8
2016,47,AR,145,153,-8
2016,47,AZ,349,428,-79
2016,47,CA,6306,13914,-7608
2016,47,CO,204,210,-6
2016,47,CT,636,660,-24
2016,47,DC,30,29,1
2016,47,DE,282,296,-14
2016,47,FL,19485,19810,-325
2016,47,GA,1056,1073,-17
2016,47,HI,774,775,-1
2016,47,IA,111,111,0
2016,47,ID,57,61,-4
2016,47,IL,340,363,-23
2016,47,IN,225,244,-19
2016,47,KS,103,101,2
2016,47,KY,206,223,-17
2016,47,LA,6075,5398,677
2016,47,MA,812,826,-14
2016,47,MD,819,818,1
2016,47,ME,109,110,-1
2016,47,MI,145,147,-2
2016,47,MN,89,95,-6
2016,47,MO,232,233,-1
2016,47,MS,713,723,-10
2016,47,MT,37,40,-3
2016,47,NC,1678,1613,65
2016,47,ND,93,104,-11
2016,47,NE,59,64,-5
2016,47,NH,82,76,6
2016,47,NJ,2158,2258,-100
2016,47,NM,82,97,-15
2016,47,NV,153,187,-34
2016,47,NY,2506,2644,-138
2016,47,OH,325,355,-30
2016,47,OK,152,173,-21
2016,47,OR,469,476,-7
2016,47,PA,725,758,-33
2016,47,PR,32,36,-4
2016,47,RI,181,198,-17
2016,47,SC,2269,2228,41
2016,47,SD,50,49,1
2016,47,TN,296,307,-11
2016,47,TX,7040,7496,-456
2016,47,UT,50,57,-7
2016,47,VA,1452,1412,40
2016,47,VI,5,6,-1
2016,47,VT,57,61,-4
2016,47,WA,621,642,-21
2016,47,WI,93,92,1
2016,47,WV,138,159,-21
2016,47,WY,16,18,-2
2016,48,AK,26,31,-5
2016,48,AL,766,773,-7
2016,48,AR,123,138,-15
2016,48,AZ,396,461,-65
2016,48,CA,7515,17147,-9632
2016,48,CO,241,265,-24
2016,48,CT,692,845,-153
2016,48,DC,54,66,-12
2016,48,DE,327,330,-3
2016,48,FL,24929,25326,-397
2016,48,GA,1171,1343,-172
2016,48,GU,2,2,0
2016,48,HI,1314,1309,5
2016,48,IA,273,279,-6
2016,48,ID,62,59,3
2016,48,IL,454,466,-12
2016,48,IN,247,325,-78
2016,48,KS,110,112,-2
2016,48,KY,211,227,-16
2016,48,LA,6588,5938,650
2016,48,MA,978,962,16
2016,48,MD,982,974,8
2016,48,ME,118,116,2
2016,48,MI,397,408,-11
2016,48,MN,108,116,-8
2016,48,MO,210,210,0
2016,48,MS,982,1003,-21
2016,48,MT,61,64,-3
2016,48,NC,1677,1639,38
2016,48,ND,92,113,-21
2016,48,NE,59,75,-16
2016,48,NH,177,181,-4
2016,48,NJ,3199,3243,-44
2016,48,NM,130,130,0
2016,48,NV,170,214,-44
2016,48,NY,2719,2540,179
2016,48,OH,384,438,-54
2016,48,OK,156,158,-2
2016,48,OR,468,501,-33
2016,48,PA,777,810,-33
2016,48,PR,24,50,-26
2016,48,RI,160,183,-23
2016,48,SC,2873,2881,-8
2016,48,SD,40,45,-5
2016,48,TN,468,487,-19
2016,48,TX,7627,7962,-335
2016,48,UT,48,43,5
2016,48,VA,1546,1564,-18
2016,48,VI,41,39,2
2016,48,VT,58,62,-4
2016,48,WA,722,775,-53
2016,48,WI,131,136,-5
2016,48,WV,149,165,-16
2016,48,WY,24,22,2
2016,49,AK,31,34,-3
2016,49,AL,814,825,-11
2016,49,AR,133,149,-16
2016,49,AZ,346,389,-43
2016,49,CA,6191,12631,-6440
2016,49,CO,207,230,-23
2016,49,CT,416,428,-12
2016,49,DC,22,21,1
2016,49,DE,291,306,-15
2016,49,FL,19090,19635,-545
2016,49,GA,996,1023,-27
2016,49,HI,995,1009,-14
2016,49,IA,109,120,-11
2016,49,ID,59,59,0
2016,49,IL,311,352,-41
2016,49,IN,196,209,-13
2016,49,KS,107,95,12
2016,49,KY,183,179,4
2016,49,LA,5324,4797,527
2016,49,MA,787,790,-3
2016,49,MD,926,919,7
2016,49,ME,124,119,5
2016,49,MI,141,150,-9
2016,49,MN,91,88,3
2016,49,MO,213,224,-11
2016,49,MS,700,743,-43
2016,49,MT,35,41,-6
2016,49,NC,1531,1490,41
2016,49,ND,108,106,2
2016,49,NE,56,61,-5
2016,49,NH,72,80,-8
2016,49,NJ,2146,2187,-41
2016,49,NM,116,121,-5
2016,49,NV,124,151,-27
2016,49,NY,2478,2594,-116
2016,49,OH,346,357,-11
2016,49,OK,155,174,-19
2016,49,OR,461,457,4
2016,49,PA,897,933,-36
2016,49,PR,28,36,-8
2016,49,RI,241,256,-15
2016,49,SC,2112,2126,-14
2016,49,SD,45,47,-2
2016,49,TN,314,313,1
2016,49,TX,5979,6302,-323
2016,49,UT,48,52,-4
2016,49,VA,1197,1163,34
2016,49,VI,6,6,0
2016,49,VT,31,32,-1
2016,49,WA,592,624,-32
2016,49,WI,111,117,-6
2016,49,WV,117,130,-13
2016,49,WY,18,14,4
2016,50,AK,27,30,-3
2016,50,AL,460,484,-24
2016,50,AR,149,164,-15
2016,50,AZ,324,362,-38
2016,50,CA,5747,10420,-4673
2016,50,CO,253,249,4
2016,50,CT,434,452,-18
2016,50,DC,30,30,0
2016,50,DE,347,361,-14
2016,50,FL,20902,21691,-789
2016,50,GA,1087,1126,-39
2016,50,HI,1109,1117,-8
2016,50,IA,145,149,-4
2016,50,ID,56,62,-6
2016,50,IL,296,326,-30
2016,50,IN,212,227,-15
2016,50,KS,124,127,-3
2016,50,KY,188,202,-14
2016,50,LA,6210,5747,463
2016,50,MA,776,751,25
2016,50,MD,670,697,-27
2016,50,ME,119,112,7
2016,50,MI,185,198,-13
2016,50,MN,87,89,-2
2016,50,MO,180,197,-17
2016,50,MS,740,760,-20
2016,50,MT,42,45,-3
2016,50,NC,1685,1619,66
2016,50,ND,90,104,-14
2016,50,NE,81,84,-3
2016,50,NH,77,83,-6
2016,50,NJ,3058,3146,-88
2016,50,NM,115,120,-5
2016,50,NV,136,161,-25
2016,50,NY,2863,2952,-89
2016,50,OH,419,448,-29
2016,50,OK,150,160,-10
2016,50,OR,436,456,-20
2016,50,PA,694,746,-52
2016,50,PR,37,38,-1
2016,50,RI,154,160,-6
2016,50,SC,2478,2495,-17
2016,50,SD,46,60,-14
2016,50,TN,336,344,-8
2016,50,TX,6475,6676,-201
2016,50,UT,59,36,23
2016,50,VA,1359,1360,-1
2016,50,VI,7,8,-1
2016,50,VT,46,43,3
2016,50,WA,591,644,-53
2016,50,WI,108,120,-12
2016,50,WV,133,144,-11
2016,50,WY,20,24,-4
2016,51,AK,18,24,-6
2016,51,AL,481,500,-19
2016,51,AR,140,149,-9
2016,51,AZ,321,374,-53
2016,51,CA,4660,8753,-4093
2016,51,CO,275,282,-7
2016,51,CT,288,311,-23
2016,51,DC,25,23,2
2016,51,DE,301,315,-14
2016,51,FL,18724,19418,-694
2016,51,GA,956,1028,-72
2016,51,GU,2,1,1
2016,51,HI,448,463,-15
2016,51,IA,117,116,1
2016,51,ID,46,51,-5
2016,51,IL,320,362,-42
2016,51,IN,227,241,-14
2016,51,KS,130,140,-10
2016,51,KY,221,235,-14
2016,51,LA,5128,4977,151
2016,51,MA,682,689,-7
2016,51,MD,664,657,7
2016,51,ME,100,109,-9
2016,51,MI,152,160,-8
2016,51,MN,78,82,-4
2016,51,MO,179,192,-13
2016,51,MP,1,1,0
2016,51,MS,762,800,-38
2016,51,MT,39,39,0
2016,51,NC,1526,1525,1
2016,51,ND,96,105,-9
2016,51,NE,50,53,-3
2016,51,NH,76,78,-2
2016,51,NJ,2372,2466,-94
2016,51,NM,92,91,1
2016,51,NV,113,135,-22
2016,51,NY,2586,2728,-142
2016,51,OH,271,299,-28
2016,51,OK,124,142,-18
2016,51,OR,390,395,-5
2016,51,PA,630,673,-43
2016,51,PR,31,49,-18
2016,51,RI,140,153,-13
2016,51,SC,2294,2294,0
2016,51,SD,44,49,-5
2016,51,TN,309,314,-5
2016,51,TX,5867,6087,-220
2016,51,UT,58,61,-3
2016,51,VA,1037,1127,-90
2016,51,VI,4,4,0
2016,51,VT,34,34,0
2016,51,WA,624,678,-54
2016,51,WI,91,96,-5
2016,51,WV,141,157,-16
2016,51,WY,23,24,-1
2016,52,AK,16,17,-1
2016,52,AL,527,515,12
2016,52,AR,89,92,-3
2016,52,AZ,311,344,-33
2016,52,CA,3764,5423,-1659
2016,52,CO,224,239,-15
2016,52,CT,325,330,-5
2016,52,DC,24,28,-4
2016,52,DE,218,217,1
2016,52,FL,21451,22362,-911
2016,52,GA,837,847,-10
2016,52,HI,990,990,0
2016,52,IA,92,92,0
2016,52,ID,56,53,3
2016,52,IL,230,241,-11
2016,52,IN,150,162,-12
2016,52,KS,89,88,1
2016,52,KY,162,173,-11
2016,52,LA,5289,5002,287
2016,52,MA,908,879,29
2016,52,MD,1040,1029,11
2016,52,ME,74,78,-4
2016,52,MI,152,150,2
2016,52,MN,82,82,0
2016,52,MO,169,170,-1
2016,52,MS,947,972,-25
2016,52,MT,26,30,-4
2016,52,NC,1237,1225,12
2016,52,ND,123,134,-11
2016,52,NE,84,94,-10
2016,52,NH,63,66,-3
2016,52,NJ,1895,1898,-3
2016,52,NM,94,92,2
2016,52,NV,97,118,-21
2016,52,NY,2484,2628,-144
2016,52,OH,260,276,-16
2016,52,OK,119,130,-11
2016,52,OR,368,348,20
2016,52,PA,574,583,-9
2016,52,PR,72,74,-2
2016,52,RI,104,123,-19
2016,52,SC,2598,2608,-10
2016,52,SD,35,40,-5
2016,52,TN,356,349,7
2016,52,TX,5392,5506,-114
2016,52,UT,39,39,0
2016,52,VA,1039,1040,-1
2016,52,VI,25,31,-6
2016,52,VT,24,26,-2
2016,52,WA,501,524,-23
2016,52,WI,79,82,-3
2016,52,WV,93,103,-10
2016,52,WY,20,21,-1
2017,1,AK,14,15,-1
2017,1,AL,428,440,-12
2017,1,AR,107,120,-13
2017,1,AZ,347,388,-41
2017,1,CA,5780,8223,-2443
2017,1,CO,265,258,7
2017,1,CT,503,510,-7
2017,1,DC,27,26,1
2017,1,DE,377,386,-9
2017,1,FL,26058,26410,-352
2017,1,GA,1000,993,7
2017,1,HI,559,560,-1
2017,1,IA,111,115,-4
2017,1,ID,58,67,-9
2017,1,IL,579,589,-10
2017,1,IN,205,218,-13
2017,1,KS,104,125,-21
2017,1,KY,172,192,-20
2017,1,LA,6182,5824,358
2017,1,MA,623,597,26
2017,1,MD,720,712,8
2017,1,ME,85,83,2
2017,1,MI,136,148,-12
2017,1,MN,81,80,1
2017,1,MO,153,157,-4
2017,1,MS,646,663,-17
2017,1,MT,40,48,-8
2017,1,NC,1587,1536,51
2017,1,ND,112,104,8
2017,1,NE,81,87,-6
2017,1,NH,59,65,-6
2017,1,NJ,2013,1960,53
2017,1,NM,141,143,-2
2017,1,NV,149,167,-18
2017,1,NY,2256,2305,-49
2017,1,OH,269,280,-11
2017,1,OK,112,118,-6
2017,1,OR,485,535,-50
2017,1,PA,656,672,-16
2017,1,PR,26,28,-2
2017,1,RI,144,156,-12
2017,1,SC,1990,1969,21
2017,1,SD,41,51,-10
2017,1,TN,301,339,-38
2017,1,TX,8419,8433,-14
2017,1,UT,34,43,-9
2017,1,VA,1738,1726,12
2017,1,VI,1,2,-1
2017,1,VT,26,29,-3
2017,1,WA,477,502,-25
2017,1,WI,172,174,-2
2017,1,WV,153,160,-7
2017,1,WY,7,8,-1
2017,2,AK,30,29,1
2017,2,AL,549,554,-5
2017,2,AR,104,107,-3
2017,2,AZ,335,368,-33
2017,2,CA,4233,6815,-2582
2017,2,CO,205,216,-11
2017,2,CT,430,442,-12
2017,2,DC,21,22,-1
2017,2,DE,255,255,0
2017,2,FL,18129,19007,-878
2017,2,GA,842,866,-24
2017,2,HI,924,925,-1
2017,2,IA,101,106,-5
2017,2,ID,51,52,-1
2017,2,IL,279,309,-30
2017,2,IN,218,229,-11
2017,2,KS,121,128,-7
2017,2,KY,187,197,-10
2017,2,LA,4984,4695,289
2017,2,MA,533,521,12
2017,2,MD,670,662,8
2017,2,ME,108,109,-1
2017,2,MI,188,159,29
2017,2,MN,85,91,-6
2017,2,MO,183,188,-5
2017,2,MS,747,768,-21
2017,2,MT,39,40,-1
2017,2,NC,1300,1313,-13
2017,2,ND,239,257,-18
2017,2,NE,67,69,-2
2017,2,NH,62,62,0
2017,2,NJ,1934,1988,-54
2017,2,NM,97,102,-5
2017,2,NV,122,136,-14
2017,2,NY,2549,2627,-78
2017,2,OH,359,373,-14
2017,2,OK,135,141,-6
2017,2,OR,451,553,-102
2017,2,PA,739,772,-33
2017,2,PR,28,32,-4
2017,2,RI,301,306,-5
2017,2,SC,2168,2199,-31
2017,2,SD,45,46,-1
2017,2,TN,245,252,-7
2017,2,TX,5228,5291,-63
2017,2,UT,52,47,5
2017,2,VA,893,907,-14
2017,2,VI,5,6,-1
2017,2,VT,33,35,-2
2017,2,WA,506,564,-58
2017,2,WI,188,195,-7
2017,2,WV,121,129,-8
2017,2,WY,17,18,-1
2017,3,AK,35,38,-3
2017,3,AL,506,520,-14
2017,3,AR,110,117,-7
2017,3,AZ,289,330,-41
2017,3,CA,3884,5509,-1625
2017,3,CO,179,188,-9
2017,3,CT,358,362,-4
2017,3,DC,25,29,-4
2017,3,DE,359,373,-14
2017,3,FL,19093,19830,-737
2017,3,GA,879,875,4
2017,3,HI,765,774,-9
2017,3,IA,92,99,-7
2017,3,ID,44,40,4
2017,3,IL,277,295,-18
2017,3,IN,191,212,-21
2017,3,KS,113,127,-14
2017,3,KY,163,178,-15
2017,3,LA,4859,4732,127
2017,3,MA,651,641,10
2017,3,MD,1041,1094,-53
2017,3,ME,88,87,1
2017,3,MI,157,169,-12
2017,3,MN,73,64,9
2017,3,MO,265,282,-17
2017,3,MS,670,688,-18
2017,3,MT,51,56,-5
2017,3,NC,1681,1653,28
2017,3,ND,200,224,-24
2017,3,NE,47,54,-7
2017,3,NH,76,81,-5
2017,3,NJ,1913,1950,-37
2017,3,NM,92,96,-4
2017,3,NV,130,158,-28
2017,3,NY,2706,2703,3
2017,3,OH,264,277,-13
2017,3,OK,125,132,-7
2017,3,OR,394,406,-12
2017,3,PA,922,947,-25
2017,3,PR,28,33,-5
2017,3,RI,112,123,-11
2017,3,SC,2316,2318,-2
2017,3,SD,39,44,-5
2017,3,TN,240,248,-8
2017,3,TX,5469,5559,-90
2017,3,UT,35,34,1
2017,3,VA,909,917,-8
2017,3,VI,5,5,0
2017,3,VT,28,33,-5
2017,3,WA,650,644,6
2017,3,WI,107,114,-7
2017,3,WV,116,122,-6
2017,3,WY,16,16,0
2017,4,AK,17,21,-4
2017,4,AL,437,478,-41
2017,4,AR,141,163,-22
2017,4,AZ,274,282,-8
2017,4,CA,2834,3632,-798
2017,4,CO,216,212,4
2017,4,CT,225,240,-15
2017,4,DC,27,29,-2
2017,4,DE,192,196,-4
2017,4,FL,18235,18557,-322
2017,4,GA,841,893,-52
2017,4,GU,1,1,0
2017,4,HI,358,304,54
2017,4,IA,91,99,-8
2017,4,ID,45,46,-1
2017,4,IL,281,353,-72
2017,4,IN,183,193,-10
2017,4,KS,81,94,-13
2017,4,KY,140,153,-13
2017,4,LA,4517,4578,-61
2017,4,MA,478,463,15
2017,4,MD,526,533,-7
2017,4,ME,75,83,-8
2017,4,MI,132,145,-13
2017,4,MN,85,76,9
2017,4,MO,153,176,-23
2017,4,MS,594,657,-63
2017,4,MT,49,61,-12
2017,4,NC,1209,1226,-17
2017,4,ND,133,105,28
2017,4,NE,61,68,-7
2017,4,NH,65,72,-7
2017,4,NJ,1782,1800,-18
2017,4,NM,78,84,-6
2017,4,NV,86,104,-18
2017,4,NY,1845,1874,-29
2017,4,OH,224,263,-39
2017,4,OK,109,120,-11
2017,4,OR,343,348,-5
2017,4,PA,536,578,-42
2017,4,PR,32,37,-5
2017,4,RI,105,113,-8
2017,4,SC,1823,1853,-30
2017,4,SD,22,28,-6
2017,4,TN,238,245,-7
2017,4,TX,4569,4634,-65
2017,4,UT,30,30,0
2017,4,VA,874,892,-18
2017,4,VI,10,19,-9
2017,4,VT,49,48,1
2017,4,WA,357,379,-22
2017,4,WI,92,94,-2
2017,4,WV,87,102,-15
2017,4,WY,10,10,0
2017,5,AK,18,20,-2
2017,5,AL,887,898,-11
2017,5,AR,175,206,-31
2017,5,AZ,321,398,-77
2017,5,CA,4279,5207,-928
2017,5,CO,254,268,-14
2017,5,CT,311,342,-31
2017,5,DC,36,54,-18
2017,5,DE,200,212,-12
2017,5,FL,21236,21752,-516
2017,5,GA,1063,1101,-38
2017,5,HI,1733,1747,-14
2017,5,IA,108,118,-10
2017,5,ID,89,75,14
2017,5,IL,349,385,-36
2017,5,IN,218,238,-20
2017,5,KS,93,100,-7
2017,5,KY,169,179,-10
2017,5,LA,5862,5852,10
2017,5,MA,577,593,-16
2017,5,MD,928,934,-6
2017,5,ME,76,80,-4
2017,5,MI,170,174,-4
2017,5,MN,107,100,7
2017,5,MO,192,228,-36
2017,5,MS,978,910,68
2017,5,MT,57,53,4
2017,5,NC,1439,1444,-5
2017,5,ND,184,133,51
2017,5,NE,75,82,-7
2017,5,NH,58,59,-1
2017,5,NJ,2572,2636,-64
2017,5,NM,131,135,-4
2017,5,NV,189,214,-25
2017,5,NY,2475,2507,-32
2017,5,OH,264,314,-50
2017,5,OK,129,136,-7
2017,5,OR,415,415,0
2017,5,PA,872,908,-36
2017,5,PR,23,320,-297
2017,5,RI,116,119,-3
2017,5,SC,2187,2192,-5
2017,5,SD,43,51,-8
2017,5,TN,277,294,-17
2017,5,TX,6781,6897,-116
2017,5,UT,52,52,0
2017,5,VA,1181,1184,-3
2017,5,VI,1,2,-1
2017,5,VT,43,45,-2
2017,5,WA,738,757,-19
2017,5,WI,108,113,-5
2017,5,WV,134,147,-13
2017,5,WY,10,10,0
2017,6,AK,21,27,-6
2017,6,AL,534,536,-2
2017,6,AR,160,171,-11
2017,6,AZ,368,416,-48
2017,6,CA,5306,5510,-204
2017,6,CO,223,230,-7
2017,6,CT,286,284,2
2017,6,DC,19,23,-4
2017,6,DE,203,215,-12
2017,6,FL,18504,19322,-818
2017,6,GA,901,922,-21
2017,6,GU,1,2,-1
2017,6,HI,666,708,-42
2017,6,IA,117,126,-9
2017,6,ID,233,92,141
2017,6,IL,398,423,-25
2017,6,IN,260,272,-12
2017,6,KS,122,116,6
2017,6,KY,185,186,-1
2017,6,LA,5540,5307,233
2017,6,MA,674,674,0
2017,6,MD,516,553,-37
2017,6,ME,128,134,-6
2017,6,MI,165,202,-37
2017,6,MN,115,106,9
2017,6,MO,193,200,-7
2017,6,MS,800,827,-27
2017,6,MT,68,68,0
2017,6,NC,1451,1451,0
2017,6,ND,264,226,38
2017,6,NE,67,67,0
2017,6,NH,55,68,-13
2017,6,NJ,2021,2071,-50
2017,6,NM,99,104,-5
2017,6,NV,233,200,33
2017,6,NY,2140,2162,-22
2017,6,OH,373,388,-15
2017,6,OK,136,133,3
2017,6,OR,371,349,22
2017,6,PA,705,769,-64
2017,6,PR,19,22,-3
2017,6,RI,127,143,-16
2017,6,SC,2014,2055,-41
2017,6,SD,31,36,-5
2017,6,TN,306,302,4
2017,6,TX,5619,5683,-64
2017,6,UT,132,120,12
2017,6,VA,951,970,-19
2017,6,VI,3,3,0
2017,6,VT,50,52,-2
2017,6,WA,480,492,-12
2017,6,WI,104,108,-4
2017,6,WV,155,184,-29
2017,6,WY,17,17,0
2017,7,AK,23,28,-5
2017,7,AL,863,895,-32
2017,7,AR,143,148,-5
2017,7,AZ,309,312,-3
2017,7,CA,3884,3727,157
2017,7,CO,188,188,0
2017,7,CT,294,313,-19
2017,7,DC,36,44,-8
2017,7,DE,212,216,-4
2017,7,FL,21852,22647,-795
2017,7,GA,910,939,-29
2017,7,HI,898,907,-9
2017,7,IA,134,148,-14
2017,7,ID,175,86,89
2017,7,IL,692,720,-28
2017,7,IN,235,256,-21
2017,7,KS,129,119,10
2017,7,KY,202,210,-8
2017,7,LA,5502,5319,183
2017,7,MA,929,934,-5
2017,7,MD,608,621,-13
2017,7,ME,74,71,3
2017,7,MI,192,218,-26
2017,7,MN,124,132,-8
2017,7,MO,190,209,-19
2017,7,MS,738,762,-24
2017,7,MT,70,60,10
2017,7,NC,1494,1489,5
2017,7,ND,284,271,13
2017,7,NE,83,89,-6
2017,7,NH,67,74,-7
2017,7,NJ,2116,2183,-67
2017,7,NM,93,97,-4
2017,7,NV,191,176,15
2017,7,NY,2226,2344,-118
2017,7,OH,443,457,-14
2017,7,OK,132,140,-8
2017,7,OR,413,364,49
2017,7,PA,875,950,-75
2017,7,PR,45,50,-5
2017,7,RI,115,122,-7
2017,7,SC,1939,1970,-31
2017,7,SD,42,44,-2
2017,7,TN,286,288,-2
2017,7,TX,6161,5929,232
2017,7,UN,1,1,0
2017,7,UT,44,48,-4
2017,7,VA,1513,1480,33
2017,7,VI,3,46,-43
2017,7,VT,40,46,-6
2017,7,WA,516,508,8
2017,7,WI,113,128,-15
2017,7,WV,172,186,-14
2017,7,WY,21,19,2
2017,8,AK,22,27,-5
2017,8,AL,755,773,-18
2017,8,AR,159,162,-3
2017,8,AZ,303,331,-28
2017,8,CA,3478,3443,35
2017,8,CO,289,275,14
2017,8,CT,353,362,-9
2017,8,DC,35,36,-1
2017,8,DE,230,229,1
2017,8,FL,19068,19727,-659
2017,8,GA,1008,1003,5
2017,8,HI,1485,1495,-10
2017,8,IA,146,148,-2
2017,8,ID,187,85,102
2017,8,IL,375,404,-29
2017,8,IN,230,251,-21
2017,8,KS,116,93,23
2017,8,KY,203,216,-13
2017,8,LA,6262,6015,247
2017,8,MA,445,442,3
2017,8,MD,557,578,-21
2017,8,ME,81,88,-7
2017,8,MI,278,250,28
2017,8,MN,154,148,6
2017,8,MO,207,207,0
2017,8,MP,1,1,0
2017,8,MS,930,977,-47
2017,8,MT,81,73,8
2017,8,NC,1493,1468,25
2017,8,ND,232,217,15
2017,8,NE,103,102,1
2017,8,NH,67,65,2
2017,8,NJ,1868,1950,-82
2017,8,NM,110,102,8
2017,8,NV,171,161,10
2017,8,NY,2870,2907,-37
2017,8,OH,317,335,-18
2017,8,OK,139,147,-8
2017,8,OR,436,395,41
2017,8,PA,849,903,-54
2017,8,PR,24,25,-1
2017,8,RI,111,119,-8
2017,8,SC,2042,2039,3
2017,8,SD,63,71,-8
2017,8,TN,346,345,1
2017,8,TX,6226,6087,139
2017,8,UT,82,84,-2
2017,8,VA,1092,1109,-17
2017,8,VI,4,5,-1
2017,8,VT,30,32,-2
2017,8,WA,448,487,-39
2017,8,WI,126,130,-4
2017,8,WV,156,166,-10
2017,8,WY,20,23,-3
2017,9,AK,38,40,-2
2017,9,AL,583,609,-26
2017,9,AR,175,185,-10
2017,9,AZ,367,382,-15
2017,9,CA,3197,3458,-261
2017,9,CO,290,311,-21
2017,9,CT,426,458,-32
2017,9,DC,36,46,-10
2017,9,DE,281,295,-14
2017,9,FL,29102,29833,-731
2017,9,GA,1307,1346,-39
2017,9,GU,1,1,0
2017,9,HI,894,907,-13
2017,9,IA,211,226,-15
2017,9,ID,177,107,70
2017,9,IL,479,497,-18
2017,9,IN,274,307,-33
2017,9,KS,139,124,15
2017,9,KY,215,229,-14
2017,9,LA,7757,7541,216
2017,9,MA,859,833,26
2017,9,MD,1171,1205,-34
2017,9,ME,106,109,-3
2017,9,MI,215,232,-17
2017,9,MN,218,226,-8
2017,9,MO,276,294,-18
2017,9,MS,1010,1055,-45
2017,9,MT,107,110,-3
2017,9,NC,2443,2424,19
2017,9,ND,460,423,37
2017,9,NE,85,96,-11
2017,9,NH,80,71,9
2017,9,NJ,2644,2746,-102
2017,9,NM,146,146,0
2017,9,NV,166,331,-165
2017,9,NY,2665,2721,-56
2017,9,OH,407,433,-26
2017,9,OK,155,164,-9
2017,9,OR,439,412,27
2017,9,PA,937,1036,-99
2017,9,PR,29,36,-7
2017,9,RI,345,355,-10
2017,9,SC,2740,2755,-15
2017,9,SD,53,54,-1
2017,9,TN,488,496,-8
2017,9,TX,7900,8076,-176
2017,9,UT,87,73,14
2017,9,VA,1406,1434,-28
2017,9,VI,11,10,1
2017,9,VT,55,59,-4
2017,9,WA,528,549,-21
2017,9,WI,162,172,-10
2017,9,WV,148,184,-36
2017,9,WY,29,29,0
2017,10,AK,27,26,1
2017,10,AL,497,504,-7
2017,10,AR,147,148,-1
2017,10,AZ,258,283,-25
2017,10,CA,3083,2779,304
2017,10,CO,253,269,-16
2017,10,CT,332,346,-14
2017,10,DC,19,24,-5
2017,10,DE,316,327,-11
2017,10,FL,21644,22441,-797
2017,10,GA,1017,1073,-56
2017,10,GU,1,1,0
2017,10,HI,1267,975,292
2017,10,IA,195,207,-12
2017,10,ID,270,135,135
2017,10,IL,496,529,-33
2017,10,IN,258,268,-10
2017,10,KS,130,123,7
2017,10,KY,201,207,-6
2017,10,LA,6230,6012,218
2017,10,MA,760,778,-18
2017,10,MD,531,560,-29
2017,10,ME,95,105,-10
2017,10,MI,194,195,-1
2017,10,MN,202,210,-8
2017,10,MO,227,237,-10
2017,10,MS,830,887,-57
2017,10,MT,113,78,35
2017,10,NC,1460,1418,42
2017,10,ND,407,408,-1
2017,10,NE,73,82,-9
2017,10,NH,81,85,-4
2017,10,NJ,1934,2009,-75
2017,10,NM,118,125,-7
2017,10,NV,153,157,-4
2017,10,NY,3158,2907,251
2017,10,OH,311,339,-28
2017,10,OK,144,160,-16
2017,10,OR,317,311,6
2017,10,PA,741,785,-44
2017,10,PR,21,26,-5
2017,10,RI,128,141,-13
2017,10,SC,2189,2229,-40
2017,10,SD,144,152,-8
2017,10,TN,377,381,-4
2017,10,TX,6192,6211,-19
2017,10,UT,58,53,5
2017,10,VA,1230,1173,57
2017,10,VI,6,6,0
2017,10,VT,50,53,-3
2017,10,WA,772,757,15
2017,10,WI,135,150,-15
2017,10,WV,146,161,-15
2017,10,WY,44,26,18
2017,11,AK,23,28,-5
2017,11,AL,602,629,-27
2017,11,AR,147,155,-8
2017,11,AZ,293,303,-10
2017,11,CA,5497,2466,3031
2017,11,CO,255,286,-31
2017,11,CT,319,348,-29
2017,11,DC,28,33,-5
2017,11,DE,252,247,5
2017,11,FL,21120,22096,-976
2017,11,GA,1057,1049,8
2017,11,HI,625,729,-104
2017,11,IA,221,236,-15
2017,11,ID,184,100,84
2017,11,IL,407,461,-54
2017,11,IN,311,333,-22
2017,11,KS,141,135,6
2017,11,KY,244,270,-26
2017,11,LA,6640,6178,462
2017,11,MA,718,755,-37
2017,11,MD,630,633,-3
2017,11,ME,85,91,-6
2017,11,MI,210,220,-10
2017,11,MN,260,274,-14
2017,11,MO,253,262,-9
2017,11,MS,1060,1123,-63
2017,11,MT,149,131,18
2017,11,NC,1620,1631,-11
2017,11,ND,487,486,1
2017,11,NE,91,101,-10
2017,11,NH,104,110,-6
2017,11,NJ,2189,2218,-29
2017,11,NM,108,116,-8
2017,11,NV,175,163,12
2017,11,NY,2080,2091,-11
2017,11,OH,390,414,-24
2017,11,OK,143,154,-11
2017,11,OR,315,303,12
2017,11,PA,778,842,-64
2017,11,PR,23,27,-4
2017,11,RI,97,107,-10
2017,11,SC,3023,3014,9
2017,11,SD,75,99,-24
2017,11,TN,421,441,-20
2017,11,TX,6266,6255,11
2017,11,UT,87,71,16
2017,11,VA,1060,1093,-33
2017,11,VI,35,38,-3
2017,11,VT,51,55,-4
2017,11,WA,465,456,9
2017,11,WI,141,148,-7
2017,11,WV,148,165,-17
2017,11,WY,61,30,31
2017,12,AK,25,26,-1
2017,12,AL,741,764,-23
2017,12,AR,174,172,2
2017,12,AZ,252,263,-11
2017,12,CA,4665,2886,1779
2017,12,CO,278,283,-5
2017,12,CT,419,447,-28
2017,12,DC,28,29,-1
2017,12,DE,286,293,-7
2017,12,FL,21055,21938,-883
2017,12,GA,1071,1067,4
2017,12,GU,1,1,0
2017,12,HI,503,505,-2
2017,12,IA,216,235,-19
2017,12,ID,148,75,73
2017,12,IL,468,530,-62
2017,12,IN,286,320,-34
2017,12,KS,127,119,8
2017,12,KY,225,251,-26
2017,12,LA,6665,6511,154
2017,12,MA,682,702,-20
2017,12,MD,1362,1402,-40
2017,12,ME,98,101,-3
2017,12,MI,273,287,-14
2017,12,MN,291,337,-46
2017,12,MO,260,256,4
2017,12,MS,1076,1126,-50
2017,12,MT,156,155,1
2017,12,NC,1562,1591,-29
2017,12,ND,547,578,-31
2017,12,NE,96,116,-20
2017,12,NH,96,78,18
2017,12,NJ,1775,1820,-45
2017,12,NM,123,132,-9
2017,12,NV,191,145,46
2017,12,NY,2517,2543,-26
2017,12,OH,392,414,-22
2017,12,OK,167,170,-3
2017,12,OR,340,324,16
2017,12,PA,1131,1223,-92
2017,12,PR,21,23,-2
2017,12,RI,147,160,-13
2017,12,SC,2205,2262,-57
2017,12,SD,85,138,-53
2017,12,TN,390,394,-4
2017,12,TX,6748,6698,50
2017,12,UT,70,53,17
2017,12,VA,1641,1675,-34
2017,12,VI,7,6,1
2017,12,VT,40,44,-4
2017,12,WA,403,393,10
2017,12,WI,173,182,-9
2017,12,WV,153,172,-19
2017,12,WY,64,26,38
2017,13,AK,33,28,5
2017,13,AL,910,949,-39
2017,13,AR,193,200,-7
2017,13,AZ,332,354,-22
2017,13,CA,3217,2746,471
2017,13,CO,337,334,3
2017,13,CT,398,408,-10
2017,13,DC,37,49,-12
2017,13,DE,262,267,-5
2017,13,FL,31871,33554,-1683
2017,13,GA,1526,1519,7
2017,13,HI,695,688,7
2017,13,IA,288,309,-21
2017,13,ID,285,152,133
2017,13,IL,700,735,-35
2017,13,IN,292,308,-16
2017,13,KS,161,169,-8
2017,13,KY,275,290,-15
2017,13,LA,8749,8760,-11
2017,13,MA,670,744,-74
2017,13,MD,760,812,-52
2017,13,ME,103,116,-13
2017,13,MI,273,288,-15
2017,13,MN,386,394,-8
2017,13,MO,427,405,22
2017,13,MS,1132,1228,-96
2017,13,MT,172,175,-3
2017,13,NC,2200,2221,-21
2017,13,ND,470,496,-26
2017,13,NE,167,176,-9
2017,13,NH,114,128,-14
2017,13,NJ,2482,2598,-116
2017,13,NM,130,137,-7
2017,13,NV,241,161,80
2017,13,NY,3267,3325,-58
2017,13,OH,402,440,-38
2017,13,OK,175,214,-39
2017,13,OR,320,574,-254
2017,13,PA,936,1041,-105
2017,13,PR,42,46,-4
2017,13,RI,157,172,-15
2017,13,SC,3992,4049,-57
2017,13,SD,88,144,-56
2017,13,TN,438,453,-15
2017,13,TX,8383,8526,-143
2017,13,UT,108,87,21
2017,13,VA,1698,1706,-8
2017,13,VI,4,6,-2
2017,13,VT,47,51,-4
2017,13,WA,503,467,36
2017,13,WI,192,208,-16
2017,13,WV,197,217,-20
2017,13,WY,57,29,28
2017,14,AK,32,29,3
2017,14,AL,489,512,-23
2017,14,AR,195,202,-7
2017,14,AZ,263,269,-6
2017,14,CA,2548,2162,386
2017,14,CO,290,295,-5
2017,14,CT,331,344,-13
2017,14,DC,15,21,-6
2017,14,DE,231,232,-1
2017,14,FL,19592,20609,-1017
2017,14,GA,1003,1000,3
2017,14,HI,586,590,-4
2017,14,IA,248,264,-16
2017,14,ID,292,77,215
2017,14,IL,435,456,-21
2017,14,IN,293,316,-23
2017,14,KS,132,120,12
2017,14,KY,207,217,-10
2017,14,LA,6768,6552,216
2017,14,MA,436,462,-26
2017,14,MD,685,737,-52
2017,14,ME,124,134,-10
2017,14,MI,191,209,-18
2017,14,MN,371,392,-21
2017,14,MO,316,311,5
2017,14,MS,881,931,-50
2017,14,MT,128,123,5
2017,14,NC,1723,1744,-21
2017,14,ND,362,379,-17
2017,14,NE,98,113,-15
2017,14,NH,87,94,-7
2017,14,NJ,1923,1954,-31
2017,14,NM,97,97,0
2017,14,NV,212,142,70
2017,14,NY,2077,2243,-166
2017,14,OH,381,406,-25
2017,14,OK,156,162,-6
2017,14,OR,279,274,5
2017,14,PA,685,734,-49
2017,14,PR,32,36,-4
2017,14,RI,183,191,-8
2017,14,SC,2302,2324,-22
2017,14,SD,85,125,-40
2017,14,TN,749,766,-17
2017,14,TX,7748,7726,22
2017,14,UT,81,61,20
2017,14,VA,1045,1084,-39
2017,14,VI,2,2,0
2017,14,VT,30,32,-2
2017,14,WA,392,394,-2
2017,14,WI,192,200,-8
2017,14,WV,195,218,-23
2017,14,WY,69,49,20
2017,15,AK,37,31,6
2017,15,AL,891,897,-6
2017,15,AR,212,285,-73
2017,15,AZ,260,283,-23
2017,15,CA,2504,2239,265
2017,15,CO,309,326,-17
2017,15,CT,378,390,-12
2017,15,DC,22,19,3
2017,15,DE,292,294,-2
2017,15,FL,28683,29733,-1050
2017,15,GA,1032,1110,-78
2017,15,HI,302,309,-7
2017,15,IA,236,246,-10
2017,15,ID,247,96,151
2017,15,IL,547,563,-16
2017,15,IN,270,293,-23
2017,15,KS,160,156,4
2017,15,KY,254,282,-28
2017,15,LA,8338,8528,-190
2017,15,MA,928,960,-32
2017,15,MD,630,640,-10
2017,15,ME,116,117,-1
2017,15,MI,224,232,-8
2017,15,MN,245,266,-21
2017,15,MO,281,280,1
2017,15,MS,1187,1253,-66
2017,15,MT,112,101,11
2017,15,NC,1786,1772,14
2017,15,ND,411,428,-17
2017,15,NE,110,114,-4
2017,15,NH,85,89,-4
2017,15,NJ,2124,2188,-64
2017,15,NM,103,113,-10
2017,15,NV,183,124,59
2017,15,NY,1991,2029,-38
2017,15,OH,379,404,-25
2017,15,OK,188,202,-14
2017,15,OR,285,302,-17
2017,15,PA,813,837,-24
2017,15,PR,21,26,-5
2017,15,RI,114,125,-11
2017,15,SC,2464,2459,5
2017,15,SD,81,116,-35
2017,15,TN,392,416,-24
2017,15,TX,7311,7528,-217
2017,15,UT,60,54,6
2017,15,VA,1326,1356,-30
2017,15,VI,56,57,-1
2017,15,VT,58,65,-7
2017,15,WA,427,410,17
2017,15,WI,237,256,-19
2017,15,WV,163,176,-13
2017,15,WY,68,39,29
2017,16,AK,37,36,1
2017,16,AL,819,855,-36
2017,16,AR,163,181,-18
2017,16,AZ,268,286,-18
2017,16,CA,2775,2202,573
2017,16,CO,350,372,-22
2017,16,CT,334,349,-15
2017,16,DC,27,29,-2
2017,16,DE,305,310,-5
2017,16,FL,23052,24094,-1042
2017,16,GA,1098,1095,3
2017,16,GU,1,1,0
2017,16,HI,1041,1055,-14
2017,16,IA,201,214,-13
2017,16,ID,190,91,99
2017,16,IL,490,529,-39
2017,16,IN,260,291,-31
2017,16,KS,164,146,18
2017,16,KY,233,254,-21
2017,16,LA,8403,8513,-110
2017,16,MA,559,573,-14
2017,16,MD,601,614,-13
2017,16,ME,96,92,4
2017,16,MI,198,205,-7
2017,16,MN,162,185,-23
2017,16,MO,341,341,0
2017,16,MS,1165,1213,-48
2017,16,MT,101,95,6
2017,16,NC,1728,1766,-38
2017,16,ND,219,207,12
2017,16,NE,92,102,-10
2017,16,NH,83,82,1
2017,16,NJ,2273,2334,-61
2017,16,NM,128,136,-8
2017,16,NV,126,114,12
2017,16,NY,2436,2488,-52
2017,16,OH,397,428,-31
2017,16,OK,202,208,-6
2017,16,OR,293,298,-5
2017,16,PA,645,666,-21
2017,16,PR,21,24,-3
2017,16,RI,114,127,-13
2017,16,SC,2580,2558,22
2017,16,SD,43,71,-28
2017,16,TN,385,403,-18
2017,16,TX,7703,8276,-573
2017,16,UT,73,67,6
2017,16,VA,1201,1192,9
2017,16,VI,12,12,0
2017,16,VT,48,52,-4
2017,16,WA,429,408,21
2017,16,WI,164,177,-13
2017,16,WV,138,148,-10
2017,16,WY,83,49,34
2017,17,AK,43,42,1
2017,17,AL,1284,1345,-61
2017,17,AR,133,146,-13
2017,17,AZ,351,369,-18
2017,17,CA,2572,2382,190
2017,17,CO,430,439,-9
2017,17,CT,386,402,-16
2017,17,DC,28,25,3
2017,17,DE,308,309,-1
2017,17,FL,30363,31353,-990
2017,17,GA,1206,1252,-46
2017,17,HI,1120,1128,-8
2017,17,IA,175,184,-9
2017,17,ID,134,86,48
2017,17,IL,469,504,-35
2017,17,IN,299,331,-32
2017,17,KS,177,169,8
2017,17,KY,247,267,-20
2017,17,LA,10029,10039,-10
2017,17,MA,696,645,51
2017,17,MD,673,707,-34
2017,17,ME,134,147,-13
2017,17,MI,222,239,-17
2017,17,MN,158,163,-5
2017,17,MO,312,326,-14
2017,17,MS,1209,1256,-47
2017,17,MT,90,87,3
2017,17,NC,1974,1988,-14
2017,17,ND,149,167,-18
2017,17,NE,102,107,-5
2017,17,NH,73,78,-5
2017,17,NJ,2449,2542,-93
2017,17,NM,97,142,-45
2017,17,NV,141,127,14
2017,17,NY,2573,2545,28
2017,17,OH,398,426,-28
2017,17,OK,176,195,-19
2017,17,OR,278,281,-3
2017,17,PA,732,818,-86
2017,17,PR,44,47,-3
2017,17,RI,138,149,-11
2017,17,SC,2737,2775,-38
2017,17,SD,47,64,-17
2017,17,TN,436,430,6
2017,17,TX,9276,9370,-94
2017,17,UT,53,52,1
2017,17,VA,1455,1477,-22
2017,17,VI,8,8,0
2017,17,VT,35,39,-4
2017,17,WA,433,407,26
2017,17,WI,161,186,-25
2017,17,WV,147,167,-20
2017,17,WY,56,26,30
2017,18,AK,35,34,1
2017,18,AL,782,804,-22
2017,18,AR,178,199,-21
2017,18,AZ,290,303,-13
2017,18,CA,2337,2237,100
2017,18,CO,508,515,-7
2017,18,CT,347,365,-18
2017,18,DC,27,29,-2
2017,18,DE,309,326,-17
2017,18,FL,35081,36087,-1006
2017,18,GA,1314,1325,-11
2017,18,GU,1,1,0
2017,18,HI,1946,1915,31
2017,18,IA,158,149,9
2017,18,ID,494,352,142
2017,18,IL,537,565,-28
2017,18,IN,262,293,-31
2017,18,KS,146,147,-1
2017,18,KY,238,263,-25
2017,18,LA,9552,9260,292
2017,18,MA,565,630,-65
2017,18,MD,669,746,-77
2017,18,ME,104,105,-1
2017,18,MI,192,211,-19
2017,18,MN,138,142,-4
2017,18,MO,261,279,-18
2017,18,MS,1304,1365,-61
2017,18,MT,84,76,8
2017,18,NC,2287,2287,0
2017,18,ND,129,134,-5
2017,18,NE,110,121,-11
2017,18,NH,77,84,-7
2017,18,NJ,2500,2573,-73
2017,18,NM,130,133,-3
2017,18,NV,135,117,18
2017,18,NY,3050,3121,-71
2017,18,OH,351,360,-9
2017,18,OK,180,193,-13
2017,18,OR,745,763,-18
2017,18,PA,798,847,-49
2017,18,PR,29,32,-3
2017,18,RI,149,158,-9
2017,18,SC,2876,2883,-7
2017,18,SD,60,75,-15
2017,18,TN,402,393,9
2017,18,TX,9694,9931,-237
2017,18,UT,150,147,3
2017,18,VA,1441,1406,35
2017,18,VI,10,14,-4
2017,18,VT,48,49,-1
2017,18,WA,479,454,25
2017,18,WI,147,152,-5
2017,18,WV,140,142,-2
2017,18,WY,59,45,14
2017,19,AK,29,31,-2
2017,19,AL,587,603,-16
2017,19,AR,158,172,-14
2017,19,AZ,274,279,-5
2017,19,CA,2132,2063,69
2017,19,CO,297,316,-19
2017,19,CT,320,322,-2
2017,19,DC,17,22,-5
2017,19,DE,303,312,-9
2017,19,FL,25410,26327,-917
2017,19,GA,1175,1195,-20
2017,19,HI,777,783,-6
2017,19,IA,126,125,1
2017,19,ID,286,85,201
2017,19,IL,388,411,-23
2017,19,IN,232,255,-23
2017,19,KS,136,140,-4
2017,19,KY,209,209,0
2017,19,LA,8194,7955,239
2017,19,MA,651,677,-26
2017,19,MD,663,674,-11
2017,19,ME,77,84,-7
2017,19,MI,202,208,-6
2017,19,MN,108,111,-3
2017,19,MO,249,255,-6
2017,19,MS,1311,1333,-22
2017,19,MT,90,85,5
2017,19,NC,1733,1759,-26
2017,19,ND,98,104,-6
2017,19,NE,74,83,-9
2017,19,NH,73,76,-3
2017,19,NJ,2100,2136,-36
2017,19,NM,95,98,-3
2017,19,NV,106,97,9
2017,19,NY,2637,2701,-64
2017,19,OH,305,325,-20
2017,19,OK,216,219,-3
2017,19,OR,256,242,14
2017,19,PA,736,750,-14
2017,19,PR,15,22,-7
2017,19,RI,136,137,-1
2017,19,SC,2466,2493,-27
2017,19,SD,44,57,-13
2017,19,TN,303,312,-9
2017,19,TX,8512,8649,-137
2017,19,UN,1,1,0
2017,19,UT,67,58,9
2017,19,VA,1237,1240,-3
2017,19,VI,7,6,1
2017,19,VT,36,37,-1
2017,19,WA,406,358,48
2017,19,WI,131,135,-4
2017,19,WV,132,148,-16
2017,19,WY,44,38,6
2017,20,AK,42,42,0
2017,20,AL,868,910,-42
2017,20,AR,159,167,-8
2017,20,AZ,284,287,-3
2017,20,CA,2028,1980,48
2017,20,CO,368,389,-21
2017,20,CT,392,409,-17
2017,20,DC,21,24,-3
2017,20,DE,319,331,-12
2017,20,FL,26938,27997,-1059
2017,20,GA,1274,1278,-4
2017,20,GU,1,1,0
2017,20,HI,841,776,65
2017,20,IA,144,144,0
2017,20,ID,241,98,143
2017,20,IL,548,601,-53
2017,20,IN,237,257,-20
2017,20,KS,135,135,0
2017,20,KY,256,265,-9
2017,20,LA,8972,8950,22
2017,20,MA,599,654,-55
2017,20,MD,598,635,-37
2017,20,ME,78,76,2
2017,20,MI,205,224,-19
2017,20,MN,121,130,-9
2017,20,MO,257,273,-16
2017,20,MS,1189,1231,-42
2017,20,MT,86,83,3
2017,20,NC,2153,2179,-26
2017,20,ND,90,96,-6
2017,20,NE,77,91,-14
2017,20,NH,73,84,-11
2017,20,NJ,2456,2529,-73
2017,20,NM,101,111,-10
2017,20,NV,213,140,73
2017,20,NY,2580,2677,-97
2017,20,OH,310,331,-21
2017,20,OK,202,214,-12
2017,20,OR,291,296,-5
2017,20,PA,706,752,-46
2017,20,PR,32,35,-3
2017,20,RI,129,139,-10
2017,20,SC,3400,3464,-64
2017,20,SD,50,59,-9
2017,20,TN,358,340,18
2017,20,TX,11892,13005,-1113
2017,20,UT,58,56,2
2017,20,VA,1413,1458,-45
2017,20,VI,9,10,-1
2017,20,VT,43,45,-2
2017,20,WA,385,352,33
2017,20,WI,131,143,-12
2017,20,WV,127,134,-7
2017,20,WY,38,39,-1
2017,21,AK,35,28,7
2017,21,AL,946,966,-20
2017,21,AR,164,176,-12
2017,21,AZ,314,319,-5
2017,21,CA,1973,2010,-37
2017,21,CO,487,511,-24
2017,21,CT,397,415,-18
2017,21,DC,16,14,2
2017,21,DE,352,342,10
2017,21,FL,28374,29087,-713
2017,21,GA,1360,1296,64
2017,21,GU,1,2,-1
2017,21,HI,886,887,-1
2017,21,IA,225,236,-11
2017,21,ID,158,78,80
2017,21,IL,411,445,-34
2017,21,IN,224,260,-36
2017,21,KS,146,147,-1
2017,21,KY,226,250,-24
2017,21,LA,9679,9404,275
2017,21,MA,575,600,-25
2017,21,MD,681,807,-126
2017,21,ME,83,85,-2
2017,21,MI,183,187,-4
2017,21,MN,98,96,2
2017,21,MO,259,264,-5
2017,21,MS,1260,1316,-56
2017,21,MT,90,79,11
2017,21,NC,2135,2086,49
2017,21,ND,83,86,-3
2017,21,NE,102,107,-5
2017,21,NH,66,67,-1
2017,21,NJ,2409,2506,-97
2017,21,NM,133,133,0
2017,21,NV,256,214,42
2017,21,NY,2862,2844,18
2017,21,OH,311,343,-32
2017,21,OK,172,179,-7
2017,21,OR,332,341,-9
2017,21,PA,854,877,-23
2017,21,PR,34,38,-4
2017,21,RI,157,171,-14
2017,21,SC,3330,3353,-23
2017,21,SD,53,91,-38
2017,21,TN,442,417,25
2017,21,TX,13238,14624,-1386
2017,21,UT,54,50,4
2017,21,VA,1343,1355,-12
2017,21,VI,5,4,1
2017,21,VT,23,26,-3
2017,21,WA,350,328,22
2017,21,WI,171,185,-14
2017,21,WV,137,142,-5
2017,21,WY,39,39,0
2017,22,AK,38,38,0
2017,22,AL,892,923,-31
2017,22,AR,301,280,21
2017,22,AZ,338,346,-8
2017,22,CA,2178,2105,73
2017,22,CO,337,360,-23
2017,22,CT,416,438,-22
2017,22,DC,36,36,0
2017,22,DE,538,543,-5
2017,22,FL,38011,38644,-633
2017,22,GA,1578,1590,-12
2017,22,HI,851,862,-11
2017,22,IA,186,197,-11
2017,22,ID,124,72,52
2017,22,IL,532,540,-8
2017,22,IN,275,307,-32
2017,22,KS,163,178,-15
2017,22,KY,249,256,-7
2017,22,LA,11932,11552,380
2017,22,MA,759,814,-55
2017,22,MD,838,878,-40
2017,22,ME,106,108,-2
2017,22,MI,178,192,-14
2017,22,MN,128,124,4
2017,22,MO,313,262,51
2017,22,MS,1651,1718,-67
2017,22,MT,93,82,11
2017,22,NC,2402,2390,12
2017,22,ND,106,102,4
2017,22,NE,124,121,3
2017,22,NH,107,107,0
2017,22,NJ,3205,3304,-99
2017,22,NM,100,110,-10
2017,22,NV,158,113,45
2017,22,NY,2885,3030,-145
2017,22,OH,359,384,-25
2017,22,OK,250,260,-10
2017,22,OR,385,401,-16
2017,22,PA,766,808,-42
2017,22,PR,30,35,-5
2017,22,RI,167,184,-17
2017,22,SC,3758,3785,-27
2017,22,SD,87,91,-4
2017,22,TN,648,639,9
2017,22,TX,15244,16280,-1036
2017,22,UN,1,1,0
2017,22,UT,91,93,-2
2017,22,VA,2091,2187,-96
2017,22,VI,6,6,0
2017,22,VT,27,27,0
2017,22,WA,509,496,13
2017,22,WI,140,140,0
2017,22,WV,154,163,-9
2017,22,WY,48,46,2
2017,23,AK,25,25,0
2017,23,AL,1032,1068,-36
2017,23,AR,229,216,13
2017,23,AZ,299,326,-27
2017,23,CA,1948,1913,35
2017,23,CO,413,437,-24
2017,23,CT,336,358,-22
2017,23,DC,258,256,2
2017,23,DE,349,360,-11
2017,23,FL,27377,27869,-492
2017,23,GA,1565,1560,5
2017,23,HI,370,379,-9
2017,23,IA,172,171,1
2017,23,ID,124,68,56
2017,23,IL,443,479,-36
2017,23,IN,261,278,-17
2017,23,KS,127,118,9
2017,23,KY,281,294,-13
2017,23,LA,10135,9851,284
2017,23,MA,677,723,-46
2017,23,MD,648,664,-16
2017,23,ME,82,85,-3
2017,23,MI,150,163,-13
2017,23,MN,102,100,2
2017,23,MO,276,269,7
2017,23,MS,1336,1401,-65
2017,23,MT,77,84,-7
2017,23,NC,2194,2192,2
2017,23,ND,130,137,-7
2017,23,NE,87,99,-12
2017,23,NH,64,64,0
2017,23,NJ,2286,2356,-70
2017,23,NM,91,100,-9
2017,23,NV,155,125,30
2017,23,NY,2342,2668,-326
2017,23,OH,349,359,-10
2017,23,OK,237,262,-25
2017,23,OR,274,282,-8
2017,23,PA,671,717,-46
2017,23,PR,34,41,-7
2017,23,RI,139,145,-6
2017,23,SC,3353,3380,-27
2017,23,SD,48,72,-24
2017,23,TN,634,641,-7
2017,23,TX,12598,13232,-634
2017,23,UT,49,52,-3
2017,23,VA,1445,1432,13
2017,23,VI,16,17,-1
2017,23,VT,32,31,1
2017,23,WA,322,323,-1
2017,23,WI,131,132,-1
2017,23,WV,105,118,-13
2017,23,WY,38,37,1
2017,24,AK,32,33,-1
2017,24,AL,808,812,-4
2017,24,AR,245,234,11
2017,24,AZ,309,321,-12
2017,24,CA,2200,2238,-38
2017,24,CO,408,429,-21
2017,24,CT,394,428,-34
2017,24,DC,25,23,2
2017,24,DE,339,349,-10
2017,24,FL,33009,33911,-902
2017,24,GA,1420,1445,-25
2017,24,HI,979,991,-12
2017,24,IA,158,172,-14
2017,24,ID,101,76,25
2017,24,IL,528,640,-112
2017,24,IN,252,272,-20
2017,24,KS,159,174,-15
2017,24,KY,257,276,-19
2017,24,LA,10826,10533,293
2017,24,MA,730,765,-35
2017,24,MD,716,752,-36
2017,24,ME,84,84,0
2017,24,MI,201,210,-9
2017,24,MN,121,124,-3
2017,24,MO,274,264,10
2017,24,MS,1438,1497,-59
2017,24,MT,79,82,-3
2017,24,NC,2066,2058,8
2017,24,ND,97,106,-9
2017,24,NE,100,118,-18
2017,24,NH,73,86,-13
2017,24,NJ,2208,2289,-81
2017,24,NM,117,125,-8
2017,24,NV,127,122,5
2017,24,NY,2711,2784,-73
2017,24,OH,382,408,-26
2017,24,OK,219,241,-22
2017,24,OR,279,287,-8
2017,24,PA,695,742,-47
2017,24,PR,20,28,-8
2017,24,RI,210,228,-18
2017,24,SC,3513,3512,1
2017,24,SD,45,61,-16
2017,24,TN,619,606,13
2017,24,TX,14500,15456,-956
2017,24,UT,35,41,-6
2017,24,VA,1725,1761,-36
2017,24,VI,97,98,-1
2017,24,VT,30,34,-4
2017,24,WA,328,314,14
2017,24,WI,183,184,-1
2017,24,WV,133,144,-11
2017,24,WY,41,38,3
2017,25,AK,26,29,-3
2017,25,AL,984,997,-13
2017,25,AR,169,163,6
2017,25,AZ,393,402,-9
2017,25,CA,1976,1900,76
2017,25,CO,484,503,-19
2017,25,CT,419,447,-28
2017,25,DC,41,39,2
2017,25,DE,332,347,-15
2017,25,FL,31112,31682,-570
2017,25,GA,1530,1537,-7
2017,25,HI,743,761,-18
2017,25,IA,123,124,-1
2017,25,ID,98,69,29
2017,25,IL,368,373,-5
2017,25,IN,261,288,-27
2017,25,KS,142,145,-3
2017,25,KY,206,212,-6
2017,25,LA,10951,10316,635
2017,25,MA,588,613,-25
2017,25,MD,837,876,-39
2017,25,ME,90,91,-1
2017,25,MI,204,217,-13
2017,25,MN,112,108,4
2017,25,MO,244,275,-31
2017,25,MS,1396,1424,-28
2017,25,MT,70,81,-11
2017,25,NC,2702,2728,-26
2017,25,ND,108,123,-15
2017,25,NE,79,91,-12
2017,25,NH,77,74,3
2017,25,NJ,2805,2886,-81
2017,25,NM,110,122,-12
2017,25,NV,82,106,-24
2017,25,NY,2797,2888,-91
2017,25,OH,364,398,-34
2017,25,OK,218,241,-23
2017,25,OR,251,261,-10
2017,25,PA,660,705,-45
2017,25,PR,27,31,-4
2017,25,RI,175,186,-11
2017,25,SC,3617,3593,24
2017,25,SD,51,65,-14
2017,25,TN,522,503,19
2017,25,TX,15684,16454,-770
2017,25,UT,50,58,-8
2017,25,VA,1823,1879,-56
2017,25,VI,5,6,-1
2017,25,VT,25,27,-2
2017,25,WA,355,336,19
2017,25,WI,101,116,-15
2017,25,WV,144,159,-15
2017,25,WY,29,32,-3
2017,26,AK,27,30,-3
2017,26,AL,1256,1278,-22
2017,26,AR,214,222,-8
2017,26,AZ,425,445,-20
2017,26,CA,2103,2184,-81
2017,26,CO,360,377,-17
2017,26,CT,564,594,-30
2017,26,DC,45,46,-1
2017,26,DE,651,666,-15
2017,26,FL,42933,44167,-1234
2017,26,GA,2031,2058,-27
2017,26,HI,1993,1578,415
2017,26,IA,282,291,-9
2017,26,ID,75,82,-7
2017,26,IL,539,591,-52
2017,26,IN,303,327,-24
2017,26,KS,177,206,-29
2017,26,KY,216,237,-21
2017,26,LA,14650,14152,498
2017,26,MA,967,1035,-68
2017,26,MD,1850,1899,-49
2017,26,ME,114,118,-4
2017,26,MI,256,245,11
2017,26,MN,134,130,4
2017,26,MO,287,298,-11
2017,26,MS,1593,1632,-39
2017,26,MT,182,187,-5
2017,26,NC,3144,3226,-82
2017,26,ND,280,306,-26
2017,26,NE,150,164,-14
2017,26,NH,100,107,-7
2017,26,NJ,3490,3582,-92
2017,26,NM,126,129,-3
2017,26,NV,132,142,-10
2017,26,NY,3500,3610,-110
2017,26,OH,454,478,-24
2017,26,OK,265,308,-43
2017,26,OR,270,292,-22
2017,26,PA,819,885,-66
2017,26,PR,39,53,-14
2017,26,RI,211,230,-19
2017,26,SC,4960,5041,-81
2017,26,SD,98,122,-24
2017,26,TN,511,528,-17
2017,26,TX,25444,28891,-3447
2017,26,UT,45,51,-6
2017,26,VA,2544,2576,-32
2017,26,VI,8,8,0
2017,26,VT,52,61,-9
2017,26,WA,372,389,-17
2017,26,WI,145,154,-9
2017,26,WV,142,153,-11
2017,26,WY,22,21,1
2017,27,AK,22,21,1
2017,27,AL,826,955,-129
2017,27,AR,168,170,-2
2017,27,AZ,336,362,-26
2017,27,CA,1721,1692,29
2017,27,CO,295,303,-8
2017,27,CT,377,395,-18
2017,27,DC,30,38,-8
2017,27,DE,298,307,-9
2017,27,FL,32864,33193,-329
2017,27,GA,1849,1919,-70
2017,27,HI,258,262,-4
2017,27,IA,197,211,-14
2017,27,ID,61,61,0
2017,27,IL,354,397,-43
2017,27,IN,257,282,-25
2017,27,KS,142,157,-15
2017,27,KY,184,185,-1
2017,27,LA,11362,10686,676
2017,27,MA,632,665,-33
2017,27,MD,635,668,-33
2017,27,ME,166,163,3
2017,27,MI,140,158,-18
2017,27,MN,70,76,-6
2017,27,MO,249,272,-23
2017,27,MS,1350,1386,-36
2017,27,MT,45,49,-4
2017,27,NC,2180,2241,-61
2017,27,ND,70,67,3
2017,27,NE,123,135,-12
2017,27,NH,79,79,0
2017,27,NJ,2027,2113,-86
2017,27,NM,121,120,1
2017,27,NV,98,106,-8
2017,27,NY,2424,2517,-93
2017,27,OH,339,368,-29
2017,27,OK,206,223,-17
2017,27,OR,241,241,0
2017,27,PA,724,735,-11
2017,27,PR,36,43,-7
2017,27,RI,176,191,-15
2017,27,SC,3836,3939,-103
2017,27,SD,64,74,-10
2017,27,TN,374,391,-17
2017,27,TX,22399,25533,-3134
2017,27,UT,54,57,-3
2017,27,VA,1914,1929,-15
2017,27,VI,8,10,-2
2017,27,VT,20,25,-5
2017,27,WA,298,312,-14
2017,27,WI,120,124,-4
2017,27,WV,129,149,-20
2017,27,WY,29,34,-5
2017,28,AK,22,28,-6
2017,28,AL,860,869,-9
2017,28,AR,172,164,8
2017,28,AZ,431,463,-32
2017,28,CA,2346,2341,5
2017,28,CO,307,348,-41
2017,28,CT,453,452,1
2017,28,DC,28,29,-1
2017,28,DE,333,340,-7
2017,28,FL,31912,32479,-567
2017,28,GA,1749,1754,-5
2017,28,HI,413,408,5
2017,28,IA,203,226,-23
2017,28,ID,39,47,-8
2017,28,IL,437,456,-19
2017,28,IN,331,356,-25
2017,28,KS,144,163,-19
2017,28,KY,236,252,-16
2017,28,LA,11222,10821,401
2017,28,MA,689,768,-79
2017,28,MD,879,919,-40
2017,28,ME,106,102,4
2017,28,MI,228,455,-227
2017,28,MN,116,118,-2
2017,28,MO,250,253,-3
2017,28,MS,1332,1353,-21
2017,28,MT,65,74,-9
2017,28,NC,2692,2756,-64
2017,28,ND,81,77,4
2017,28,NE,111,137,-26
2017,28,NH,73,78,-5
2017,28,NJ,3931,4009,-78
2017,28,NM,141,137,4
2017,28,NV,97,108,-11
2017,28,NY,2844,2911,-67
2017,28,OH,368,378,-10
2017,28,OK,195,226,-31
2017,28,OR,328,345,-17
2017,28,PA,649,702,-53
2017,28,PR,41,48,-7
2017,28,RI,206,226,-20
2017,28,SC,3503,3509,-6
2017,28,SD,38,51,-13
2017,28,TN,447,461,-14
2017,28,TX,21229,22824,-1595
2017,28,UT,41,47,-6
2017,28,VA,2181,2228,-47
2017,28,VI,8,8,0
2017,28,VT,41,45,-4
2017,28,WA,342,364,-22
2017,28,WI,150,157,-7
2017,28,WV,133,146,-13
2017,28,WY,27,27,0
2017,29,AK,25,32,-7
2017,29,AL,904,878,26
2017,29,AR,166,166,0
2017,29,AZ,395,414,-19
2017,29,CA,1769,1805,-36
2017,29,CO,304,326,-22
2017,29,CT,422,418,4
2017,29,DC,97,29,68
2017,29,DE,327,330,-3
2017,29,FL,29610,29791,-181
2017,29,GA,1667,1659,8
2017,29,HI,883,894,-11
2017,29,IA,206,221,-15
2017,29,ID,52,55,-3
2017,29,IL,420,462,-42
2017,29,IN,338,366,-28
2017,29,KS,140,149,-9
2017,29,KY,217,238,-21
2017,29,LA,11642,9899,1743
2017,29,MA,770,727,43
2017,29,MD,1135,1168,-33
2017,29,ME,102,99,3
2017,29,MI,205,221,-16
2017,29,MN,120,137,-17
2017,29,MO,255,247,8
2017,29,MS,1211,1149,62
2017,29,MT,108,107,1
2017,29,NC,2467,2417,50
2017,29,ND,83,85,-2
2017,29,NE,86,104,-18
2017,29,NH,125,158,-33
2017,29,NJ,2591,2637,-46
2017,29,NM,123,133,-10
2017,29,NV,103,117,-14
2017,29,NY,2624,2706,-82
2017,29,OH,411,450,-39
2017,29,OK,230,273,-43
2017,29,OR,259,267,-8
2017,29,PA,685,726,-41
2017,29,PR,32,35,-3
2017,29,RI,182,190,-8
2017,29,SC,3777,3805,-28
2017,29,SD,38,45,-7
2017,29,TN,409,439,-30
2017,29,TX,19552,19549,3
2017,29,UT,58,59,-1
2017,29,VA,1937,1943,-6
2017,29,VI,4,3,1
2017,29,VT,53,50,3
2017,29,WA,383,368,15
2017,29,WI,165,172,-7
2017,29,WV,138,164,-26
2017,29,WY,24,26,-2
2017,30,AK,34,42,-8
2017,30,AL,780,801,-21
2017,30,AR,200,191,9
2017,30,AZ,398,433,-35
2017,30,CA,2165,2168,-3
2017,30,CO,305,323,-18
2017,30,CT,464,486,-22
2017,30,DC,29,34,-5
2017,30,DE,379,400,-21
2017,30,FL,33733,34189,-456
2017,30,GA,1840,1816,24
2017,30,HI,700,692,8
2017,30,IA,208,214,-6
2017,30,ID,59,58,1
2017,30,IL,611,640,-29
2017,30,IN,355,394,-39
2017,30,KS,162,187,-25
2017,30,KY,251,259,-8
2017,30,LA,11085,10596,489
2017,30,MA,874,938,-64
2017,30,MD,1083,1128,-45
2017,30,ME,109,113,-4
2017,30,MI,189,211,-22
2017,30,MN,147,161,-14
2017,30,MO,260,275,-15
2017,30,MS,1151,1202,-51
2017,30,MT,46,47,-1
2017,30,NC,2514,2542,-28
2017,30,ND,109,112,-3
2017,30,NE,103,113,-10
2017,30,NH,85,89,-4
2017,30,NJ,2677,2776,-99
2017,30,NM,139,156,-17
2017,30,NV,124,145,-21
2017,30,NY,3057,3162,-105
2017,30,OH,459,490,-31
2017,30,OK,232,254,-22
2017,30,OR,253,253,0
2017,30,PA,733,782,-49
2017,30,PR,36,46,-10
2017,30,RI,219,230,-11
2017,30,SC,3852,3799,53
2017,30,SD,48,57,-9
2017,30,TN,390,409,-19
2017,30,TX,17856,18409,-553
2017,30,UT,40,48,-8
2017,30,VA,2323,2397,-74
2017,30,VI,6,7,-1
2017,30,VT,39,45,-6
2017,30,WA,334,358,-24
2017,30,WI,151,162,-11
2017,30,WV,155,180,-25
2017,30,WY,23,23,0
2017,31,AK,34,35,-1
2017,31,AL,1177,1183,-6
2017,31,AR,177,177,0
2017,31,AZ,409,420,-11
2017,31,CA,1979,2043,-64
2017,31,CO,288,323,-35
2017,31,CT,480,499,-19
2017,31,DC,39,42,-3
2017,31,DE,313,331,-18
2017,31,FL,30389,31163,-774
2017,31,GA,1750,1747,3
2017,31,HI,428,447,-19
2017,31,IA,164,158,6
2017,31,ID,58,67,-9
2017,31,IL,460,489,-29
2017,31,IN,270,288,-18
2017,31,KS,151,170,-19
2017,31,KY,234,249,-15
2017,31,LA,10143,9995,148
2017,31,MA,763,815,-52
2017,31,MD,1055,1108,-53
2017,31,ME,104,104,0
2017,31,MI,179,194,-15
2017,31,MN,97,116,-19
2017,31,MO,263,273,-10
2017,31,MS,1196,1212,-16
2017,31,MT,30,29,1
2017,31,NC,2384,2425,-41
2017,31,ND,76,77,-1
2017,31,NE,72,84,-12
2017,31,NH,76,78,-2
2017,31,NJ,2733,2810,-77
2017,31,NM,242,260,-18
2017,31,NV,117,134,-17
2017,31,NY,2458,2617,-159
2017,31,OH,395,413,-18
2017,31,OK,188,213,-25
2017,31,OR,218,250,-32
2017,31,PA,737,782,-45
2017,31,PR,41,47,-6
2017,31,RI,235,258,-23
2017,31,SC,3807,3878,-71
2017,31,SD,32,52,-20
2017,31,TN,406,430,-24
2017,31,TX,14796,15046,-250
2017,31,UT,53,57,-4
2017,31,VA,2057,2095,-38
2017,31,VI,22,23,-1
2017,31,VT,37,37,0
2017,31,WA,351,373,-22
2017,31,WI,144,140,4
2017,31,WV,136,161,-25
2017,31,WY,26,26,0
2017,32,AK,29,31,-2
2017,32,AL,753,760,-7
2017,32,AR,186,192,-6
2017,32,AZ,441,434,7
2017,32,CA,2066,2045,21
2017,32,CO,342,379,-37
2017,32,CT,466,486,-20
2017,32,DC,27,28,-1
2017,32,DE,376,383,-7
2017,32,FL,29275,29657,-382
2017,32,GA,1855,1814,41
2017,32,HI,703,696,7
2017,32,IA,146,153,-7
2017,32,ID,62,60,2
2017,32,IL,393,373,20
2017,32,IN,323,363,-40
2017,32,KS,116,133,-17
2017,32,KY,223,243,-20
2017,32,LA,9478,9104,374
2017,32,MA,819,855,-36
2017,32,MD,769,801,-32
2017,32,ME,105,100,5
2017,32,MI,212,215,-3
2017,32,MN,115,120,-5
2017,32,MO,435,455,-20
2017,32,MS,1079,1095,-16
2017,32,MT,41,47,-6
2017,32,NC,2554,2565,-11
2017,32,ND,98,97,1
2017,32,NE,85,90,-5
2017,32,NH,66,67,-1
2017,32,NJ,3124,3206,-82
2017,32,NM,179,191,-12
2017,32,NV,141,152,-11
2017,32,NY,2720,2771,-51
2017,32,OH,380,412,-32
2017,32,OK,218,244,-26
2017,32,OR,255,264,-9
2017,32,PA,755,774,-19
2017,32,PR,21,30,-9
2017,32,RI,221,237,-16
2017,32,SC,3818,3762,56
2017,32,SD,48,53,-5
2017,32,TN,449,468,-19
2017,32,TX,14959,15072,-113
2017,32,UT,40,41,-1
2017,32,VA,2049,2053,-4
2017,32,VI,13,15,-2
2017,32,VT,49,50,-1
2017,32,WA,322,326,-4
2017,32,WI,162,161,1
2017,32,WV,155,170,-15
2017,32,WY,27,29,-2
2017,33,AK,30,31,-1
2017,33,AL,735,746,-11
2017,33,AR,181,188,-7
2017,33,AZ,519,472,47
2017,33,CA,1989,2011,-22
2017,33,CO,330,360,-30
2017,33,CT,517,534,-17
2017,33,DC,35,32,3
2017,33,DE,360,361,-1
2017,33,FL,28457,28610,-153
2017,33,GA,1750,1725,25
2017,33,HI,1081,1082,-1
2017,33,IA,159,165,-6
2017,33,ID,61,65,-4
2017,33,IL,437,430,7
2017,33,IN,292,302,-10
2017,33,KS,111,113,-2
2017,33,KY,232,250,-18
2017,33,LA,9392,9025,367
2017,33,MA,709,734,-25
2017,33,MD,860,907,-47
2017,33,ME,115,117,-2
2017,33,MI,191,203,-12
2017,33,MN,102,106,-4
2017,33,MO,232,233,-1
2017,33,MS,1171,1203,-32
2017,33,MT,67,78,-11
2017,33,NC,2667,2674,-7
2017,33,ND,112,133,-21
2017,33,NE,80,87,-7
2017,33,NH,65,70,-5
2017,33,NJ,3180,3224,-44
2017,33,NM,145,154,-9
2017,33,NV,143,163,-20
2017,33,NY,2986,3057,-71
2017,33,OH,427,446,-19
2017,33,OK,184,198,-14
2017,33,OR,270,280,-10
2017,33,PA,1045,1091,-46
2017,33,PR,28,39,-11
2017,33,RI,463,473,-10
2017,33,SC,3904,3874,30
2017,33,SD,40,47,-7
2017,33,TN,432,445,-13
2017,33,TX,14462,14916,-454
2017,33,UT,42,43,-1
2017,33,VA,1875,1865,10
2017,33,VI,14,12,2
2017,33,VT,33,33,0
2017,33,WA,366,394,-28
2017,33,WI,146,147,-1
2017,33,WV,175,198,-23
2017,33,WY,16,19,-3
2017,34,AK,32,36,-4
2017,34,AL,1042,1040,2
2017,34,AR,203,209,-6
2017,34,AZ,482,466,16
2017,34,CA,2148,2194,-46
2017,34,CO,344,383,-39
2017,34,CT,636,658,-22
2017,34,DC,22,23,-1
2017,34,DE,364,363,1
2017,34,FL,28618,28945,-327
2017,34,GA,1645,1576,69
2017,34,HI,2208,2206,2
2017,34,IA,174,184,-10
2017,34,ID,64,77,-13
2017,34,IL,620,589,31
2017,34,IN,286,308,-22
2017,34,KS,128,138,-10
2017,34,KY,240,263,-23
2017,34,LA,9605,9306,299
2017,34,MA,1077,1103,-26
2017,34,MD,835,845,-10
2017,34,ME,132,134,-2
2017,34,MI,186,198,-12
2017,34,MN,101,98,3
2017,34,MO,231,238,-7
2017,34,MS,1181,1200,-19
2017,34,MT,52,52,0
2017,34,NC,2539,2545,-6
2017,34,ND,137,135,2
2017,34,NE,81,84,-3
2017,34,NH,73,76,-3
2017,34,NJ,2520,2634,-114
2017,34,NM,157,169,-12
2017,34,NV,156,170,-14
2017,34,NY,3190,3234,-44
2017,34,OH,394,413,-19
2017,34,OK,172,198,-26
2017,34,OR,351,359,-8
2017,34,PA,774,784,-10
2017,34,PR,30,37,-7
2017,34,RI,253,269,-16
2017,34,SC,3989,3984,5
2017,34,SD,58,72,-14
2017,34,TN,473,432,41
2017,34,TX,13467,13128,339
2017,34,UT,57,50,7
2017,34,VA,2068,2085,-17
2017,34,VI,18,17,1
2017,34,VT,43,45,-2
2017,34,WA,361,389,-28
2017,34,WI,178,166,12
2017,34,WV,166,184,-18
2017,34,WY,48,54,-6
2017,35,AK,35,41,-6
2017,35,AL,770,795,-25
2017,35,AR,182,188,-6
2017,35,AZ,474,498,-24
2017,35,CA,2491,2484,7
2017,35,CO,358,369,-11
2017,35,CT,602,617,-15
2017,35,DC,111,102,9
2017,35,DE,567,560,7
2017,35,FL,33036,33331,-295
2017,35,GA,1967,1913,54
2017,35,HI,3492,3553,-61
2017,35,IA,162,179,-17
2017,35,ID,66,70,-4
2017,35,IL,438,450,-12
2017,35,IN,287,302,-15
2017,35,KS,137,140,-3
2017,35,KY,253,269,-16
2017,35,LA,10923,10572,351
2017,35,MA,1089,1173,-84
2017,35,MD,1172,1194,-22
2017,35,ME,115,119,-4
2017,35,MI,184,200,-16
2017,35,MN,129,142,-13
2017,35,MO,262,262,0
2017,35,MS,1176,1178,-2
2017,35,MT,53,60,-7
2017,35,NC,2931,2913,18
2017,35,ND,176,192,-16
2017,35,NE,90,99,-9
2017,35,NH,136,144,-8
2017,35,NJ,3133,3168,-35
2017,35,NM,184,193,-9
2017,35,NV,160,169,-9
2017,35,NY,3554,3631,-77
2017,35,OH,477,504,-27
2017,35,OK,231,250,-19
2017,35,OR,335,358,-23
2017,35,PA,821,848,-27
2017,35,PR,47,54,-7
2017,35,RI,326,343,-17
2017,35,SC,3874,3786,88
2017,35,SD,75,98,-23
2017,35,TN,457,464,-7
2017,35,TX,14479,14536,-57
2017,35,UT,114,114,0
2017,35,VA,2613,2624,-11
2017,35,VI,10,9,1
2017,35,VT,41,41,0
2017,35,WA,386,404,-18
2017,35,WI,186,179,7
2017,35,WV,217,228,-11
2017,35,WY,23,23,0
2017,36,AK,29,31,-2
2017,36,AL,1004,987,17
2017,36,AR,155,159,-4
2017,36,AZ,402,445,-43
2017,36,CA,2069,2022,47
2017,36,CO,270,262,8
2017,36,CT,483,510,-27
2017,36,DC,34,31,3
2017,36,DE,378,372,6
2017,36,FL,24179,23520,659
2017,36,GA,1625,1428,197
2017,36,HI,334,325,9
2017,36,IA,129,142,-13
2017,36,ID,49,48,1
2017,36,IL,333,342,-9
2017,36,IN,220,224,-4
2017,36,KS,128,128,0
2017,36,KY,176,189,-13
2017,36,LA,8124,7149,975
2017,36,MA,687,699,-12
2017,36,MD,700,693,7
2017,36,ME,115,111,4
2017,36,MI,172,169,3
2017,36,MN,83,80,3
2017,36,MO,204,204,0
2017,36,MS,923,905,18
2017,36,MT,46,50,-4
2017,36,NC,2339,2278,61
2017,36,ND,176,178,-2
2017,36,NE,68,63,5
2017,36,NH,76,71,5
2017,36,NJ,2716,2732,-16
2017,36,NM,137,144,-7
2017,36,NV,107,114,-7
2017,36,NY,2693,2760,-67
2017,36,OH,478,487,-9
2017,36,OK,145,156,-11
2017,36,OR,422,422,0
2017,36,PA,691,705,-14
2017,36,PR,33,37,-4
2017,36,RI,302,309,-7
2017,36,SC,3029,2886,143
2017,36,SD,46,58,-12
2017,36,TN,361,350,11
2017,36,TX,11658,11299,359
2017,36,UT,58,56,2
2017,36,VA,1788,1747,41
2017,36,VI,11,9,2
2017,36,VT,50,65,-15
2017,36,WA,328,331,-3
2017,36,WI,137,128,9
2017,36,WV,165,179,-14
2017,36,WY,22,20,2
2017,37,AK,36,34,2
2017,37,AL,1227,1197,30
2017,37,AR,195,210,-15
2017,37,AZ,459,475,-16
2017,37,CA,2367,2393,-26
2017,37,CO,361,401,-40
2017,37,CT,582,602,-20
2017,37,DC,49,36,13
2017,37,DE,386,376,10
2017,37,FL,25440,25513,-73
2017,37,GA,1565,1489,76
2017,37,GU,1,1,0
2017,37,HI,2830,2810,20
2017,37,IA,151,157,-6
2017,37,ID,48,52,-4
2017,37,IL,386,413,-27
2017,37,IN,235,266,-31
2017,37,KS,134,129,5
2017,37,KY,252,270,-18
2017,37,LA,11646,11663,-17
2017,37,MA,976,1017,-41
2017,37,MD,955,966,-11
2017,37,ME,136,144,-8
2017,37,MI,274,289,-15
2017,37,MN,123,134,-11
2017,37,MO,234,240,-6
2017,37,MS,1051,1067,-16
2017,37,MT,61,67,-6
2017,37,NC,2391,2314,77
2017,37,ND,196,202,-6
2017,37,NE,68,82,-14
2017,37,NH,118,127,-9
2017,37,NJ,2760,2840,-80
2017,37,NM,161,183,-22
2017,37,NV,127,132,-5
2017,37,NY,3505,3586,-81
2017,37,OH,374,407,-33
2017,37,OK,169,170,-1
2017,37,OR,306,331,-25
2017,37,PA,742,772,-30
2017,37,PR,36,44,-8
2017,37,RI,277,288,-11
2017,37,SC,3414,3296,118
2017,37,SD,50,57,-7
2017,37,TN,385,407,-22
2017,37,TX,12824,12701,123
2017,37,UT,53,51,2
2017,37,VA,1980,1944,36
2017,37,VI,23,25,-2
2017,37,VT,44,46,-2
2017,37,WA,358,376,-18
2017,37,WI,159,160,-1
2017,37,WV,169,196,-27
2017,37,WY,21,23,-2
2017,38,AK,42,43,-1
2017,38,AL,726,758,-32
2017,38,AR,194,202,-8
2017,38,AZ,554,598,-44
2017,38,CA,2510,2500,10
2017,38,CO,284,294,-10
2017,38,CT,467,497,-30
2017,38,DC,40,32,8
2017,38,DE,374,375,-1
2017,38,FL,25562,25960,-398
2017,38,GA,1743,1710,33
2017,38,HI,1076,1082,-6
2017,38,IA,141,152,-11
2017,38,ID,79,91,-12
2017,38,IL,370,413,-43
2017,38,IN,260,278,-18
2017,38,KS,141,141,0
2017,38,KY,197,209,-12
2017,38,LA,14592,14961,-369
2017,38,MA,1091,1112,-21
2017,38,MD,939,969,-30
2017,38,ME,109,113,-4
2017,38,MI,290,300,-10
2017,38,MN,97,115,-18
2017,38,MO,277,272,5
2017,38,MS,1143,1173,-30
2017,38,MT,61,67,-6
2017,38,NC,2312,2292,20
2017,38,ND,157,161,-4
2017,38,NE,79,79,0
2017,38,NH,122,126,-4
2017,38,NJ,3172,3250,-78
2017,38,NM,134,149,-15
2017,38,NV,132,140,-8
2017,38,NY,3155,3240,-85
2017,38,OH,401,426,-25
2017,38,OK,189,211,-22
2017,38,OR,306,318,-12
2017,38,PA,784,774,10
2017,38,PR,48,60,-12
2017,38,RI,207,226,-19
2017,38,SC,3875,3820,55
2017,38,SD,43,55,-12
2017,38,TN,439,466,-27
2017,38,TX,14850,11992,2858
2017,38,UT,54,58,-4
2017,38,VA,2122,2141,-19
2017,38,VI,7,7,0
2017,38,VT,40,41,-1
2017,38,WA,413,416,-3
2017,38,WI,141,145,-4
2017,38,WV,148,172,-24
2017,38,WY,16,18,-2
2017,39,AK,46,47,-1
2017,39,AL,1242,995,247
2017,39,AR,278,246,32
2017,39,AZ,624,596,28
2017,39,CA,3252,3135,117
2017,39,CO,382,381,1
2017,39,CT,711,699,12
2017,39,DC,55,40,15
2017,39,DE,587,534,53
2017,39,FL,42344,35546,6798
2017,39,GA,2426,1936,490
2017,39,HI,2508,2494,14
2017,39,IA,313,318,-5
2017,39,ID,68,72,-4
2017,39,IL,506,477,29
2017,39,IN,338,353,-15
2017,39,KS,165,159,6
2017,39,KY,345,320,25
2017,39,LA,17797,16516,1281
2017,39,MA,1288,1305,-17
2017,39,MD,1358,1234,124
2017,39,ME,150,147,3
2017,39,MI,212,213,-1
2017,39,MN,155,156,-1
2017,39,MO,291,273,18
2017,39,MS,1428,1308,120
2017,39,MT,49,53,-4
2017,39,NC,3471,2955,516
2017,39,ND,184,191,-7
2017,39,NE,107,103,4
2017,39,NH,134,125,9
2017,39,NJ,3518,3528,-10
2017,39,NM,146,161,-15
2017,39,NV,161,165,-4
2017,39,NY,4670,4680,-10
2017,39,OH,525,518,7
2017,39,OK,245,229,16
2017,39,OR,416,404,12
2017,39,PA,1221,1216,5
2017,39,PR,59,66,-7
2017,39,RI,387,371,16
2017,39,SC,5103,4332,771
2017,39,SD,53,71,-18
2017,39,TN,594,486,108
2017,39,TX,23347,13802,9545
2017,39,UT,69,72,-3
2017,39,VA,3202,2600,602
2017,39,VI,12,14,-2
2017,39,VT,50,51,-1
2017,39,WA,646,610,36
2017,39,WI,180,195,-15
2017,39,WV,170,177,-7
2017,39,WY,24,26,-2
2017,40,AK,41,40,1
2017,40,AL,1689,1117,572
2017,40,AR,175,148,27
2017,40,AZ,454,389,65
2017,40,CA,3051,2825,226
2017,40,CO,321,306,15
2017,40,CT,612,519,93
2017,40,DC,68,34,34
2017,40,DE,672,411,261
2017,40,FL,56296,37599,18697
2017,40,GA,3181,1515,1666
2017,40,HI,1035,1064,-29
2017,40,IA,126,130,-4
2017,40,ID,66,65,1
2017,40,IL,430,398,32
2017,40,IN,278,249,29
2017,40,KS,144,124,20
2017,40,KY,221,192,29
2017,40,LA,10849,8386,2463
2017,40,MA,1164,1056,108
2017,40,MD,1725,1160,565
2017,40,ME,189,172,17
2017,40,MI,174,145,29
2017,40,MN,122,105,17
2017,40,MO,221,251,-30
2017,40,MS,1257,914,343
2017,40,MT,46,46,0
2017,40,NC,4497,2120,2377
2017,40,ND,102,112,-10
2017,40,NE,70,66,4
2017,40,NH,145,124,21
2017,40,NJ,6577,6206,371
2017,40,NM,119,122,-3
2017,40,NV,140,126,14
2017,40,NY,3838,3393,445
2017,40,OH,436,397,39
2017,40,OK,211,180,31
2017,40,OR,358,332,26
2017,40,PA,995,886,109
2017,40,PR,25,24,1
2017,40,RI,251,194,57
2017,40,SC,6936,4198,2738
2017,40,SD,40,43,-3
2017,40,TN,609,418,191
2017,40,TX,28755,10373,18382
2017,40,UT,63,57,6
2017,40,VA,4389,2285,2104
2017,40,VI,8,7,1
2017,40,VT,54,50,4
2017,40,WA,447,438,9
2017,40,WI,136,129,7
2017,40,WV,172,166,6
2017,40,WY,19,20,-1
2017,41,AK,25,23,2
2017,41,AL,799,585,214
2017,41,AR,188,168,20
2017,41,AZ,582,561,21
2017,41,CA,3775,3381,394
2017,41,CO,338,322,16
2017,41,CT,576,538,38
2017,41,DC,57,36,21
2017,41,DE,485,364,121
2017,41,FL,24641,22297,2344
2017,41,GA,1862,1341,521
2017,41,HI,974,686,288
2017,41,IA,126,138,-12
2017,41,ID,74,70,4
2017,41,IL,407,379,28
2017,41,IN,290,271,19
2017,41,KS,110,103,7
2017,41,KY,204,194,10
2017,41,LA,9009,8463,546
2017,41,MA,1257,1164,93
2017,41,MD,1151,872,279
2017,41,ME,150,136,14
2017,41,MI,249,207,42
2017,41,MN,121,95,26
2017,41,MO,251,222,29
2017,41,MS,888,807,81
2017,41,MT,51,54,-3
2017,41,NC,2717,2032,685
2017,41,ND,134,135,-1
2017,41,NE,72,68,4
2017,41,NH,92,84,8
2017,41,NJ,2819,2586,233
2017,41,NM,157,148,9
2017,41,NV,154,147,7
2017,41,NY,3985,3685,300
2017,41,OH,438,397,41
2017,41,OK,214,188,26
2017,41,OR,391,366,25
2017,41,PA,903,857,46
2017,41,PR,31,29,2
2017,41,RI,240,215,25
2017,41,SC,3237,2652,585
2017,41,SD,53,61,-8
2017,41,TN,572,389,183
2017,41,TX,19352,9319,10033
2017,41,UT,67,56,11
2017,41,VA,2447,1747,700
2017,41,VI,10,11,-1
2017,41,VT,52,55,-3
2017,41,WA,496,481,15
2017,41,WI,127,122,5
2017,41,WV,158,162,-4
2017,41,WY,20,23,-3
2017,42,AK,39,38,1
2017,42,AL,676,597,79
2017,42,AR,186,185,1
2017,42,AZ,585,592,-7
2017,42,CA,4277,3979,298
2017,42,CO,396,388,8
2017,42,CT,611,571,40
2017,42,DC,50,37,13
2017,42,DE,404,334,70
2017,42,FL,29893,24404,5489
2017,42,GA,1856,1470,386
2017,42,HI,1092,931,161
2017,42,IA,202,204,-2
2017,42,ID,79,80,-1
2017,42,IL,396,385,11
2017,42,IN,314,312,2
2017,42,KS,131,140,-9
2017,42,KY,196,194,2
2017,42,LA,8768,8561,207
2017,42,MA,1324,1271,53
2017,42,MD,1034,906,128
2017,42,ME,227,218,9
2017,42,MI,183,175,8
2017,42,MN,129,114,15
2017,42,MO,228,228,0
2017,42,MS,905,889,16
2017,42,MT,50,49,1
2017,42,NC,2389,2066,323
2017,42,ND,157,169,-12
2017,42,NE,90,86,4
2017,42,NH,80,67,13
2017,42,NJ,3020,2951,69
2017,42,NM,137,133,4
2017,42,NV,197,191,6
2017,42,NY,3193,3019,174
2017,42,OH,416,410,6
2017,42,OK,201,189,12
2017,42,OR,487,444,43
2017,42,PA,878,893,-15
2017,42,PR,29,33,-4
2017,42,RI,207,184,23
2017,42,SC,3393,2940,453
2017,42,SD,30,47,-17
2017,42,TN,408,374,34
2017,42,TX,17600,9921,7679
2017,42,UT,79,68,11
2017,42,VA,2619,2316,303
2017,42,VI,12,13,-1
2017,42,VT,49,49,0
2017,42,WA,572,556,16
2017,42,WI,148,141,7
2017,42,WV,141,147,-6
2017,42,WY,19,17,2
2017,43,AK,43,40,3
2017,43,AL,852,803,49
2017,43,AR,170,182,-12
2017,43,AZ,455,482,-27
2017,43,CA,4319,4259,60
2017,43,CO,408,383,25
2017,43,CT,513,496,17
2017,43,DC,43,35,8
2017,43,DE,562,542,20
2017,43,FL,25520,22879,2641
2017,43,GA,1704,1549,155
2017,43,HI,1058,1034,24
2017,43,IA,123,144,-21
2017,43,ID,74,70,4
2017,43,IL,412,420,-8
2017,43,IN,273,275,-2
2017,43,KS,129,126,3
2017,43,KY,231,243,-12
2017,43,LA,7754,7670,84
2017,43,MA,1035,1087,-52
2017,43,MD,926,870,56
2017,43,ME,152,151,1
2017,43,MI,214,216,-2
2017,43,MN,129,130,-1
2017,43,MO,227,228,-1
2017,43,MS,974,923,51
2017,43,MT,51,53,-2
2017,43,NC,2044,1882,162
2017,43,ND,125,132,-7
2017,43,NE,67,73,-6
2017,43,NH,102,101,1
2017,43,NJ,2779,2751,28
2017,43,NM,139,143,-4
2017,43,NV,142,147,-5
2017,43,NY,2766,2739,27
2017,43,OH,445,453,-8
2017,43,OK,198,193,5
2017,43,OR,414,413,1
2017,43,PA,1199,1251,-52
2017,43,PR,29,43,-14
2017,43,RI,201,196,5
2017,43,SC,2990,2700,290
2017,43,SD,33,38,-5
2017,43,TN,396,379,17
2017,43,TX,14663,10047,4616
2017,43,UT,61,52,9
2017,43,VA,1808,1713,95
2017,43,VI,5,6,-1
2017,43,VT,49,56,-7
2017,43,WA,635,630,5
2017,43,WI,151,152,-1
2017,43,WV,151,159,-8
2017,43,WY,25,24,1
2017,44,AK,33,37,-4
2017,44,AL,868,851,17
2017,44,AR,194,189,5
2017,44,AZ,410,400,10
2017,44,CA,4233,4187,46
2017,44,CO,271,267,4
2017,44,CT,449,468,-19
2017,44,DC,31,35,-4
2017,44,DE,414,397,17
2017,44,FL,28842,27445,1397
2017,44,GA,1802,1726,76
2017,44,HI,1733,1708,25
2017,44,IA,184,191,-7
2017,44,ID,70,77,-7
2017,44,IL,427,422,5
2017,44,IN,263,274,-11
2017,44,KS,136,131,5
2017,44,KY,249,256,-7
2017,44,LA,8342,8246,96
2017,44,MA,1309,1150,159
2017,44,MD,1101,1103,-2
2017,44,ME,152,148,4
2017,44,MI,204,200,4
2017,44,MN,113,111,2
2017,44,MO,212,221,-9
2017,44,MS,877,887,-10
2017,44,MT,46,45,1
2017,44,NC,2245,2251,-6
2017,44,ND,161,168,-7
2017,44,NE,71,74,-3
2017,44,NH,100,102,-2
2017,44,NJ,3069,3084,-15
2017,44,NM,127,131,-4
2017,44,NV,141,144,-3
2017,44,NY,3207,3291,-84
2017,44,OH,365,396,-31
2017,44,OK,205,197,8
2017,44,OR,518,504,14
2017,44,PA,877,936,-59
2017,44,PR,30,36,-6
2017,44,RI,202,205,-3
2017,44,SC,3566,3771,-205
2017,44,SD,40,44,-4
2017,44,TN,459,446,13
2017,44,TX,13680,9980,3700
2017,44,UT,61,57,4
2017,44,VA,2008,2046,-38
2017,44,VI,11,11,0
2017,44,VT,55,59,-4
2017,44,WA,738,748,-10
2017,44,WI,127,130,-3
2017,44,WV,167,161,6
2017,44,WY,25,25,0
2017,45,AK,30,31,-1
2017,45,AL,743,707,36
2017,45,AR,181,185,-4
2017,45,AZ,310,316,-6
2017,45,CA,3934,3830,104
2017,45,CO,228,235,-7
2017,45,CT,430,418,12
2017,45,DC,37,37,0
2017,45,DE,226,226,0
2017,45,FL,20626,19776,850
2017,45,GA,1272,1249,23
2017,45,HI,551,494,57
2017,45,IA,104,111,-7
2017,45,ID,70,70,0
2017,45,IL,336,333,3
2017,45,IN,240,239,1
2017,45,KS,92,98,-6
2017,45,KY,201,224,-23
2017,45,LA,5901,5898,3
2017,45,MA,809,807,2
2017,45,MD,727,725,2
2017,45,ME,137,126,11
2017,45,MI,170,169,1
2017,45,MN,83,76,7
2017,45,MO,243,246,-3
2017,45,MS,914,904,10
2017,45,MT,47,48,-1
2017,45,NC,1882,1896,-14
2017,45,ND,113,112,1
2017,45,NE,61,65,-4
2017,45,NH,72,67,5
2017,45,NJ,2682,2726,-44
2017,45,NM,92,96,-4
2017,45,NV,112,120,-8
2017,45,NY,2424,2423,1
2017,45,OH,297,319,-22
2017,45,OK,153,150,3
2017,45,OR,422,411,11
2017,45,PA,729,758,-29
2017,45,PR,30,34,-4
2017,45,RI,158,165,-7
2017,45,SC,2761,2750,11
2017,45,SD,28,34,-6
2017,45,TN,383,383,0
2017,45,TX,10296,7232,3064
2017,45,UT,55,59,-4
2017,45,VA,1973,1984,-11
2017,45,VI,5,8,-3
2017,45,VT,45,45,0
2017,45,WA,729,750,-21
2017,45,WI,105,104,1
2017,45,WV,127,138,-11
2017,45,WY,29,26,3
2017,46,AK,18,20,-2
2017,46,AL,820,809,11
2017,46,AR,159,165,-6
2017,46,AZ,344,352,-8
2017,46,CA,4562,4582,-20
2017,46,CO,282,270,12
2017,46,CT,720,730,-10
2017,46,DC,22,20,2
2017,46,DE,363,349,14
2017,46,FL,21864,21389,475
2017,46,GA,1283,1237,46
2017,46,HI,679,671,8
2017,46,IA,121,131,-10
2017,46,ID,65,57,8
2017,46,IL,421,410,11
2017,46,IN,250,251,-1
2017,46,KS,122,129,-7
2017,46,KY,193,184,9
2017,46,LA,6721,6543,178
2017,46,MA,903,908,-5
2017,46,MD,885,883,2
2017,46,ME,127,122,5
2017,46,MI,163,153,10
2017,46,MN,103,91,12
2017,46,MO,184,178,6
2017,46,MS,861,867,-6
2017,46,MT,41,46,-5
2017,46,NC,2286,2267,19
2017,46,ND,88,102,-14
2017,46,NE,61,67,-6
2017,46,NH,83,80,3
2017,46,NJ,3227,3283,-56
2017,46,NM,123,126,-3
2017,46,NV,144,154,-10
2017,46,NY,2481,2539,-58
2017,46,OH,363,367,-4
2017,46,OK,166,164,2
2017,46,OR,553,545,8
2017,46,PA,699,725,-26
2017,46,PR,25,33,-8
2017,46,RI,136,139,-3
2017,46,SC,3185,3152,33
2017,46,SD,25,24,1
2017,46,TN,363,365,-2
2017,46,TX,10091,7738,2353
2017,46,UT,50,56,-6
2017,46,VA,1848,1874,-26
2017,46,VI,14,16,-2
2017,46,VT,58,55,3
2017,46,WA,713,733,-20
2017,46,WI,118,116,2
2017,46,WV,152,158,-6
2017,46,WY,13,17,-4
2017,47,AK,55,53,2
2017,47,AL,457,460,-3
2017,47,AR,125,137,-12
2017,47,AZ,340,361,-21
2017,47,CA,5318,5573,-255
2017,47,CO,212,203,9
2017,47,CT,651,649,2
2017,47,DC,26,27,-1
2017,47,DE,285,277,8
2017,47,FL,19647,19328,319
2017,47,GA,1080,1043,37
2017,47,HI,755,730,25
2017,47,IA,105,109,-4
2017,47,ID,60,61,-1
2017,47,IL,326,349,-23
2017,47,IN,236,227,9
2017,47,KS,89,101,-12
2017,47,KY,207,213,-6
2017,47,LA,5655,5637,18
2017,47,MA,796,817,-21
2017,47,MD,840,866,-26
2017,47,ME,112,116,-4
2017,47,MI,141,138,3
2017,47,MN,82,79,3
2017,47,MO,241,242,-1
2017,47,MS,816,821,-5
2017,47,MT,36,34,2
2017,47,NC,1657,1646,11
2017,47,ND,84,93,-9
2017,47,NE,53,52,1
2017,47,NH,78,82,-4
2017,47,NJ,2262,2304,-42
2017,47,NM,84,93,-9
2017,47,NV,156,154,2
2017,47,NY,2308,2358,-50
2017,47,OH,325,335,-10
2017,47,OK,143,146,-3
2017,47,OR,463,471,-8
2017,47,PA,696,727,-31
2017,47,PR,32,40,-8
2017,47,RI,138,140,-2
2017,47,SC,2361,2328,33
2017,47,SD,37,46,-9
2017,47,TN,361,363,-2
2017,47,TX,9217,7180,2037
2017,47,UT,46,54,-8
2017,47,VA,1396,1415,-19
2017,47,VI,5,5,0
2017,47,VT,42,49,-7
2017,47,WA,601,613,-12
2017,47,WI,103,97,6
2017,47,WV,119,130,-11
2017,47,WY,18,17,1
2017,48,AK,25,34,-9
2017,48,AL,816,794,22
2017,48,AR,156,154,2
2017,48,AZ,368,389,-21
2017,48,CA,6857,7591,-734
2017,48,CO,240,253,-13
2017,48,CT,649,674,-25
2017,48,DC,102,54,48
2017,48,DE,341,331,10
2017,48,FL,26026,25753,273
2017,48,GA,1236,1196,40
2017,48,GU,1,2,-1
2017,48,HI,1345,1336,9
2017,48,IA,124,131,-7
2017,48,ID,63,64,-1
2017,48,IL,419,445,-26
2017,48,IN,219,243,-24
2017,48,KS,115,122,-7
2017,48,KY,264,262,2
2017,48,LA,7469,7453,16
2017,48,MA,862,865,-3
2017,48,MD,941,963,-22
2017,48,ME,116,107,9
2017,48,MI,197,201,-4
2017,48,MN,96,105,-9
2017,48,MO,193,196,-3
2017,48,MS,830,835,-5
2017,48,MT,49,54,-5
2017,48,NC,1707,1740,-33
2017,48,ND,82,90,-8
2017,48,NE,64,56,8
2017,48,NH,188,177,11
2017,48,NJ,3199,3125,74
2017,48,NM,115,119,-4
2017,48,NV,129,143,-14
2017,48,NY,2781,2791,-10
2017,48,OH,320,331,-11
2017,48,OK,155,161,-6
2017,48,OR,453,464,-11
2017,48,PA,737,791,-54
2017,48,PR,116,32,84
2017,48,RI,185,191,-6
2017,48,SC,2899,2869,30
2017,48,SD,35,42,-7
2017,48,TN,471,464,7
2017,48,TX,10098,8315,1783
2017,48,UT,64,60,4
2017,48,VA,1535,1531,4
2017,48,VI,6,4,2
2017,48,VT,73,70,3
2017,48,WA,725,731,-6
2017,48,WI,110,115,-5
2017,48,WV,128,137,-9
2017,48,WY,29,26,3
2017,49,AK,24,23,1
2017,49,AL,1024,1025,-1
2017,49,AR,121,129,-8
2017,49,AZ,298,317,-19
2017,49,CA,5789,6264,-475
2017,49,CO,264,268,-4
2017,49,CT,420,433,-13
2017,49,DC,25,24,1
2017,49,DE,330,320,10
2017,49,FL,18138,18046,92
2017,49,GA,1035,999,36
2017,49,HI,264,254,10
2017,49,IA,89,106,-17
2017,49,ID,64,60,4
2017,49,IL,304,309,-5
2017,49,IN,192,203,-11
2017,49,KS,92,104,-12
2017,49,KY,191,189,2
2017,49,LA,5823,5718,105
2017,49,MA,1039,1035,4
2017,49,MD,863,872,-9
2017,49,ME,133,135,-2
2017,49,MI,163,334,-171
2017,49,MN,84,86,-2
2017,49,MO,224,218,6
2017,49,MS,910,930,-20
2017,49,MT,35,32,3
2017,49,NC,1633,1645,-12
2017,49,ND,102,102,0
2017,49,NE,51,62,-11
2017,49,NH,98,94,4
2017,49,NJ,2223,2283,-60
2017,49,NM,104,106,-2
2017,49,NV,119,120,-1
2017,49,NY,2522,2620,-98
2017,49,OH,349,350,-1
2017,49,OK,141,152,-11
2017,49,OR,440,448,-8
2017,49,PA,706,731,-25
2017,49,PR,21,34,-13
2017,49,RI,239,232,7
2017,49,SC,2185,2172,13
2017,49,SD,34,39,-5
2017,49,TN,320,325,-5
2017,49,TX,8380,6767,1613
2017,49,UT,43,43,0
2017,49,VA,1314,1335,-21
2017,49,VI,45,44,1
2017,49,VT,29,28,1
2017,49,WA,583,620,-37
2017,49,WI,101,107,-6
2017,49,WV,115,120,-5
2017,49,WY,17,19,-2
2017,50,AK,28,31,-3
2017,50,AL,477,460,17
2017,50,AR,142,138,4
2017,50,AZ,328,340,-12
2017,50,CA,5602,5934,-332
2017,50,CO,234,245,-11
2017,50,CT,490,479,11
2017,50,DC,23,27,-4
2017,50,DE,331,329,2
2017,50,FL,22690,22901,-211
2017,50,GA,1092,1080,12
2017,50,HI,1767,1748,19
2017,50,IA,132,145,-13
2017,50,ID,65,63,2
2017,50,IL,315,322,-7
2017,50,IN,195,197,-2
2017,50,KS,108,123,-15
2017,50,KY,183,190,-7
2017,50,LA,6104,6118,-14
2017,50,MA,713,719,-6
2017,50,MD,742,780,-38
2017,50,ME,119,125,-6
2017,50,MI,191,192,-1
2017,50,MN,82,84,-2
2017,50,MO,196,188,8
2017,50,MS,774,783,-9
2017,50,MT,40,41,-1
2017,50,NC,1608,1636,-28
2017,50,ND,80,88,-8
2017,50,NE,66,75,-9
2017,50,NH,66,68,-2
2017,50,NJ,2694,3087,-393
2017,50,NM,113,117,-4
2017,50,NV,141,137,4
2017,50,NY,2807,2930,-123
2017,50,OH,419,417,2
2017,50,OK,141,154,-13
2017,50,OR,404,416,-12
2017,50,PA,642,704,-62
2017,50,PR,27,37,-10
2017,50,RI,134,143,-9
2017,50,SC,2573,2570,3
2017,50,SD,25,30,-5
2017,50,TN,329,330,-1
2017,50,TX,8310,6807,1503
2017,50,UT,43,44,-1
2017,50,VA,1296,1333,-37
2017,50,VI,9,7,2
2017,50,VT,41,46,-5
2017,50,WA,579,598,-19
2017,50,WI,101,109,-8
2017,50,WV,140,149,-9
2017,50,WY,19,19,0
2017,51,AK,18,17,1
2017,51,AL,482,498,-16
2017,51,AR,154,147,7
2017,51,AZ,318,340,-22
2017,51,CA,4360,4868,-508
2017,51,CO,280,294,-14
2017,51,CT,278,295,-17
2017,51,DC,33,32,1
2017,51,DE,287,281,6
2017,51,FL,20708,20775,-67
2017,51,GA,1211,1191,20
2017,51,GU,3,2,1
2017,51,HI,690,681,9
2017,51,IA,116,126,-10
2017,51,ID,57,55,2
2017,51,IL,343,352,-9
2017,51,IN,218,241,-23
2017,51,KS,90,94,-4
2017,51,KY,268,269,-1
2017,51,LA,6052,6116,-64
2017,51,MA,748,765,-17
2017,51,MD,692,701,-9
2017,51,ME,103,98,5
2017,51,MI,153,176,-23
2017,51,MN,74,85,-11
2017,51,MO,184,196,-12
2017,51,MS,842,882,-40
2017,51,MT,39,42,-3
2017,51,NC,1635,1690,-55
2017,51,ND,94,107,-13
2017,51,NE,53,59,-6
2017,51,NH,83,77,6
2017,51,NJ,2476,2548,-72
2017,51,NM,90,102,-12
2017,51,NV,101,111,-10
2017,51,NY,2681,2791,-110
2017,51,OH,295,289,6
2017,51,OK,124,122,2
2017,51,OR,395,426,-31
2017,51,PA,659,695,-36
2017,51,PR,30,29,1
2017,51,RI,139,145,-6
2017,51,SC,2947,3016,-69
2017,51,SD,36,43,-7
2017,51,TN,306,315,-9
2017,51,TX,7797,6880,917
2017,51,UT,76,71,5
2017,51,VA,1209,1237,-28
2017,51,VI,3,3,0
2017,51,VT,27,34,-7
2017,51,WA,644,679,-35
2017,51,WI,90,95,-5
2017,51,WV,125,142,-17
2017,51,WY,23,24,-1
2017,52,AK,16,15,1
2017,52,AL,397,402,-5
2017,52,AR,83,92,-9
2017,52,AZ,253,286,-33
2017,52,CA,3348,3597,-249
2017,52,CO,219,210,9
2017,52,CT,311,317,-6
2017,52,DC,26,21,5
2017,52,DE,205,209,-4
2017,52,FL,17890,17916,-26
2017,52,GA,740,746,-6
2017,52,HI,1126,1130,-4
2017,52,IA,83,91,-8
2017,52,ID,44,50,-6
2017,52,IL,208,212,-4
2017,52,IN,126,134,-8
2017,52,KS,69,75,-6
2017,52,KY,123,138,-15
2017,52,LA,4571,4599,-28
2017,52,MA,803,830,-27
2017,52,MD,1017,1023,-6
2017,52,ME,77,75,2
2017,52,MI,128,141,-13
2017,52,MN,69,74,-5
2017,52,MO,141,161,-20
2017,52,MS,532,551,-19
2017,52,MT,22,25,-3
2017,52,NC,1123,1095,28
2017,52,ND,70,80,-10
2017,52,NE,58,66,-8
2017,52,NH,64,62,2
2017,52,NJ,1721,1821,-100
2017,52,NM,92,96,-4
2017,52,NV,95,89,6
2017,52,NY,2430,2234,196
2017,52,OH,231,240,-9
2017,52,OK,118,123,-5
2017,52,OR,292,300,-8
2017,52,PA,478,499,-21
2017,52,PR,56,71,-15
2017,52,RI,104,107,-3
2017,52,SC,1696,1688,8
2017,52,SD,25,25,0
2017,52,TN,314,328,-14
2017,52,TX,6235,5252,983
2017,52,UT,33,38,-5
2017,52,VA,900,949,-49
2017,52,VI,2,26,-24
2017,52,VT,28,29,-1
2017,52,WA,409,414,-5
2017,52,WI,72,77,-5
2017,52,WV,79,79,0
2017,52,WY,20,23,-3
2017,53,AK,2,2,0
2017,53,AL,148,155,-7
2017,53,AR,15,13,2
2017,53,AZ,51,56,-5
2017,53,CA,726,814,-88
2017,53,CO,39,41,-2
2017,53,CT,45,52,-7
2017,53,DC,4,4,0
2017,53,DE,28,30,-2
2017,53,FL,6017,6166,-149
2017,53,GA,147,150,-3
2017,53,HI,36,39,-3
2017,53,IA,7,10,-3
2017,53,ID,15,15,0
2017,53,IL,37,40,-3
2017,53,IN,29,33,-4
2017,53,KS,14,16,-2
2017,53,KY,24,28,-4
2017,53,LA,974,978,-4
2017,53,MA,173,174,-1
2017,53,MD,102,104,-2
2017,53,ME,13,14,-1
2017,53,MI,26,24,2
2017,53,MN,15,15,0
2017,53,MO,24,26,-2
2017,53,MS,92,103,-11
2017,53,MT,2,2,0
2017,53,NC,194,199,-5
2017,53,ND,49,51,-2
2017,53,NE,11,11,0
2017,53,NH,7,10,-3
2017,53,NJ,213,222,-9
2017,53,NM,16,16,0
2017,53,NV,13,12,1
2017,53,NY,395,409,-14
2017,53,OH,43,41,2
2017,53,OK,17,20,-3
2017,53,OR,103,106,-3
2017,53,PA,87,92,-5
2017,53,PR,5,6,-1
2017,53,RI,12,13,-1
2017,53,SC,967,970,-3
2017,53,SD,4,5,-1
2017,53,TN,49,52,-3
2017,53,TX,1185,974,211
2017,53,UT,8,6,2
2017,53,VA,118,123,-5
2017,53,VT,1,1,0
2017,53,WA,93,100,-7
2017,53,WI,12,13,-1
2017,53,WV,15,18,-3
2017,53,WY,1,2,-1
2018,0,AK,10,8,2
2018,0,AL,359,372,-13
2018,0,AR,129,134,-5
2018,0,AZ,277,296,-19
2018,0,CA,4547,4889,-342
2018,0,CO,191,188,3
2018,0,CT,450,449,1
2018,0,DC,26,27,-1
2018,0,DE,349,348,1
2018,0,FL,23266,23061,205
2018,0,GA,2417,2422,-5
2018,0,HI,728,709,19
2018,0,IA,103,102,1
2018,0,ID,47,52,-5
2018,0,IL,266,278,-12
2018,0,IN,152,164,-12
2018,0,KS,76,81,-5
2018,0,KY,122,134,-12
2018,0,LA,3695,3649,46
2018,0,MA,553,560,-7
2018,0,MD,510,526,-16
2018,0,ME,79,81,-2
2018,0,MI,102,108,-6
2018,0,MN,66,69,-3
2018,0,MO,178,176,2
2018,0,MS,580,585,-5
2018,0,MT,32,35,-3
2018,0,NC,1258,1266,-8
2018,0,ND,84,99,-15
2018,0,NE,70,71,-1
2018,0,NH,52,56,-4
2018,0,NJ,1665,1696,-31
2018,0,NM,87,93,-6
2018,0,NV,102,114,-12
2018,0,NY,1921,1987,-66
2018,0,OH,215,229,-14
2018,0,OK,93,102,-9
2018,0,OR,370,375,-5
2018,0,PA,484,530,-46
2018,0,PR,18,24,-6
2018,0,RI,103,109,-6
2018,0,SC,1774,1717,57
2018,0,SD,25,32,-7
2018,0,TN,224,243,-19
2018,0,TX,6673,5469,1204
2018,0,UT,30,26,4
2018,0,VA,1060,1066,-6
2018,0,VI,2,1,1
2018,0,VT,19,20,-1
2018,0,WA,379,416,-37
2018,0,WI,157,153,4
2018,0,WV,89,98,-9
2018,0,WY,3,6,-3
2018,1,AK,24,27,-3
2018,1,AL,564,570,-6
2018,1,AR,103,104,-1
2018,1,AZ,312,342,-30
2018,1,CA,3938,4282,-344
2018,1,CO,206,209,-3
2018,1,CT,492,494,-2
2018,1,DC,25,23,2
2018,1,DE,249,254,-5
2018,1,FL,17401,17241,160
2018,1,GA,902,899,3
2018,1,HI,1060,1055,5
2018,1,IA,94,99,-5
2018,1,ID,54,56,-2
2018,1,IL,556,557,-1
2018,1,IN,214,225,-11
2018,1,KS,125,131,-6
2018,1,KY,159,177,-18
2018,1,LA,4817,4776,41
2018,1,MA,506,515,-9
2018,1,MD,677,694,-17
2018,1,ME,99,98,1
2018,1,MI,189,192,-3
2018,1,MN,69,78,-9
2018,1,MO,165,184,-19
2018,1,MS,736,762,-26
2018,1,MT,37,38,-1
2018,1,NC,1315,1325,-10
2018,1,ND,200,210,-10
2018,1,NE,69,69,0
2018,1,NH,61,61,0
2018,1,NJ,1852,1882,-30
2018,1,NM,91,94,-3
2018,1,NV,129,126,3
2018,1,NY,2459,2540,-81
2018,1,OH,328,353,-25
2018,1,OK,139,135,4
2018,1,OR,439,478,-39
2018,1,PA,637,670,-33
2018,1,PR,39,29,10
2018,1,RI,297,302,-5
2018,1,SC,2138,2097,41
2018,1,SD,21,31,-10
2018,1,TN,241,243,-2
2018,1,TX,6505,5261,1244
2018,1,UT,45,47,-2
2018,1,VA,880,891,-11
2018,1,VI,6,4,2
2018,1,VT,34,34,0
2018,1,WA,489,522,-33
2018,1,WI,109,113,-4
2018,1,WV,120,133,-13
2018,1,WY,17,17,0
2018,2,AK,33,34,-1
2018,2,AL,513,505,8
2018,2,AR,116,119,-3
2018,2,AZ,296,305,-9
2018,2,CA,3821,4125,-304
2018,2,CO,167,182,-15
2018,2,CT,371,375,-4
2018,2,DC,19,20,-1
2018,2,DE,391,396,-5
2018,2,FL,19830,19624,206
2018,2,GA,913,918,-5
2018,2,HI,830,856,-26
2018,2,IA,92,96,-4
2018,2,ID,43,43,0
2018,2,IL,274,275,-1
2018,2,IN,186,201,-15
2018,2,KS,105,112,-7
2018,2,KY,154,166,-12
2018,2,LA,4921,4854,67
2018,2,MA,576,586,-10
2018,2,MD,1113,1119,-6
2018,2,ME,102,102,0
2018,2,MI,146,149,-3
2018,2,MN,64,77,-13
2018,2,MO,207,208,-1
2018,2,MS,674,687,-13
2018,2,MT,33,38,-5
2018,2,NC,1706,1696,10
2018,2,ND,191,218,-27
2018,2,NE,49,53,-4
2018,2,NH,76,80,-4
2018,2,NJ,1919,1958,-39
2018,2,NM,84,96,-12
2018,2,NV,129,133,-4
2018,2,NY,2713,2721,-8
2018,2,OH,245,266,-21
2018,2,OK,114,121,-7
2018,2,OR,373,400,-27
2018,2,PA,573,955,-382
2018,2,PR,37,29,8
2018,2,RI,107,115,-8
2018,2,SC,2321,2315,6
2018,2,SD,22,21,1
2018,2,TN,241,241,0
2018,2,TX,6785,5347,1438
2018,2,UT,29,37,-8
2018,2,VA,865,906,-41
2018,2,VI,3,3,0
2018,2,VT,23,25,-2
2018,2,WA,624,653,-29
2018,2,WI,180,183,-3
2018,2,WV,117,120,-3
2018,2,WY,19,19,0
2018,3,AK,18,17,1
2018,3,AL,426,442,-16
2018,3,AR,105,108,-3
2018,3,AZ,232,243,-11
2018,3,CA,2659,2775,-116
2018,3,CO,178,187,-9
2018,3,CT,198,205,-7
2018,3,DC,27,26,1
2018,3,DE,201,213,-12
2018,3,FL,17556,17560,-4
2018,3,GA,907,900,7
2018,3,HI,426,449,-23
2018,3,IA,73,80,-7
2018,3,ID,33,30,3
2018,3,IL,244,272,-28
2018,3,IN,145,147,-2
2018,3,KS,64,79,-15
2018,3,KY,130,143,-13
2018,3,LA,4226,4167,59
2018,3,MA,431,485,-54
2018,3,MD,490,507,-17
2018,3,ME,72,72,0
2018,3,MI,124,137,-13
2018,3,MN,67,72,-5
2018,3,MO,133,145,-12
2018,3,MS,539,560,-21
2018,3,MT,37,42,-5
2018,3,NC,1152,1161,-9
2018,3,ND,106,135,-29
2018,3,NE,50,54,-4
2018,3,NH,56,57,-1
2018,3,NJ,1655,1688,-33
2018,3,NM,71,76,-5
2018,3,NV,82,84,-2
2018,3,NY,1777,1852,-75
2018,3,OH,208,218,-10
2018,3,OK,110,110,0
2018,3,OR,318,343,-25
2018,3,PA,474,502,-28
2018,3,PR,96,25,71
2018,3,RI,85,89,-4
2018,3,SC,1735,1733,2
2018,3,SD,13,17,-4
2018,3,TN,241,225,16
2018,3,TX,5731,4955,776
2018,3,UT,35,34,1
2018,3,VA,832,820,12
2018,3,VI,15,13,2
2018,3,VT,36,43,-7
2018,3,WA,334,347,-13
2018,3,WI,86,95,-9
2018,3,WV,82,90,-8
2018,3,WY,7,7,0
2018,4,AK,26,30,-4
2018,4,AL,851,872,-21
2018,4,AR,171,190,-19
2018,4,AZ,303,328,-25
2018,4,CA,3535,3694,-159
2018,4,CO,272,257,15
2018,4,CT,301,308,-7
2018,4,DC,33,34,-1
2018,4,DE,198,192,6
2018,4,FL,20595,20903,-308
2018,4,GA,1035,1079,-44
2018,4,HI,1775,1787,-12
2018,4,IA,99,119,-20
2018,4,ID,69,76,-7
2018,4,IL,315,329,-14
2018,4,IN,207,218,-11
2018,4,KS,91,99,-8
2018,4,KY,198,212,-14
2018,4,LA,24545,24546,-1
2018,4,MA,523,542,-19
2018,4,MD,611,637,-26
2018,4,ME,79,80,-1
2018,4,MI,151,156,-5
2018,4,MN,88,98,-10
2018,4,MO,192,191,1
2018,4,MS,941,992,-51
2018,4,MT,53,55,-2
2018,4,NC,1496,1515,-19
2018,4,ND,150,198,-48
2018,4,NE,57,81,-24
2018,4,NH,52,56,-4
2018,4,NJ,2422,2471,-49
2018,4,NM,89,103,-14
2018,4,NV,152,174,-22
2018,4,NY,2044,2556,-512
2018,4,OH,266,268,-2
2018,4,OK,120,115,5
2018,4,OR,346,359,-13
2018,4,PA,654,695,-41
2018,4,PR,32,26,6
2018,4,RI,108,114,-6
2018,4,SC,2187,2205,-18
2018,4,SD,24,34,-10
2018,4,TN,274,273,1
2018,4,TX,6640,5742,898
2018,4,UT,42,49,-7
2018,4,VA,980,1009,-29
2018,4,VI,12,5,7
2018,4,VT,44,46,-2
2018,4,WA,494,481,13
2018,4,WI,109,119,-10
2018,4,WV,125,132,-7
2018,4,WY,15,14,1
2018,5,AK,21,24,-3
2018,5,AL,554,560,-6
2018,5,AR,149,159,-10
2018,5,AZ,364,367,-3
2018,5,CA,4855,5485,-630
2018,5,CO,396,206,190
2018,5,CT,281,308,-27
2018,5,DC,21,20,1
2018,5,DE,207,206,1
2018,5,FL,17389,17368,21
2018,5,GA,912,924,-12
2018,5,HI,574,597,-23
2018,5,IA,112,122,-10
2018,5,ID,128,228,-100
2018,5,IL,380,397,-17
2018,5,IN,238,251,-13
2018,5,KS,105,111,-6
2018,5,KY,186,193,-7
2018,5,LA,5627,5580,47
2018,5,MA,714,707,7
2018,5,MD,530,507,23
2018,5,ME,120,118,2
2018,5,MI,171,173,-2
2018,5,MN,108,110,-2
2018,5,MO,180,190,-10
2018,5,MS,802,844,-42
2018,5,MT,66,60,6
2018,5,NC,1392,1355,37
2018,5,ND,184,235,-51
2018,5,NE,65,64,1
2018,5,NH,56,67,-11
2018,5,NJ,2048,2015,33
2018,5,NM,97,103,-6
2018,5,NV,185,215,-30
2018,5,NY,2108,2113,-5
2018,5,OH,357,370,-13
2018,5,OK,142,145,-3
2018,5,OR,363,366,-3
2018,5,PA,655,889,-234
2018,5,PR,49,20,29
2018,5,RI,120,126,-6
2018,5,SC,1996,1946,50
2018,5,SD,19,19,0
2018,5,TN,264,275,-11
2018,5,TX,7050,5937,1113
2018,5,UT,120,126,-6
2018,5,VA,940,935,5
2018,5,VI,10,4,6
2018,5,VT,45,46,-1
2018,5,WA,470,472,-2
2018,5,WI,92,101,-9
2018,5,WV,154,163,-9
2018,5,WY,22,21,1
2018,6,AK,27,25,2
2018,6,AL,688,715,-27
2018,6,AR,141,156,-15
2018,6,AZ,289,299,-10
2018,6,CA,3700,3905,-205
2018,6,CO,214,219,-5
2018,6,CT,280,296,-16
2018,6,DC,31,30,1
2018,6,DE,215,216,-1
2018,6,FL,21379,21374,5
2018,6,GA,918,933,-15
2018,6,HI,988,990,-2
2018,6,IA,126,133,-7
2018,6,ID,89,157,-68
2018,6,IL,669,690,-21
2018,6,IN,234,251,-17
2018,6,KS,112,114,-2
2018,6,KY,181,189,-8
2018,6,LA,5458,5476,-18
2018,6,MA,933,933,0
2018,6,MD,547,544,3
2018,6,ME,88,80,8
2018,6,MI,172,174,-2
2018,6,MN,110,120,-10
2018,6,MO,189,194,-5
2018,6,MS,754,763,-9
2018,6,MT,66,66,0
2018,6,NC,1380,1373,7
2018,6,ND,224,287,-63
2018,6,NE,85,84,1
2018,6,NH,70,67,3
2018,6,NJ,2157,2128,29
2018,6,NM,85,91,-6
2018,6,NV,175,202,-27
2018,6,NY,2145,2165,-20
2018,6,OH,326,327,-1
2018,6,OK,136,134,2
2018,6,OR,381,396,-15
2018,6,PA,856,869,-13
2018,6,PR,52,33,19
2018,6,RI,127,127,0
2018,6,SC,2216,2170,46
2018,6,SD,32,37,-5
2018,6,TN,297,301,-4
2018,6,TX,7624,6842,782
2018,6,UT,42,43,-1
2018,6,VA,1099,1125,-26
2018,6,VI,13,5,8
2018,6,VT,46,44,2
2018,6,WA,530,519,11
2018,6,WI,113,117,-4
2018,6,WV,144,160,-16
2018,6,WY,21,22,-1
2018,7,AK,26,24,2
2018,7,AL,720,735,-15
2018,7,AR,157,162,-5
2018,7,AZ,294,304,-10
2018,7,CA,3450,3637,-187
2018,7,CO,218,222,-4
2018,7,CT,259,278,-19
2018,7,DC,42,43,-1
2018,7,DE,246,242,4
2018,7,FL,19238,19289,-51
2018,7,GA,990,983,7
2018,7,HI,1355,1365,-10
2018,7,IA,130,137,-7
2018,7,ID,94,197,-103
2018,7,IL,365,369,-4
2018,7,IN,221,234,-13
2018,7,KS,103,109,-6
2018,7,KY,211,212,-1
2018,7,LA,6246,6170,76
2018,7,MA,420,411,9
2018,7,MD,468,491,-23
2018,7,ME,91,86,5
2018,7,MI,212,214,-2
2018,7,MN,124,145,-21
2018,7,MO,181,191,-10
2018,7,MS,850,859,-9
2018,7,MT,76,78,-2
2018,7,NC,1560,1561,-1
2018,7,ND,176,199,-23
2018,7,NE,100,106,-6
2018,7,NH,60,59,1
2018,7,NJ,1893,1894,-1
2018,7,NM,110,106,4
2018,7,NV,142,160,-18
2018,7,NY,2773,2802,-29
2018,7,OH,428,431,-3
2018,7,OK,139,145,-6
2018,7,OR,347,416,-69
2018,7,PA,826,842,-16
2018,7,PR,66,26,40
2018,7,RI,101,100,1
2018,7,SC,1909,1901,8
2018,7,SD,25,37,-12
2018,7,TN,384,325,59
2018,7,TX,7623,6423,1200
2018,7,UT,70,78,-8
2018,7,VA,1007,1022,-15
2018,7,VI,12,3,9
2018,7,VT,31,34,-3
2018,7,WA,437,455,-18
2018,7,WI,114,114,0
2018,7,WV,143,160,-17
2018,7,WY,15,16,-1
2018,8,AK,37,36,1
2018,8,AL,579,584,-5
2018,8,AR,185,187,-2
2018,8,AZ,346,375,-29
2018,8,CA,3200,3225,-25
2018,8,CO,258,279,-21
2018,8,CT,375,404,-29
2018,8,DC,28,31,-3
2018,8,DE,280,276,4
2018,8,FL,31404,31848,-444
2018,8,GA,1378,1422,-44
2018,8,GU,1,1,0
2018,8,HI,1241,1274,-33
2018,8,IA,197,211,-14
2018,8,ID,131,184,-53
2018,8,IL,455,472,-17
2018,8,IN,264,287,-23
2018,8,KS,136,137,-1
2018,8,KY,219,227,-8
2018,8,LA,7952,7958,-6
2018,8,MA,738,728,10
2018,8,MD,1093,1129,-36
2018,8,ME,106,102,4
2018,8,MI,227,234,-7
2018,8,MN,203,214,-11
2018,8,MO,278,289,-11
2018,8,MS,1296,1313,-17
2018,8,MT,111,122,-11
2018,8,NC,2480,2487,-7
2018,8,ND,341,433,-92
2018,8,NE,86,86,0
2018,8,NH,85,89,-4
2018,8,NJ,2692,2673,19
2018,8,NM,128,132,-4
2018,8,NV,144,159,-15
2018,8,NY,2750,2565,185
2018,8,OH,374,383,-9
2018,8,OK,147,162,-15
2018,8,OR,442,476,-34
2018,8,PA,899,959,-60
2018,8,PR,76,32,44
2018,8,RI,339,349,-10
2018,8,SC,2975,2918,57
2018,8,SD,44,75,-31
2018,8,TN,469,474,-5
2018,8,TX,9833,8376,1457
2018,8,UT,82,94,-12
2018,8,VA,1433,1442,-9
2018,8,VI,15,14,1
2018,8,VT,44,50,-6
2018,8,WA,483,502,-19
2018,8,WI,140,153,-13
2018,8,WV,145,154,-9
2018,8,WY,26,27,-1
2018,9,AK,21,26,-5
2018,9,AL,447,470,-23
2018,9,AR,141,139,2
2018,9,AZ,271,281,-10
2018,9,CA,2823,2944,-121
2018,9,CO,245,254,-9
2018,9,CT,327,354,-27
2018,9,DC,21,20,1
2018,9,DE,221,220,1
2018,9,FL,21607,21920,-313
2018,9,GA,1071,1071,0
2018,9,GU,1,1,0
2018,9,HI,825,780,45
2018,9,IA,183,195,-12
2018,9,ID,139,236,-97
2018,9,IL,473,492,-19
2018,9,IN,225,242,-17
2018,9,KS,115,122,-7
2018,9,KY,192,200,-8
2018,9,LA,6418,6258,160
2018,9,MA,693,712,-19
2018,9,MD,591,600,-9
2018,9,ME,90,91,-1
2018,9,MI,164,186,-22
2018,9,MN,166,185,-19
2018,9,MO,232,230,2
2018,9,MS,808,819,-11
2018,9,MT,74,92,-18
2018,9,NC,1504,1491,13
2018,9,ND,353,403,-50
2018,9,NE,72,71,1
2018,9,NH,67,64,3
2018,9,NJ,1844,1838,6
2018,9,NM,109,116,-7
2018,9,NV,145,163,-18
2018,9,NY,2824,3174,-350
2018,9,OH,302,318,-16
2018,9,OK,150,153,-3
2018,9,OR,289,314,-25
2018,9,PA,687,736,-49
2018,9,PR,208,29,179
2018,9,RI,128,132,-4
2018,9,SC,2282,2239,43
2018,9,SD,46,53,-7
2018,9,TN,378,381,-3
2018,9,TX,7808,6472,1336
2018,9,UT,51,55,-4
2018,9,VA,1156,1160,-4
2018,9,VI,27,8,19
2018,9,VT,75,46,29
2018,9,WA,478,502,-24
2018,9,WI,127,139,-12
2018,9,WV,133,139,-6
2018,9,WY,23,37,-14
2018,10,AK,20,20,0
2018,10,AL,537,547,-10
2018,10,AR,127,130,-3
2018,10,AZ,302,305,-3
2018,10,CA,3403,5026,-1623
2018,10,CO,257,258,-1
2018,10,CT,324,332,-8
2018,10,DC,25,28,-3
2018,10,DE,253,259,-6
2018,10,FL,20889,21513,-624
2018,10,GA,1079,1094,-15
2018,10,HI,731,722,9
2018,10,IA,197,208,-11
2018,10,ID,115,205,-90
2018,10,IL,382,402,-20
2018,10,IN,302,319,-17
2018,10,KS,141,149,-8
2018,10,KY,226,229,-3
2018,10,LA,6783,6767,16
2018,10,MA,896,779,117
2018,10,MD,545,547,-2
2018,10,ME,83,83,0
2018,10,MI,200,214,-14
2018,10,MN,229,255,-26
2018,10,MO,241,256,-15
2018,10,MS,1006,1038,-32
2018,10,MT,151,146,5
2018,10,NC,1624,1593,31
2018,10,ND,449,502,-53
2018,10,NE,87,94,-7
2018,10,NH,107,107,0
2018,10,NJ,2155,2126,29
2018,10,NM,109,109,0
2018,10,NV,149,170,-21
2018,10,NY,2150,2221,-71
2018,10,OH,355,363,-8
2018,10,OK,151,151,0
2018,10,OR,302,308,-6
2018,10,PA,737,791,-54
2018,10,PR,91,26,65
2018,10,RI,93,96,-3
2018,10,SC,2997,3038,-41
2018,10,SD,65,67,-2
2018,10,TN,424,406,18
2018,10,TX,7802,6413,1389
2018,10,UT,70,89,-19
2018,10,VA,1111,1165,-54
2018,10,VI,46,37,9
2018,10,VT,51,47,4
2018,10,WA,446,467,-21
2018,10,WI,127,139,-12
2018,10,WV,147,158,-11
2018,10,WY,38,62,-24
2018,11,AK,31,26,5
2018,11,AL,560,575,-15
2018,11,AR,190,173,17
2018,11,AZ,244,241,3
2018,11,CA,3549,4838,-1289
2018,11,CO,259,276,-17
2018,11,CT,331,393,-62
2018,11,DC,26,28,-2
2018,11,DE,295,291,4
2018,11,FL,20905,21012,-107
2018,11,GA,1089,1081,8
2018,11,GU,1,1,0
2018,11,HI,819,818,1
2018,11,IA,208,218,-10
2018,11,ID,96,146,-50
2018,11,IL,484,463,21
2018,11,IN,307,282,25
2018,11,KS,138,136,2
2018,11,KY,206,221,-15
2018,11,LA,6775,6647,128
2018,11,MA,668,688,-20
2018,11,MD,1260,1259,1
2018,11,ME,93,90,3
2018,11,MI,272,249,23
2018,11,MN,260,287,-27
2018,11,MO,253,255,-2
2018,11,MS,1076,1129,-53
2018,11,MT,155,139,16
2018,11,NC,1569,1527,42
2018,11,ND,441,502,-61
2018,11,NE,71,85,-14
2018,11,NH,88,93,-5
2018,11,NJ,1817,1838,-21
2018,11,NM,112,114,-2
2018,11,NV,133,174,-41
2018,11,NY,2356,2405,-49
2018,11,OH,396,380,16
2018,11,OK,150,161,-11
2018,11,OR,307,326,-19
2018,11,PA,756,797,-41
2018,11,PR,72,24,48
2018,11,RI,142,139,3
2018,11,SC,2280,2224,56
2018,11,SD,69,78,-9
2018,11,TN,436,373,63
2018,11,TX,8646,6981,1665
2018,11,UT,64,68,-4
2018,11,VA,1595,1612,-17
2018,11,VI,30,9,21
2018,11,VT,37,45,-8
2018,11,WA,373,417,-44
2018,11,WI,168,174,-6
2018,11,WV,147,154,-7
2018,11,WY,31,52,-21
2018,12,AK,22,24,-2
2018,12,AL,875,864,11
2018,12,AR,246,205,41
2018,12,AZ,344,337,7
2018,12,CA,3178,3399,-221
2018,12,CO,302,321,-19
2018,12,CT,380,396,-16
2018,12,DC,30,29,1
2018,12,DE,283,274,9
2018,12,FL,27689,27308,381
2018,12,GA,1402,1441,-39
2018,12,HI,789,801,-12
2018,12,IA,275,288,-13
2018,12,ID,189,272,-83
2018,12,IL,597,591,6
2018,12,IN,311,300,11
2018,12,KS,143,153,-10
2018,12,KY,301,275,26
2018,12,LA,9034,8604,430
2018,12,MA,640,653,-13
2018,12,MD,802,807,-5
2018,12,ME,95,99,-4
2018,12,MI,306,277,29
2018,12,MN,300,329,-29
2018,12,MO,407,403,4
2018,12,MS,1115,1087,28
2018,12,MT,207,180,27
2018,12,NC,2250,2127,123
2018,12,ND,413,447,-34
2018,12,NE,134,142,-8
2018,12,NH,102,104,-2
2018,12,NJ,2375,2381,-6
2018,12,NM,111,118,-7
2018,12,NV,154,259,-105
2018,12,NY,2285,2320,-35
2018,12,OH,412,409,3
2018,12,OK,179,178,1
2018,12,OR,310,316,-6
2018,12,PA,869,1170,-301
2018,12,PR,249,39,210
2018,12,RI,163,176,-13
2018,12,SC,3504,3505,-1
2018,12,SD,81,88,-7
2018,12,TN,486,481,5
2018,12,TX,10656,8635,2021
2018,12,UT,65,81,-16
2018,12,VA,1769,1817,-48
2018,12,VI,16,6,10
2018,12,VT,33,39,-6
2018,12,WA,494,521,-27
2018,12,WI,193,187,6
2018,12,WV,178,182,-4
2018,12,WY,37,64,-27
2018,13,AK,32,38,-6
2018,13,AL,727,703,24
2018,13,AR,187,190,-3
2018,13,AZ,312,280,32
2018,13,CA,2277,2563,-286
2018,13,CO,294,307,-13
2018,13,CT,333,343,-10
2018,13,DC,21,21,0
2018,13,DE,248,238,10
2018,13,FL,27818,27541,277
2018,13,GA,1102,1108,-6
2018,13,HI,389,451,-62
2018,13,IA,220,253,-33
2018,13,ID,100,252,-152
2018,13,IL,526,543,-17
2018,13,IN,287,276,11
2018,13,KS,130,145,-15
2018,13,KY,248,240,8
2018,13,LA,7299,6863,436
2018,13,MA,461,460,1
2018,13,MD,787,788,-1
2018,13,ME,115,125,-10
2018,13,MI,207,198,9
2018,13,MN,393,410,-17
2018,13,MO,326,321,5
2018,13,MS,939,934,5
2018,13,MT,172,120,52
2018,13,NC,1855,1839,16
2018,13,ND,397,411,-14
2018,13,NE,126,138,-12
2018,13,NH,88,90,-2
2018,13,NJ,2392,2081,311
2018,13,NM,103,108,-5
2018,13,NV,116,189,-73
2018,13,NY,2674,2710,-36
2018,13,OH,394,398,-4
2018,13,OK,163,163,0
2018,13,OR,286,298,-12
2018,13,PA,700,698,2
2018,13,PR,304,42,262
2018,13,RI,124,124,0
2018,13,SC,2732,2794,-62
2018,13,SD,71,85,-14
2018,13,TN,389,616,-227
2018,13,TX,9357,7606,1751
2018,13,UT,74,108,-34
2018,13,VA,1072,1045,27
2018,13,VI,13,6,7
2018,13,VT,39,40,-1
2018,13,WA,371,392,-21
2018,13,WI,188,184,4
2018,13,WV,191,202,-11
2018,13,WY,52,65,-13
2018,14,AK,35,33,2
2018,14,AL,723,735,-12
2018,14,AR,175,205,-30
2018,14,AZ,245,258,-13
2018,14,CA,2302,2476,-174
2018,14,CO,279,297,-18
2018,14,CT,326,357,-31
2018,14,DC,29,26,3
2018,14,DE,266,259,7
2018,14,FL,23309,23058,251
2018,14,GA,1039,1019,20
2018,14,HI,877,876,1
2018,14,IA,217,238,-21
2018,14,ID,125,280,-155
2018,14,IL,522,534,-12
2018,14,IN,275,280,-5
2018,14,KS,137,155,-18
2018,14,KY,224,232,-8
2018,14,LA,8272,8040,232
2018,14,MA,658,666,-8
2018,14,MD,611,625,-14
2018,14,ME,112,112,0
2018,14,MI,227,221,6
2018,14,MN,234,248,-14
2018,14,MO,264,279,-15
2018,14,MS,1112,1153,-41
2018,14,MT,186,114,72
2018,14,NC,1627,1603,24
2018,14,ND,349,380,-31
2018,14,NE,86,92,-6
2018,14,NH,77,81,-4
2018,14,NJ,1913,1925,-12
2018,14,NM,107,113,-6
2018,14,NV,117,201,-84
2018,14,NY,1879,1896,-17
2018,14,OH,370,373,-3
2018,14,OK,185,184,1
2018,14,OR,271,282,-11
2018,14,PA,738,794,-56
2018,14,PR,154,21,133
2018,14,RI,161,170,-9
2018,14,SC,2258,2273,-15
2018,14,SD,72,78,-6
2018,14,TN,358,368,-10
2018,14,TX,9054,7363,1691
2018,14,UT,52,56,-4
2018,14,VA,1116,1136,-20
2018,14,VI,66,55,11
2018,14,VT,50,53,-3
2018,14,WA,381,418,-37
2018,14,WI,216,222,-6
2018,14,WV,157,166,-9
2018,14,WY,44,69,-25
2018,15,AK,26,33,-7
2018,15,AL,940,960,-20
2018,15,AR,171,183,-12
2018,15,AZ,295,270,25
2018,15,CA,2627,2750,-123
2018,15,CO,361,393,-32
2018,15,CT,338,351,-13
2018,15,DC,25,27,-2
2018,15,DE,303,299,4
2018,15,FL,27512,27541,-29
2018,15,GA,1192,1163,29
2018,15,GU,1,1,0
2018,15,HI,509,737,-228
2018,15,IA,190,195,-5
2018,15,ID,105,187,-82
2018,15,IL,432,461,-29
2018,15,IN,267,278,-11
2018,15,KS,156,162,-6
2018,15,KY,221,230,-9
2018,15,LA,8707,8598,109
2018,15,MA,596,594,2
2018,15,MD,788,789,-1
2018,15,ME,97,100,-3
2018,15,MI,210,214,-4
2018,15,MN,141,139,2
2018,15,MO,340,354,-14
2018,15,MS,1203,1232,-29
2018,15,MT,127,87,40
2018,15,NC,1979,1931,48
2018,15,ND,239,274,-35
2018,15,NE,92,97,-5
2018,15,NH,86,93,-7
2018,15,NJ,2291,2323,-32
2018,15,NM,139,137,2
2018,15,NV,124,131,-7
2018,15,NY,2436,2481,-45
2018,15,OH,376,388,-12
2018,15,OK,192,206,-14
2018,15,OR,281,290,-9
2018,15,PA,605,650,-45
2018,15,PR,77,31,46
2018,15,RI,122,130,-8
2018,15,SC,2987,2945,42
2018,15,SD,45,44,1
2018,15,TN,386,412,-26
2018,15,TX,9889,8178,1711
2018,15,UT,65,66,-1
2018,15,VA,1281,1285,-4
2018,15,VI,17,12,5
2018,15,VT,49,50,-1
2018,15,WA,422,470,-48
2018,15,WI,159,169,-10
2018,15,WV,120,132,-12
2018,15,WY,40,71,-31
2018,16,AK,40,39,1
2018,16,AL,1290,1286,4
2018,16,AR,124,127,-3
2018,16,AZ,291,285,6
2018,16,CA,2470,2587,-117
2018,16,CO,406,418,-12
2018,16,CT,327,340,-13
2018,16,DC,18,25,-7
2018,16,DE,317,319,-2
2018,16,FL,28207,28207,0
2018,16,GA,1159,1161,-2
2018,16,HI,1721,1698,23
2018,16,IA,167,175,-8
2018,16,ID,145,191,-46
2018,16,IL,452,499,-47
2018,16,IN,262,292,-30
2018,16,KS,166,176,-10
2018,16,KY,221,235,-14
2018,16,LA,9569,9424,145
2018,16,MA,575,676,-101
2018,16,MD,704,699,5
2018,16,ME,117,127,-10
2018,16,MI,227,226,1
2018,16,MN,154,166,-12
2018,16,MO,338,318,20
2018,16,MS,1147,1149,-2
2018,16,MT,124,91,33
2018,16,NC,1870,1859,11
2018,16,ND,143,168,-25
2018,16,NE,93,96,-3
2018,16,NH,65,66,-1
2018,16,NJ,2184,2206,-22
2018,16,NM,102,100,2
2018,16,NV,107,142,-35
2018,16,NY,2329,2377,-48
2018,16,OH,399,393,6
2018,16,OK,164,179,-15
2018,16,OR,264,266,-2
2018,16,PA,682,703,-21
2018,16,PR,90,45,45
2018,16,RI,126,134,-8
2018,16,SC,2658,2669,-11
2018,16,SD,55,51,4
2018,16,TN,386,410,-24
2018,16,TX,11702,9268,2434
2018,16,UT,51,56,-5
2018,16,VA,1371,1386,-15
2018,16,VI,19,10,9
2018,16,VT,42,40,2
2018,16,WA,408,425,-17
2018,16,WI,154,163,-9
2018,16,WV,151,155,-4
2018,16,WY,43,73,-30
2018,17,AK,39,40,-1
2018,17,AL,792,820,-28
2018,17,AR,182,179,3
2018,17,AZ,378,362,16
2018,17,CA,2345,2480,-135
2018,17,CO,423,469,-46
2018,17,CT,371,388,-17
2018,17,DC,35,33,2
2018,17,DE,335,338,-3
2018,17,FL,38531,38594,-63
2018,17,GA,1390,1405,-15
2018,17,GU,1,1,0
2018,17,HI,2233,2236,-3
2018,17,IA,155,162,-7
2018,17,ID,383,475,-92
2018,17,IL,541,561,-20
2018,17,IN,298,296,2
2018,17,KS,141,155,-14
2018,17,KY,218,227,-9
2018,17,LA,10655,10492,163
2018,17,MA,548,573,-25
2018,17,MD,637,701,-64
2018,17,ME,104,98,6
2018,17,MI,199,213,-14
2018,17,MN,137,141,-4
2018,17,MO,261,264,-3
2018,17,MS,1297,1320,-23
2018,17,MT,128,86,42
2018,17,NC,2364,2370,-6
2018,17,ND,127,139,-12
2018,17,NE,106,109,-3
2018,17,NH,68,67,1
2018,17,NJ,2945,2783,162
2018,17,NM,114,119,-5
2018,17,NV,98,124,-26
2018,17,NY,2756,2941,-185
2018,17,OH,376,375,1
2018,17,OK,186,190,-4
2018,17,OR,603,620,-17
2018,17,PA,765,791,-26
2018,17,PR,102,40,62
2018,17,RI,134,142,-8
2018,17,SC,3100,3103,-3
2018,17,SD,55,57,-2
2018,17,TN,362,395,-33
2018,17,TX,13910,10754,3156
2018,17,UT,139,142,-3
2018,17,VA,1487,1534,-47
2018,17,VI,13,8,5
2018,17,VT,48,48,0
2018,17,WA,441,473,-32
2018,17,WI,144,153,-9
2018,17,WV,137,143,-6
2018,17,WY,45,54,-9
2018,18,AK,27,30,-3
2018,18,AL,587,615,-28
2018,18,AR,133,155,-22
2018,18,AS,2,0,2
2018,18,AZ,262,260,2
2018,18,CA,1997,2110,-113
2018,18,CO,373,377,-4
2018,18,CT,308,327,-19
2018,18,DC,17,17,0
2018,18,DE,297,289,8
2018,18,FL,26931,25425,1506
2018,18,GA,1138,1115,23
2018,18,HI,433,434,-1
2018,18,IA,120,122,-2
2018,18,ID,101,279,-178
2018,18,IL,350,375,-25
2018,18,IN,206,202,4
2018,18,KS,119,136,-17
2018,18,KY,205,213,-8
2018,18,LA,8427,8266,161
2018,18,MA,626,642,-16
2018,18,MD,621,632,-11
2018,18,ME,77,80,-3
2018,18,MI,185,186,-1
2018,18,MN,97,98,-1
2018,18,MO,213,228,-15
2018,18,MS,1155,1190,-35
2018,18,MT,153,88,65
2018,18,NC,1716,1684,32
2018,18,ND,83,85,-2
2018,18,NE,90,97,-7
2018,18,NH,73,77,-4
2018,18,NJ,1958,1993,-35
2018,18,NM,91,98,-7
2018,18,NV,96,104,-8
2018,18,NY,2591,2630,-39
2018,18,OH,278,287,-9
2018,18,OK,189,201,-12
2018,18,OR,250,418,-168
2018,18,PA,675,733,-58
2018,18,PR,360,26,334
2018,18,RI,124,132,-8
2018,18,SC,2490,2429,61
2018,18,SD,43,46,-3
2018,18,TN,308,318,-10
2018,18,TX,11924,8375,3549
2018,18,UT,48,53,-5
2018,18,VA,1241,1233,8
2018,18,VI,26,13,13
2018,18,VT,40,40,0
2018,18,WA,352,364,-12
2018,18,WI,129,130,-1
2018,18,WV,137,139,-2
2018,18,WY,38,45,-7
2018,19,AK,36,34,2
2018,19,AL,878,892,-14
2018,19,AR,124,138,-14
2018,19,AS,3,0,3
2018,19,AZ,326,283,43
2018,19,CA,1996,2047,-51
2018,19,CO,347,372,-25
2018,19,CT,356,370,-14
2018,19,DC,17,15,2
2018,19,DE,339,336,3
2018,19,FL,27496,27026,470
2018,19,GA,1365,1319,46
2018,19,HI,823,786,37
2018,19,IA,144,143,1
2018,19,ID,103,221,-118
2018,19,IL,536,554,-18
2018,19,IN,234,251,-17
2018,19,KS,121,129,-8
2018,19,KY,212,238,-26
2018,19,LA,8948,8732,216
2018,19,MA,537,559,-22
2018,19,MD,674,688,-14
2018,19,ME,80,77,3
2018,19,MI,224,209,15
2018,19,MN,119,121,-2
2018,19,MO,222,236,-14
2018,19,MS,1215,1200,15
2018,19,MT,122,89,33
2018,19,NC,2171,2143,28
2018,19,ND,81,87,-6
2018,19,NE,65,73,-8
2018,19,NH,66,70,-4
2018,19,NJ,2535,2550,-15
2018,19,NM,96,93,3
2018,19,NV,112,195,-83
2018,19,NY,2411,2501,-90
2018,19,OH,305,313,-8
2018,19,OK,178,194,-16
2018,19,OR,268,285,-17
2018,19,PA,628,705,-77
2018,19,PR,86,34,52
2018,19,RI,134,134,0
2018,19,SC,3304,3282,22
2018,19,SD,49,48,1
2018,19,TN,348,356,-8
2018,19,TX,13627,10930,2697
2018,19,UT,64,64,0
2018,19,VA,1423,1405,18
2018,19,VI,19,9,10
2018,19,VT,40,41,-1
2018,19,WA,387,399,-12
2018,19,WI,109,120,-11
2018,19,WV,128,133,-5
2018,19,WY,33,37,-4
2018,20,AK,37,38,-1
2018,20,AL,942,935,7
2018,20,AR,160,185,-25
2018,20,AS,4,0,4
2018,20,AZ,338,328,10
2018,20,CA,1992,1983,9
2018,20,CO,435,459,-24
2018,20,CT,374,395,-21
2018,20,DC,24,22,2
2018,20,DE,336,344,-8
2018,20,FL,28790,28040,750
2018,20,GA,1340,1311,29
2018,20,HI,873,852,21
2018,20,IA,212,234,-22
2018,20,ID,96,176,-80
2018,20,IL,400,424,-24
2018,20,IN,201,216,-15
2018,20,KS,137,142,-5
2018,20,KY,238,239,-1
2018,20,LA,9823,9692,131
2018,20,MA,557,577,-20
2018,20,MD,682,704,-22
2018,20,ME,80,79,1
2018,20,MI,178,171,7
2018,20,MN,95,103,-8
2018,20,MO,244,268,-24
2018,20,MS,1179,1207,-28
2018,20,MT,129,92,37
2018,20,NC,2342,2303,39
2018,20,ND,74,85,-11
2018,20,NE,81,93,-12
2018,20,NH,59,67,-8
2018,20,NJ,2477,2532,-55
2018,20,NM,124,133,-9
2018,20,NV,192,266,-74
2018,20,NY,2748,2863,-115
2018,20,OH,299,301,-2
2018,20,OK,168,180,-12
2018,20,OR,268,286,-18
2018,20,PA,826,859,-33
2018,20,PR,107,37,70
2018,20,RI,145,149,-4
2018,20,SC,3230,3169,61
2018,20,SD,46,45,1
2018,20,TN,385,401,-16
2018,20,TX,15978,13649,2329
2018,20,UT,50,53,-3
2018,20,VA,1387,1373,14
2018,20,VI,19,8,11
2018,20,VT,29,29,0
2018,20,WA,355,373,-18
2018,20,WI,162,162,0
2018,20,WV,113,116,-3
2018,20,WY,28,38,-10
2018,21,AK,38,34,4
2018,21,AL,835,854,-19
2018,21,AR,216,264,-48
2018,21,AS,2,0,2
2018,21,AZ,341,335,6
2018,21,CA,2201,2252,-51
2018,21,CO,333,353,-20
2018,21,CT,409,431,-22
2018,21,DC,27,36,-9
2018,21,DE,552,562,-10
2018,21,FL,40496,39189,1307
2018,21,GA,1674,1643,31
2018,21,HI,1156,1146,10
2018,21,IA,172,179,-7
2018,21,ID,76,127,-51
2018,21,IL,479,504,-25
2018,21,IN,246,273,-27
2018,21,KS,147,163,-16
2018,21,KY,228,239,-11
2018,21,LA,11976,11949,27
2018,21,MA,733,769,-36
2018,21,MD,823,835,-12
2018,21,ME,99,115,-16
2018,21,MI,175,189,-14
2018,21,MN,128,130,-2
2018,21,MO,285,295,-10
2018,21,MS,1645,1675,-30
2018,21,MT,116,97,19
2018,21,NC,2469,2441,28
2018,21,ND,87,103,-16
2018,21,NE,135,134,1
2018,21,NH,111,115,-4
2018,21,NJ,3326,3292,34
2018,21,NM,95,97,-2
2018,21,NV,94,162,-68
2018,21,NY,2768,2855,-87
2018,21,OH,359,375,-16
2018,21,OK,195,215,-20
2018,21,OR,441,454,-13
2018,21,PA,709,744,-35
2018,21,PR,76,38,38
2018,21,RI,164,164,0
2018,21,SC,4319,4286,33
2018,21,SD,59,71,-12
2018,21,TN,539,582,-43
2018,21,TX,19541,15795,3746
2018,21,UN,1,1,0
2018,21,UT,74,78,-4
2018,21,VA,2296,2262,34
2018,21,VI,19,11,8
2018,21,VT,28,29,-1
2018,21,WA,476,511,-35
2018,21,WI,153,155,-2
2018,21,WV,150,162,-12
2018,21,WY,41,48,-7
2018,22,AK,21,19,2
2018,22,AL,1059,1076,-17
2018,22,AR,228,260,-32
2018,22,AS,7,2,5
2018,22,AZ,296,299,-3
2018,22,CA,1956,1956,0
2018,22,CO,381,399,-18
2018,22,CT,292,302,-10
2018,22,DC,259,262,-3
2018,22,DE,360,366,-6
2018,22,FL,28101,27403,698
2018,22,GA,1579,1526,53
2018,22,HI,426,427,-1
2018,22,IA,155,161,-6
2018,22,ID,363,414,-51
2018,22,IL,340,363,-23
2018,22,IN,222,247,-25
2018,22,KS,125,130,-5
2018,22,KY,218,243,-25
2018,22,LA,10374,10217,157
2018,22,MA,578,613,-35
2018,22,MD,626,631,-5
2018,22,ME,76,78,-2
2018,22,MI,156,154,2
2018,22,MN,92,100,-8
2018,22,MO,246,266,-20
2018,22,MS,1374,1418,-44
2018,22,MT,81,67,14
2018,22,NC,2306,2282,24
2018,22,ND,89,99,-10
2018,22,NE,75,82,-7
2018,22,NH,63,60,3
2018,22,NJ,2289,2328,-39
2018,22,NM,91,97,-6
2018,22,NV,107,157,-50
2018,22,NY,2280,2355,-75
2018,22,OH,309,341,-32
2018,22,OK,234,241,-7
2018,22,OR,253,249,4
2018,22,PA,630,663,-33
2018,22,PR,101,43,58
2018,22,RI,131,141,-10
2018,22,SC,3419,3345,74
2018,22,SD,71,71,0
2018,22,TN,607,657,-50
2018,22,TX,16290,12400,3890
2018,22,UT,67,64,3
2018,22,VA,1502,1465,37
2018,22,VI,16,6,10
2018,22,VT,29,30,-1
2018,22,WA,301,301,0
2018,22,WI,125,124,1
2018,22,WV,106,115,-9
2018,22,WY,30,37,-7
2018,23,AK,25,27,-2
2018,23,AL,812,839,-27
2018,23,AR,196,213,-17
2018,23,AS,6,0,6
2018,23,AZ,325,338,-13
2018,23,CA,2116,2160,-44
2018,23,CO,388,390,-2
2018,23,CT,389,403,-14
2018,23,DC,16,18,-2
2018,23,DE,327,329,-2
2018,23,FL,32806,31283,1523
2018,23,GA,1482,1398,84
2018,23,HI,1028,1018,10
2018,23,IA,137,139,-2
2018,23,ID,66,92,-26
2018,23,IL,561,590,-29
2018,23,IN,251,266,-15
2018,23,KS,152,168,-16
2018,23,KY,249,259,-10
2018,23,LA,11095,10928,167
2018,23,MA,725,756,-31
2018,23,MD,741,710,31
2018,23,ME,73,79,-6
2018,23,MI,202,195,7
2018,23,MN,107,117,-10
2018,23,MO,265,279,-14
2018,23,MS,1437,1448,-11
2018,23,MT,99,87,12
2018,23,NC,2160,2140,20
2018,23,ND,119,132,-13
2018,23,NE,109,115,-6
2018,23,NH,79,78,1
2018,23,NJ,2195,2248,-53
2018,23,NM,119,117,2
2018,23,NV,104,132,-28
2018,23,NY,2556,2648,-92
2018,23,OH,354,375,-21
2018,23,OK,205,222,-17
2018,23,OR,285,294,-9
2018,23,PA,658,686,-28
2018,23,PR,80,29,51
2018,23,RI,167,173,-6
2018,23,SC,3630,3501,129
2018,23,SD,41,43,-2
2018,23,TN,586,620,-34
2018,23,TX,18417,14721,3696
2018,23,UT,44,44,0
2018,23,VA,1712,1960,-248
2018,23,VI,27,21,6
2018,23,VT,32,31,1
2018,23,WA,315,341,-26
2018,23,WI,188,188,0
2018,23,WV,132,133,-1
2018,23,WY,36,40,-4
2018,24,AK,26,28,-2
2018,24,AL,899,899,0
2018,24,AR,170,170,0
2018,24,AS,2,0,2
2018,24,AZ,308,410,-102
2018,24,CA,1951,2008,-57
2018,24,CO,483,500,-17
2018,24,CT,377,394,-17
2018,24,DC,46,48,-2
2018,24,DE,323,319,4
2018,24,FL,33017,30561,2456
2018,24,GA,1594,1546,48
2018,24,HI,311,286,25
2018,24,IA,136,137,-1
2018,24,ID,67,101,-34
2018,24,IL,395,404,-9
2018,24,IN,247,255,-8
2018,24,KS,133,149,-16
2018,24,KY,234,239,-5
2018,24,LA,11240,10634,606
2018,24,MA,603,620,-17
2018,24,MD,880,876,4
2018,24,ME,88,94,-6
2018,24,MI,193,198,-5
2018,24,MN,94,108,-14
2018,24,MO,235,246,-11
2018,24,MS,1411,1402,9
2018,24,MT,69,72,-3
2018,24,NC,2894,2819,75
2018,24,ND,99,103,-4
2018,24,NE,99,95,4
2018,24,NH,82,85,-3
2018,24,NJ,3167,3241,-74
2018,24,NM,112,118,-6
2018,24,NV,87,87,0
2018,24,NY,2694,2889,-195
2018,24,OH,374,391,-17
2018,24,OK,202,214,-12
2018,24,OR,328,341,-13
2018,24,PA,654,693,-39
2018,24,PR,88,34,54
2018,24,RI,175,182,-7
2018,24,SC,3876,3712,164
2018,24,SD,38,46,-8
2018,24,TN,521,528,-7
2018,24,TX,20421,15677,4744
2018,24,UT,41,42,-1
2018,24,VA,1919,1804,115
2018,24,VI,108,99,9
2018,24,VT,23,24,-1
2018,24,WA,356,375,-19
2018,24,WI,99,107,-8
2018,24,WV,124,135,-11
2018,24,WY,30,32,-2
2018,25,AK,29,26,3
2018,25,AL,885,852,33
2018,25,AR,191,205,-14
2018,25,AS,2,0,2
2018,25,AZ,394,386,8
2018,25,CA,1947,1977,-30
2018,25,CO,308,324,-16
2018,25,CT,437,459,-22
2018,25,DC,29,25,4
2018,25,DE,406,409,-3
2018,25,FL,42112,39410,2702
2018,25,GA,1994,1866,128
2018,25,HI,1765,1739,26
2018,25,IA,195,200,-5
2018,25,ID,71,70,1
2018,25,IL,491,510,-19
2018,25,IN,271,284,-13
2018,25,KS,143,162,-19
2018,25,KY,172,179,-7
2018,25,LA,13850,13408,442
2018,25,MA,912,926,-14
2018,25,MD,1221,1177,44
2018,25,ME,103,116,-13
2018,25,MI,234,250,-16
2018,25,MN,107,113,-6
2018,25,MO,269,267,2
2018,25,MS,1459,1462,-3
2018,25,MT,158,167,-9
2018,25,NC,3099,2987,112
2018,25,ND,193,200,-7
2018,25,NE,141,151,-10
2018,25,NH,85,92,-7
2018,25,NJ,3239,3300,-61
2018,25,NM,117,123,-6
2018,25,NV,114,118,-4
2018,25,NY,3261,3325,-64
2018,25,OH,408,430,-22
2018,25,OK,195,228,-33
2018,25,OR,220,236,-16
2018,25,PA,700,745,-45
2018,25,PR,90,51,39
2018,25,RI,178,186,-8
2018,25,SC,4810,4640,170
2018,25,SD,81,85,-4
2018,25,TN,491,504,-13
2018,25,TX,26865,22105,4760
2018,25,UT,44,48,-4
2018,25,VA,2368,2296,72
2018,25,VI,15,9,6
2018,25,VT,47,49,-2
2018,25,WA,348,351,-3
2018,25,WI,120,127,-7
2018,25,WV,122,125,-3
2018,25,WY,16,17,-1
2018,26,AK,21,20,1
2018,26,AL,1060,1059,1
2018,26,AR,181,195,-14
2018,26,AZ,366,364,2
2018,26,CA,1883,1888,-5
2018,26,CO,322,314,8
2018,26,CT,480,498,-18
2018,26,DC,56,46,10
2018,26,DE,557,561,-4
2018,26,FL,38995,36702,2293
2018,26,GA,1955,1922,33
2018,26,HI,684,656,28
2018,26,IA,248,267,-19
2018,26,ID,63,68,-5
2018,26,IL,1014,377,637
2018,26,IN,256,280,-24
2018,26,KS,145,148,-3
2018,26,KY,182,200,-18
2018,26,LA,12638,12376,262
2018,26,MA,644,671,-27
2018,26,MD,1350,1276,74
2018,26,ME,119,115,4
2018,26,MI,166,169,-3
2018,26,MN,83,94,-11
2018,26,MO,240,249,-9
2018,26,MS,1433,1466,-33
2018,26,MT,60,64,-4
2018,26,NC,2558,2489,69
2018,26,ND,111,114,-3
2018,26,NE,138,138,0
2018,26,NH,77,83,-6
2018,26,NJ,2158,2247,-89
2018,26,NM,120,128,-8
2018,26,NV,100,113,-13
2018,26,NY,2626,2586,40
2018,26,OH,373,380,-7
2018,26,OK,193,217,-24
2018,26,OR,260,279,-19
2018,26,PA,665,686,-21
2018,26,PR,76,36,40
2018,26,RI,185,193,-8
2018,26,SC,4751,4656,95
2018,26,SD,69,81,-12
2018,26,TN,390,388,2
2018,26,TX,29908,25138,4770
2018,26,UT,42,52,-10
2018,26,VA,2466,2323,143
2018,26,VI,8,7,1
2018,26,VT,25,26,-1
2018,26,WA,294,319,-25
2018,26,WI,127,132,-5
2018,26,WV,152,149,3
2018,26,WY,25,27,-2
2018,27,AK,24,24,0
2018,27,AL,776,785,-9
2018,27,AR,148,160,-12
2018,27,AS,2,0,2
2018,27,AZ,416,408,8
2018,27,CA,2082,2128,-46
2018,27,CO,295,292,3
2018,27,CT,399,419,-20
2018,27,DC,36,31,5
2018,27,DE,318,307,11
2018,27,FL,32510,30743,1767
2018,27,GA,1783,1709,74
2018,27,HI,391,375,16
2018,27,IA,178,189,-11
2018,27,ID,37,37,0
2018,27,IL,405,415,-10
2018,27,IN,324,318,6
2018,27,KS,134,137,-3
2018,27,KY,213,218,-5
2018,27,LA,11369,11055,314
2018,27,MA,574,628,-54
2018,27,MD,915,894,21
2018,27,ME,93,92,1
2018,27,MI,218,218,0
2018,27,MN,104,102,2
2018,27,MO,207,229,-22
2018,27,MS,1310,1305,5
2018,27,MT,56,60,-4
2018,27,NC,2322,2276,46
2018,27,ND,67,67,0
2018,27,NE,97,100,-3
2018,27,NH,70,71,-1
2018,27,NJ,3316,3354,-38
2018,27,NM,137,143,-6
2018,27,NV,86,98,-12
2018,27,NY,2548,2662,-114
2018,27,OH,342,346,-4
2018,27,OK,196,198,-2
2018,27,OR,255,344,-89
2018,27,PA,618,645,-27
2018,27,PR,100,54,46
2018,27,RI,182,195,-13
2018,27,SC,3747,3664,83
2018,27,SD,27,31,-4
2018,27,TN,408,413,-5
2018,27,TX,24985,19727,5258
2018,27,UT,42,41,1
2018,27,VA,1933,1872,61
2018,27,VI,13,10,3
2018,27,VT,38,36,2
2018,27,WA,323,338,-15
2018,27,WI,129,137,-8
2018,27,WV,116,125,-9
2018,27,WY,24,30,-6
2018,28,AK,27,26,1
2018,28,AL,753,772,-19
2018,28,AR,158,174,-16
2018,28,AZ,402,407,-5
2018,28,CA,2069,2110,-41
2018,28,CO,331,303,28
2018,28,CT,447,451,-4
2018,28,DC,31,27,4
2018,28,DE,323,321,2
2018,28,FL,32238,31252,986
2018,28,GA,1858,1835,23
2018,28,HI,841,572,269
2018,28,IA,202,202,0
2018,28,ID,54,57,-3
2018,28,IL,413,433,-20
2018,28,IN,321,335,-14
2018,28,KS,159,158,1
2018,28,KY,205,221,-16
2018,28,LA,11750,11950,-200
2018,28,MA,772,784,-12
2018,28,MD,1292,1281,11
2018,28,ME,101,112,-11
2018,28,MI,244,241,3
2018,28,MN,124,137,-13
2018,28,MO,255,275,-20
2018,28,MS,1265,1276,-11
2018,28,MT,99,95,4
2018,28,NC,2870,2849,21
2018,28,ND,84,86,-2
2018,28,NE,95,94,1
2018,28,NH,127,130,-3
2018,28,NJ,3144,3211,-67
2018,28,NM,117,123,-6
2018,28,NV,98,99,-1
2018,28,NY,2681,2736,-55
2018,28,OH,404,433,-29
2018,28,OK,204,213,-9
2018,28,OR,271,281,-10
2018,28,PA,687,710,-23
2018,28,PR,69,42,27
2018,28,RI,178,186,-8
2018,28,SC,3779,3714,65
2018,28,SD,39,41,-2
2018,28,TN,401,421,-20
2018,28,TX,25425,21193,4232
2018,28,UT,58,60,-2
2018,28,VA,2074,2049,25
2018,28,VI,12,7,5
2018,28,VT,45,51,-6
2018,28,WA,376,393,-17
2018,28,WI,168,159,9
2018,28,WV,132,141,-9
2018,28,WY,26,28,-2
2018,29,AK,35,35,0
2018,29,AL,810,814,-4
2018,29,AR,175,198,-23
2018,29,AS,1,1,0
2018,29,AZ,379,386,-7
2018,29,CA,2117,2111,6
2018,29,CO,322,302,20
2018,29,CT,456,465,-9
2018,29,DC,95,94,1
2018,29,DE,384,379,5
2018,29,FL,32621,32152,469
2018,29,GA,1776,1795,-19
2018,29,HI,411,391,20
2018,29,IA,209,205,4
2018,29,ID,55,59,-4
2018,29,IL,569,586,-17
2018,29,IN,338,357,-19
2018,29,KS,145,148,-3
2018,29,KY,245,248,-3
2018,29,LA,10738,10697,41
2018,29,MA,753,780,-27
2018,29,MD,1044,1039,5
2018,29,ME,125,122,3
2018,29,MI,191,183,8
2018,29,MN,154,153,1
2018,29,MO,235,240,-5
2018,29,MS,1103,1112,-9
2018,29,MT,45,50,-5
2018,29,NC,2554,2502,52
2018,29,ND,99,108,-9
2018,29,NE,89,98,-9
2018,29,NH,88,91,-3
2018,29,NJ,2677,2683,-6
2018,29,NM,125,127,-2
2018,29,NV,113,113,0
2018,29,NY,2869,2996,-127
2018,29,OH,428,441,-13
2018,29,OK,203,223,-20
2018,29,OR,243,262,-19
2018,29,PA,706,710,-4
2018,29,PR,79,42,37
2018,29,RI,199,206,-7
2018,29,SC,3639,3464,175
2018,29,SD,47,45,2
2018,29,TN,374,370,4
2018,29,TX,21634,18039,3595
2018,29,UT,41,37,4
2018,29,VA,2253,2193,60
2018,29,VI,11,7,4
2018,29,VT,41,50,-9
2018,29,WA,305,339,-34
2018,29,WI,163,159,4
2018,29,WV,138,143,-5
2018,29,WY,16,19,-3
2018,30,AK,29,32,-3
2018,30,AL,1130,1131,-1
2018,30,AR,199,208,-9
2018,30,AS,2,0,2
2018,30,AZ,408,422,-14
2018,30,CA,2095,2078,17
2018,30,CO,279,284,-5
2018,30,CT,438,462,-24
2018,30,DC,34,40,-6
2018,30,DE,343,328,15
2018,30,FL,30684,30474,210
2018,30,GA,2149,2154,-5
2018,30,HI,763,747,16
2018,30,IA,187,173,14
2018,30,ID,53,56,-3
2018,30,IL,480,492,-12
2018,30,IN,266,283,-17
2018,30,KS,143,150,-7
2018,30,KY,217,229,-12
2018,30,LA,10260,10203,57
2018,30,MA,796,819,-23
2018,30,MD,999,1018,-19
2018,30,ME,103,105,-2
2018,30,MI,181,183,-2
2018,30,MN,102,113,-11
2018,30,MO,260,273,-13
2018,30,MS,1189,1218,-29
2018,30,MT,43,47,-4
2018,30,NC,2511,2510,1
2018,30,ND,78,82,-4
2018,30,NE,87,93,-6
2018,30,NH,71,73,-2
2018,30,NJ,2958,3027,-69
2018,30,NM,185,190,-5
2018,30,NV,115,113,2
2018,30,NY,2467,2553,-86
2018,30,OH,352,381,-29
2018,30,OK,184,195,-11
2018,30,OR,223,229,-6
2018,30,PA,733,760,-27
2018,30,PR,61,39,22
2018,30,RI,219,239,-20
2018,30,SC,4075,4010,65
2018,30,SD,32,33,-1
2018,30,TN,427,436,-9
2018,30,TX,18442,16444,1998
2018,30,UT,59,59,0
2018,30,VA,2153,2273,-120
2018,30,VI,16,18,-2
2018,30,VT,35,33,2
2018,30,WA,334,355,-21
2018,30,WI,152,155,-3
2018,30,WV,137,139,-2
2018,30,WY,18,21,-3
2018,31,AK,26,30,-4
2018,31,AL,737,732,5
2018,31,AR,158,172,-14
2018,31,AS,1,1,0
2018,31,AZ,467,469,-2
2018,31,CA,2109,2119,-10
2018,31,CO,380,339,41
2018,31,CT,499,518,-19
2018,31,DC,33,32,1
2018,31,DE,367,361,6
2018,31,FL,29021,28178,843
2018,31,GA,1842,1845,-3
2018,31,HI,1191,1181,10
2018,31,IA,169,144,25
2018,31,ID,49,61,-12
2018,31,IL,345,382,-37
2018,31,IN,304,313,-9
2018,31,KS,120,128,-8
2018,31,KY,210,215,-5
2018,31,LA,9582,9492,90
2018,31,MA,740,759,-19
2018,31,MD,780,791,-11
2018,31,ME,97,99,-2
2018,31,MI,187,191,-4
2018,31,MN,97,98,-1
2018,31,MO,206,436,-230
2018,31,MS,1144,1140,4
2018,31,MT,37,37,0
2018,31,NC,2632,2556,76
2018,31,ND,74,85,-11
2018,31,NE,78,82,-4
2018,31,NH,73,72,1
2018,31,NJ,2377,2462,-85
2018,31,NM,143,143,0
2018,31,NV,139,144,-5
2018,31,NY,2777,2850,-73
2018,31,OH,386,412,-26
2018,31,OK,209,221,-12
2018,31,OR,241,252,-11
2018,31,PA,698,729,-31
2018,31,PR,149,38,111
2018,31,RI,213,216,-3
2018,31,SC,3892,3927,-35
2018,31,SD,46,42,4
2018,31,TN,412,428,-16
2018,31,TX,18318,15520,2798
2018,31,UT,50,49,1
2018,31,VA,2109,2088,21
2018,31,VI,9,14,-5
2018,31,VT,41,45,-4
2018,31,WA,321,320,1
2018,31,WI,140,150,-10
2018,31,WV,145,154,-9
2018,31,WY,29,28,1
2018,32,AK,30,30,0
2018,32,AL,839,847,-8
2018,32,AR,165,173,-8
2018,32,AZ,464,482,-18
2018,32,CA,1974,1996,-22
2018,32,CO,343,343,0
2018,32,CT,486,512,-26
2018,32,DC,37,35,2
2018,32,DE,379,367,12
2018,32,FL,28906,28736,170
2018,32,GA,5779,5749,30
2018,32,HI,1113,1089,24
2018,32,IA,167,154,13
2018,32,ID,68,74,-6
2018,32,IL,374,418,-44
2018,32,IN,263,286,-23
2018,32,KS,110,113,-3
2018,32,KY,236,241,-5
2018,32,LA,9334,9288,46
2018,32,MA,715,738,-23
2018,32,MD,875,845,30
2018,32,ME,139,114,25
2018,32,MI,211,211,0
2018,32,MN,112,115,-3
2018,32,MO,213,230,-17
2018,32,MS,1041,1167,-126
2018,32,MT,58,59,-1
2018,32,NC,2760,2645,115
2018,32,ND,101,108,-7
2018,32,NE,74,75,-1
2018,32,NH,66,64,2
2018,32,NJ,3408,3467,-59
2018,32,NM,171,180,-9
2018,32,NV,120,137,-17
2018,32,NY,2677,2756,-79
2018,32,OH,394,420,-26
2018,32,OK,169,179,-10
2018,32,OR,267,272,-5
2018,32,PA,1046,1078,-32
2018,32,PR,70,37,33
2018,32,RI,449,465,-16
2018,32,SC,3958,3834,124
2018,32,SD,36,39,-3
2018,32,TN,400,432,-32
2018,32,TX,15885,14262,1623
2018,32,UT,54,45,9
2018,32,VA,1918,1902,16
2018,32,VI,18,19,-1
2018,32,VT,35,35,0
2018,32,WA,387,397,-10
2018,32,WI,138,153,-15
2018,32,WV,166,180,-14
2018,32,WY,15,17,-2
2018,33,AK,25,29,-4
2018,33,AL,967,967,0
2018,33,AR,178,198,-20
2018,33,AZ,452,474,-22
2018,33,CA,2123,2121,2
2018,33,CO,425,347,78
2018,33,CT,600,609,-9
2018,33,DC,24,21,3
2018,33,DE,357,352,5
2018,33,FL,27987,27558,429
2018,33,GA,1625,1652,-27
2018,33,HI,2466,2458,8
2018,33,IA,182,168,14
2018,33,ID,45,45,0
2018,33,IL,572,611,-39
2018,33,IN,264,287,-23
2018,33,KS,113,116,-3
2018,33,KY,217,227,-10
2018,33,LA,9594,9506,88
2018,33,MA,1061,1078,-17
2018,33,MD,949,865,84
2018,33,ME,124,122,2
2018,33,MI,189,178,11
2018,33,MN,98,108,-10
2018,33,MO,216,234,-18
2018,33,MS,1125,1135,-10
2018,33,MT,56,60,-4
2018,33,NC,2661,2555,106
2018,33,ND,125,142,-17
2018,33,NE,88,88,0
2018,33,NH,79,82,-3
2018,33,NJ,2748,2805,-57
2018,33,NM,168,144,24
2018,33,NV,157,161,-4
2018,33,NY,3116,3172,-56
2018,33,OH,395,414,-19
2018,33,OK,153,159,-6
2018,33,OR,339,346,-7
2018,33,PA,738,739,-1
2018,33,PR,68,42,26
2018,33,RI,256,259,-3
2018,33,SC,4090,3960,130
2018,33,SD,58,61,-3
2018,33,TN,471,495,-24
2018,33,TX,15124,13683,1441
2018,33,UT,49,47,2
2018,33,VA,2097,2016,81
2018,33,VI,22,21,1
2018,33,VT,37,39,-2
2018,33,WA,345,373,-28
2018,33,WI,183,187,-4
2018,33,WV,150,163,-13
2018,33,WY,39,42,-3
2018,34,AK,41,43,-2
2018,34,AL,879,872,7
2018,34,AR,170,188,-18
2018,34,AZ,454,486,-32
2018,34,CA,2493,2503,-10
2018,34,CO,415,374,41
2018,34,CT,608,640,-32
2018,34,DC,117,114,3
2018,34,DE,595,587,8
2018,34,FL,31997,32256,-259
2018,34,GA,2058,2105,-47
2018,34,GU,1,0,1
2018,34,HI,3631,3498,133
2018,34,IA,156,157,-1
2018,34,ID,43,49,-6
2018,34,IL,451,458,-7
2018,34,IN,270,285,-15
2018,34,KS,132,141,-9
2018,34,KY,258,271,-13
2018,34,LA,11806,11658,148
2018,34,MA,1146,1141,5
2018,34,MD,1059,1045,14
2018,34,ME,111,117,-6
2018,34,MI,218,201,17
2018,34,MN,118,131,-13
2018,34,MO,255,268,-13
2018,34,MS,1227,1231,-4
2018,34,MT,49,54,-5
2018,34,NC,7855,7702,153
2018,34,ND,148,158,-10
2018,34,NE,91,80,11
2018,34,NH,133,125,8
2018,34,NJ,4060,4125,-65
2018,34,NM,194,177,17
2018,34,NV,138,150,-12
2018,34,NY,3416,3496,-80
2018,34,OH,441,483,-42
2018,34,OK,196,214,-18
2018,34,OR,351,355,-4
2018,34,PA,867,874,-7
2018,34,PR,71,54,17
2018,34,RI,317,336,-19
2018,34,SC,4591,4388,203
2018,34,SD,73,76,-3
2018,34,TN,464,473,-9
2018,34,TX,16355,14613,1742
2018,34,UT,63,64,-1
2018,34,VA,2745,2698,47
2018,34,VI,11,9,2
2018,34,VT,43,45,-2
2018,34,WA,399,416,-17
2018,34,WI,174,192,-18
2018,34,WV,195,199,-4
2018,34,WY,19,20,-1
2018,35,AK,26,29,-3
2018,35,AL,772,791,-19
2018,35,AR,138,140,-2
2018,35,AZ,380,389,-9
2018,35,CA,2106,2109,-3
2018,35,CO,310,277,33
2018,35,CT,487,500,-13
2018,35,DC,39,33,6
2018,35,DE,490,488,2
2018,35,FL,23822,23784,38
2018,35,GA,1591,1578,13
2018,35,HI,340,316,24
2018,35,IA,151,139,12
2018,35,ID,53,59,-6
2018,35,IL,326,317,9
2018,35,IN,211,211,0
2018,35,KS,127,130,-3
2018,35,KY,169,162,7
2018,35,LA,7845,7742,103
2018,35,MA,622,626,-4
2018,35,MD,844,834,10
2018,35,ME,96,96,0
2018,35,MI,166,157,9
2018,35,MN,75,83,-8
2018,35,MO,185,182,3
2018,35,MS,895,913,-18
2018,35,MT,43,47,-4
2018,35,NC,2320,2216,104
2018,35,ND,158,166,-8
2018,35,NE,69,73,-4
2018,35,NH,76,76,0
2018,35,NJ,2573,2635,-62
2018,35,NM,152,148,4
2018,35,NV,115,117,-2
2018,35,NY,2702,2743,-41
2018,35,OH,362,370,-8
2018,35,OK,156,163,-7
2018,35,OR,421,437,-16
2018,35,PA,692,697,-5
2018,35,PR,55,42,13
2018,35,RI,191,212,-21
2018,35,SC,3008,2855,153
2018,35,SD,36,39,-3
2018,35,TN,335,335,0
2018,35,TX,12942,11553,1389
2018,35,UT,68,65,3
2018,35,VA,1886,1810,76
2018,35,VI,12,11,1
2018,35,VT,48,52,-4
2018,35,WA,322,307,15
2018,35,WI,135,131,4
2018,35,WV,149,163,-14
2018,35,WY,17,22,-5
2018,36,AK,29,32,-3
2018,36,AL,1232,1247,-15
2018,36,AR,168,174,-6
2018,36,AZ,444,450,-6
2018,36,CA,2370,2379,-9
2018,36,CO,405,345,60
2018,36,CT,495,505,-10
2018,36,DC,37,41,-4
2018,36,DE,425,413,12
2018,36,FL,24499,24564,-65
2018,36,GA,1516,1519,-3
2018,36,HI,1901,1929,-28
2018,36,IA,147,142,5
2018,36,ID,45,46,-1
2018,36,IL,346,359,-13
2018,36,IN,223,225,-2
2018,36,KS,116,130,-14
2018,36,KY,245,256,-11
2018,36,LA,10375,10556,-181
2018,36,MA,949,980,-31
2018,36,MD,969,938,31
2018,36,ME,135,144,-9
2018,36,MI,207,222,-15
2018,36,MN,109,110,-1
2018,36,MO,217,230,-13
2018,36,MS,982,1019,-37
2018,36,MT,63,67,-4
2018,36,NC,2634,2449,185
2018,36,ND,192,213,-21
2018,36,NE,75,73,2
2018,36,NH,121,119,2
2018,36,NJ,2930,2897,33
2018,36,NM,147,144,3
2018,36,NV,113,116,-3
2018,36,NY,3355,3370,-15
2018,36,OH,361,397,-36
2018,36,OK,172,170,2
2018,36,OR,287,310,-23
2018,36,PA,818,740,78
2018,36,PR,81,43,38
2018,36,RI,283,300,-17
2018,36,SC,3625,3484,141
2018,36,SD,34,34,0
2018,36,TN,382,390,-8
2018,36,TX,13473,12363,1110
2018,36,UT,60,56,4
2018,36,VA,2036,1980,56
2018,36,VI,21,23,-2
2018,36,VT,38,41,-3
2018,36,WA,357,368,-11
2018,36,WI,155,157,-2
2018,36,WV,170,176,-6
2018,36,WY,18,16,2
2018,37,AK,44,45,-1
2018,37,AL,739,732,7
2018,37,AR,174,191,-17
2018,37,AZ,498,523,-25
2018,37,CA,2422,2479,-57
2018,37,CO,293,283,10
2018,37,CT,617,625,-8
2018,37,DC,51,48,3
2018,37,DE,366,361,5
2018,37,FL,25626,26026,-400
2018,37,GA,1726,1728,-2
2018,37,HI,709,656,53
2018,37,IA,139,130,9
2018,37,ID,66,77,-11
2018,37,IL,360,376,-16
2018,37,IN,251,267,-16
2018,37,KS,122,133,-11
2018,37,KY,195,199,-4
2018,37,LA,13363,14041,-678
2018,37,MA,1016,1064,-48
2018,37,MD,877,857,20
2018,37,ME,90,95,-5
2018,37,MI,278,278,0
2018,37,MN,94,98,-4
2018,37,MO,249,265,-16
2018,37,MS,1098,1137,-39
2018,37,MT,57,62,-5
2018,37,NC,2447,2370,77
2018,37,ND,143,148,-5
2018,37,NE,73,76,-3
2018,37,NH,96,94,2
2018,37,NJ,3640,3610,30
2018,37,NM,144,147,-3
2018,37,NV,126,134,-8
2018,37,NY,3053,3095,-42
2018,37,OH,357,370,-13
2018,37,OK,189,184,5
2018,37,OR,246,255,-9
2018,37,PA,805,793,12
2018,37,PR,70,54,16
2018,37,RI,200,204,-4
2018,37,SC,3790,3688,102
2018,37,SD,41,45,-4
2018,37,TN,421,414,7
2018,37,TX,13908,13303,605
2018,37,UT,55,54,1
2018,37,VA,1968,1940,28
2018,37,VI,12,13,-1
2018,37,VT,41,39,2
2018,37,WA,402,423,-21
2018,37,WI,160,132,28
2018,37,WV,142,150,-8
2018,37,WY,19,21,-2
2018,38,AK,39,40,-1
2018,38,AL,1008,1071,-63
2018,38,AR,226,250,-24
2018,38,AZ,556,583,-27
2018,38,CA,2932,2976,-44
2018,38,CO,328,329,-1
2018,38,CT,565,588,-23
2018,38,DC,39,46,-7
2018,38,DE,533,533,0
2018,38,FL,32813,34207,-1394
2018,38,GA,1965,2099,-134
2018,38,HI,1904,1857,47
2018,38,IA,306,309,-3
2018,38,ID,61,66,-5
2018,38,IL,504,540,-36
2018,38,IN,290,298,-8
2018,38,KS,139,147,-8
2018,38,KY,241,259,-18
2018,38,LA,15665,16887,-1222
2018,38,MA,1100,1133,-33
2018,38,MD,1200,1227,-27
2018,38,ME,143,146,-3
2018,38,MI,208,206,2
2018,38,MN,129,139,-10
2018,38,MO,249,264,-15
2018,38,MS,1222,1301,-79
2018,38,MT,36,44,-8
2018,38,NC,3175,3191,-16
2018,38,ND,152,160,-8
2018,38,NE,81,87,-6
2018,38,NH,114,122,-8
2018,38,NJ,3132,3152,-20
2018,38,NM,132,132,0
2018,38,NV,143,159,-16
2018,38,NY,4003,4063,-60
2018,38,OH,475,497,-22
2018,38,OK,202,205,-3
2018,38,OR,423,457,-34
2018,38,PA,1076,1080,-4
2018,38,PR,107,94,13
2018,38,RI,361,379,-18
2018,38,SC,4237,4229,8
2018,38,SD,49,50,-1
2018,38,TN,494,524,-30
2018,38,TX,19111,19952,-841
2018,38,UT,63,62,1
2018,38,VA,2722,2775,-53
2018,38,VI,14,12,2
2018,38,VT,52,51,1
2018,38,WA,487,510,-23
2018,38,WI,244,174,70
2018,38,WV,156,157,-1
2018,38,WY,19,15,4
2018,39,AK,37,34,3
2018,39,AL,1356,1529,-173
2018,39,AR,194,202,-8
2018,39,AZ,444,486,-42
2018,39,CA,3117,3301,-184
2018,39,CO,342,344,-2
2018,39,CT,607,674,-67
2018,39,DC,56,67,-11
2018,39,DE,629,668,-39
2018,39,FL,45859,52061,-6202
2018,39,GA,2801,3226,-425
2018,39,HI,1047,971,76
2018,39,IA,155,145,10
2018,39,ID,66,68,-2
2018,39,IL,443,460,-17
2018,39,IN,273,304,-31
2018,39,KS,170,154,16
2018,39,KY,249,278,-29
2018,39,LA,12075,12937,-862
2018,39,MA,1148,1219,-71
2018,39,MD,1668,1794,-126
2018,39,ME,176,182,-6
2018,39,MI,179,174,5
2018,39,MN,125,143,-18
2018,39,MO,234,245,-11
2018,39,MS,1328,1451,-123
2018,39,MT,47,48,-1
2018,39,NC,4225,4545,-320
2018,39,ND,125,131,-6
2018,39,NE,92,103,-11
2018,39,NH,121,128,-7
2018,39,NJ,3391,3475,-84
2018,39,NM,144,143,1
2018,39,NV,123,141,-18
2018,39,NY,3841,4009,-168
2018,39,OH,435,474,-39
2018,39,OK,206,223,-17
2018,39,OR,332,371,-39
2018,39,PA,899,922,-23
2018,39,PR,59,46,13
2018,39,RI,258,276,-18
2018,39,SC,6551,7041,-490
2018,39,SD,39,46,-7
2018,39,TN,562,657,-95
2018,39,TX,26003,29504,-3501
2018,39,UT,71,64,7
2018,39,VA,4064,4409,-345
2018,39,VI,8,8,0
2018,39,VT,49,52,-3
2018,39,WA,547,578,-31
2018,39,WI,200,159,41
2018,39,WV,150,165,-15
2018,39,WY,25,26,-1
2018,40,AK,21,30,-9
2018,40,AL,964,1020,-56
2018,40,AR,176,175,1
2018,40,AZ,578,591,-13
2018,40,CA,3303,3557,-254
2018,40,CO,314,345,-31
2018,40,CT,598,610,-12
2018,40,DC,94,58,36
2018,40,DE,553,513,40
2018,40,FL,24791,25054,-263
2018,40,GA,2100,2096,4
2018,40,HI,1051,822,229
2018,40,IA,121,123,-2
2018,40,ID,64,76,-12
2018,40,IL,422,412,10
2018,40,IN,284,300,-16
2018,40,KS,113,116,-3
2018,40,KY,212,214,-2
2018,40,LA,9266,9259,7
2018,40,MA,1234,1264,-30
2018,40,MD,1483,1265,218
2018,40,ME,165,162,3
2018,40,MI,239,226,13
2018,40,MN,110,121,-11
2018,40,MO,224,239,-15
2018,40,MS,916,941,-25
2018,40,MT,45,52,-7
2018,40,NC,3965,3109,856
2018,40,ND,123,129,-6
2018,40,NE,73,71,2
2018,40,NH,89,93,-4
2018,40,NJ,2877,2844,33
2018,40,NM,123,131,-8
2018,40,NV,124,140,-16
2018,40,NY,4011,4093,-82
2018,40,OH,432,438,-6
2018,40,OK,215,228,-13
2018,40,OR,353,383,-30
2018,40,PA,1138,1012,126
2018,40,PR,43,30,13
2018,40,RI,213,227,-14
2018,40,SC,3876,3499,377
2018,40,SD,58,55,3
2018,40,TN,643,688,-45
2018,40,TX,21371,20837,534
2018,40,UT,63,66,-3
2018,40,VA,3957,2748,1209
2018,40,VI,13,10,3
2018,40,VT,53,55,-2
2018,40,WA,471,477,-6
2018,40,WI,152,120,32
2018,40,WV,173,160,13
2018,40,WY,17,19,-2
2018,41,AK,38,41,-3
2018,41,AL,681,687,-6
2018,41,AR,189,206,-17
2018,41,AZ,548,581,-33
2018,41,CA,4069,4239,-170
2018,41,CO,389,390,-1
2018,41,CT,545,566,-21
2018,41,DC,58,51,7
2018,41,DE,465,422,43
2018,41,FL,29242,28892,350
2018,41,GA,1829,1808,21
2018,41,HI,1262,759,503
2018,41,IA,203,199,4
2018,41,ID,75,78,-3
2018,41,IL,401,417,-16
2018,41,IN,285,296,-11
2018,41,KS,123,122,1
2018,41,KY,212,218,-6
2018,41,LA,8865,8860,5
2018,41,MA,1201,1203,-2
2018,41,MD,1155,1051,104
2018,41,ME,221,219,2
2018,41,MI,224,212,12
2018,41,MN,129,127,2
2018,41,MO,229,238,-9
2018,41,MS,858,865,-7
2018,41,MT,51,58,-7
2018,41,NC,3054,2524,530
2018,41,ND,138,147,-9
2018,41,NE,85,85,0
2018,41,NH,81,82,-1
2018,41,NJ,3094,2997,97
2018,41,NM,169,163,6
2018,41,NV,143,161,-18
2018,41,NY,3243,3232,11
2018,41,OH,417,434,-17
2018,41,OK,188,183,5
2018,41,OR,437,480,-43
2018,41,PA,950,894,56
2018,41,PR,49,37,12
2018,41,RI,261,270,-9
2018,41,SC,3881,3262,619
2018,41,SD,29,28,1
2018,41,TN,421,439,-18
2018,41,TX,17316,17599,-283
2018,41,UT,83,80,3
2018,41,VA,2674,2147,527
2018,41,VI,13,11,2
2018,41,VT,47,50,-3
2018,41,WA,550,567,-17
2018,41,WI,156,127,29
2018,41,WV,135,137,-2
2018,41,WY,22,20,2
2018,42,AK,46,44,2
2018,42,AL,845,826,19
2018,42,AR,169,173,-4
2018,42,AZ,457,471,-14
2018,42,CA,4008,4195,-187
2018,42,CO,389,401,-12
2018,42,CT,514,500,14
2018,42,DC,48,49,-1
2018,42,DE,510,483,27
2018,42,FL,25707,25969,-262
2018,42,GA,1711,1694,17
2018,42,HI,1803,1786,17
2018,42,IA,119,121,-2
2018,42,ID,70,72,-2
2018,42,IL,397,390,7
2018,42,IN,283,281,2
2018,42,KS,122,115,7
2018,42,KY,199,195,4
2018,42,LA,7587,7648,-61
2018,42,MA,1069,1080,-11
2018,42,MD,959,897,62
2018,42,ME,145,136,9
2018,42,MI,198,195,3
2018,42,MN,146,140,6
2018,42,MO,222,216,6
2018,42,MS,967,960,7
2018,42,MT,47,47,0
2018,42,NC,2786,2095,691
2018,42,ND,113,122,-9
2018,42,NE,63,71,-8
2018,42,NH,93,90,3
2018,42,NJ,2669,2647,22
2018,42,NM,125,130,-5
2018,42,NV,143,149,-6
2018,42,NY,2749,2730,19
2018,42,OH,415,423,-8
2018,42,OK,217,212,5
2018,42,OR,382,403,-21
2018,42,PA,1170,1140,30
2018,42,PR,47,38,9
2018,42,RI,190,187,3
2018,42,SC,3551,2906,645
2018,42,SD,28,33,-5
2018,42,TN,401,421,-20
2018,42,TX,14711,14607,104
2018,42,UT,72,72,0
2018,42,VA,2488,2206,282
2018,42,VI,6,7,-1
2018,42,VT,55,51,4
2018,42,WA,567,609,-42
2018,42,WI,221,161,60
2018,42,WV,155,155,0
2018,42,WY,25,25,0
2018,43,AK,31,25,6
2018,43,AL,989,987,2
2018,43,AR,172,179,-7
2018,43,AZ,469,412,57
2018,43,CA,4064,4122,-58
2018,43,CO,396,296,100
2018,43,CT,457,473,-16
2018,43,DC,33,25,8
2018,43,DE,484,471,13
2018,43,FL,31098,31452,-354
2018,43,GA,1732,1796,-64
2018,43,HI,1684,1497,187
2018,43,IA,177,180,-3
2018,43,ID,69,68,1
2018,43,IL,486,475,11
2018,43,IN,244,266,-22
2018,43,KS,143,142,1
2018,43,KY,240,250,-10
2018,43,LA,8336,8501,-165
2018,43,MA,1320,1333,-13
2018,43,MD,1128,1120,8
2018,43,ME,173,164,9
2018,43,MI,294,293,1
2018,43,MN,112,112,0
2018,43,MO,224,219,5
2018,43,MS,876,895,-19
2018,43,MT,45,50,-5
2018,43,NC,2871,2306,565
2018,43,ND,167,182,-15
2018,43,NE,83,74,9
2018,43,NH,108,108,0
2018,43,NJ,3148,3143,5
2018,43,NM,136,138,-2
2018,43,NV,145,143,2
2018,43,NY,3261,3257,4
2018,43,OH,404,408,-4
2018,43,OK,198,210,-12
2018,43,OR,453,491,-38
2018,43,PA,883,898,-15
2018,43,PR,49,39,10
2018,43,RI,202,212,-10
2018,43,SC,4077,3729,348
2018,43,SD,39,39,0
2018,43,TN,425,442,-17
2018,43,TX,14020,14261,-241
2018,43,UT,325,55,270
2018,43,VA,2083,1966,117
2018,43,VI,8,10,-2
2018,43,VT,48,49,-1
2018,43,WA,666,729,-63
2018,43,WI,131,122,9
2018,43,WV,153,154,-1
2018,43,WY,25,23,2
2018,44,AK,27,28,-1
2018,44,AL,755,745,10
2018,44,AR,168,171,-3
2018,44,AZ,339,320,19
2018,44,CA,3923,4053,-130
2018,44,CO,230,217,13
2018,44,CT,369,357,12
2018,44,DC,46,37,9
2018,44,DE,291,265,26
2018,44,FL,20587,20921,-334
2018,44,GA,1386,1338,48
2018,44,HI,919,931,-12
2018,44,IA,113,104,9
2018,44,ID,66,66,0
2018,44,IL,299,318,-19
2018,44,IN,228,235,-7
2018,44,KS,101,95,6
2018,44,KY,206,209,-3
2018,44,LA,6010,6138,-128
2018,44,MA,825,826,-1
2018,44,MD,706,685,21
2018,44,ME,136,134,2
2018,44,MI,148,148,0
2018,44,MN,177,90,87
2018,44,MO,256,243,13
2018,44,MS,858,889,-31
2018,44,MT,39,41,-2
2018,44,NC,2786,2094,692
2018,44,ND,100,100,0
2018,44,NE,49,59,-10
2018,44,NH,77,75,2
2018,44,NJ,2676,2663,13
2018,44,NM,94,97,-3
2018,44,NV,114,126,-12
2018,44,NY,2412,2453,-41
2018,44,OH,288,305,-17
2018,44,OK,166,159,7
2018,44,OR,385,421,-36
2018,44,PA,716,717,-1
2018,44,PR,51,34,17
2018,44,RI,159,162,-3
2018,44,SC,3226,2892,334
2018,44,SD,24,29,-5
2018,44,TN,391,411,-20
2018,44,TX,10100,10400,-300
2018,44,UT,71,55,16
2018,44,VA,1991,1835,156
2018,44,VI,2,3,-1
2018,44,VT,45,46,-1
2018,44,WA,687,715,-28
2018,44,WI,138,120,18
2018,44,WV,135,141,-6
2018,44,WY,33,33,0
2018,45,AK,19,19,0
2018,45,AL,774,758,16
2018,45,AR,138,145,-7
2018,45,AZ,349,327,22
2018,45,CA,4206,4335,-129
2018,45,CO,301,312,-11
2018,45,CT,591,592,-1
2018,45,DC,26,22,4
2018,45,DE,360,342,18
2018,45,FL,21240,20998,242
2018,45,GA,1248,1257,-9
2018,45,HI,1530,1501,29
2018,45,IA,114,108,6
2018,45,ID,68,70,-2
2018,45,IL,348,405,-57
2018,45,IN,225,238,-13
2018,45,KS,115,113,2
2018,45,KY,167,178,-11
2018,45,LA,6260,6474,-214
2018,45,MA,849,842,7
2018,45,MD,858,841,17
2018,45,ME,125,128,-3
2018,45,MI,168,168,0
2018,45,MN,82,86,-4
2018,45,MO,185,187,-2
2018,45,MS,946,813,133
2018,45,MT,44,41,3
2018,45,NC,2673,2298,375
2018,45,ND,85,94,-9
2018,45,NE,65,60,5
2018,45,NH,71,84,-13
2018,45,NJ,2684,2652,32
2018,45,NM,102,106,-4
2018,45,NV,132,135,-3
2018,45,NY,2451,2482,-31
2018,45,OH,342,342,0
2018,45,OK,153,162,-9
2018,45,OR,521,564,-43
2018,45,PA,692,705,-13
2018,45,PR,46,34,12
2018,45,RI,142,139,3
2018,45,SC,3039,2865,174
2018,45,SD,23,28,-5
2018,45,TN,336,325,11
2018,45,TX,10230,9963,267
2018,45,UT,67,55,12
2018,45,VA,1653,1802,-149
2018,45,VI,6,7,-1
2018,45,VT,39,43,-4
2018,45,WA,609,646,-37
2018,45,WI,120,109,11
2018,45,WV,138,143,-5
2018,45,WY,9,12,-3
2018,46,AK,52,52,0
2018,46,AL,478,474,4
2018,46,AR,121,126,-5
2018,46,AZ,337,333,4
2018,46,CA,4387,4631,-244
2018,46,CO,212,214,-2
2018,46,CT,420,423,-3
2018,46,DC,23,22,1
2018,46,DE,300,285,15
2018,46,FL,19469,19737,-268
2018,46,GA,1055,1090,-35
2018,46,HI,756,749,7
2018,46,IA,110,101,9
2018,46,ID,43,48,-5
2018,46,IL,302,316,-14
2018,46,IN,217,238,-21
2018,46,KS,102,103,-1
2018,46,KY,195,204,-9
2018,46,LA,5857,5896,-39
2018,46,MA,776,789,-13
2018,46,MD,812,787,25
2018,46,ME,104,108,-4
2018,46,MI,151,138,13
2018,46,MN,70,79,-9
2018,46,MO,182,238,-56
2018,46,MS,835,859,-24
2018,46,MT,36,36,0
2018,46,NC,2097,1788,309
2018,46,ND,75,75,0
2018,46,NE,52,57,-5
2018,46,NH,70,70,0
2018,46,NJ,2305,2319,-14
2018,46,NM,103,96,7
2018,46,NV,145,153,-8
2018,46,NY,2286,2316,-30
2018,46,OH,325,348,-23
2018,46,OK,142,153,-11
2018,46,OR,433,441,-8
2018,46,PA,665,684,-19
2018,46,PR,53,38,15
2018,46,RI,146,147,-1
2018,46,SC,2530,2456,74
2018,46,SD,24,33,-9
2018,46,TN,298,328,-30
2018,46,TX,9386,9269,117
2018,46,UT,56,44,12
2018,46,VA,1494,1423,71
2018,46,VI,12,11,1
2018,46,VT,50,47,3
2018,46,WA,573,636,-63
2018,46,WI,149,152,-3
2018,46,WV,115,125,-10
2018,46,WY,21,23,-2
2018,47,AK,34,30,4
2018,47,AL,813,813,0
2018,47,AR,127,151,-24
2018,47,AZ,340,341,-1
2018,47,CA,6704,7230,-526
2018,47,CO,211,216,-5
2018,47,CT,897,896,1
2018,47,DC,103,107,-4
2018,47,DE,380,364,16
2018,47,FL,26822,27197,-375
2018,47,GA,1217,1282,-65
2018,47,GU,1,1,0
2018,47,HI,1322,1310,12
2018,47,IA,123,118,5
2018,47,ID,61,65,-4
2018,47,IL,399,411,-12
2018,47,IN,218,217,1
2018,47,KS,104,106,-2
2018,47,KY,202,211,-9
2018,47,LA,6961,7087,-126
2018,47,MA,989,1015,-26
2018,47,MD,1005,1003,2
2018,47,ME,112,108,4
2018,47,MI,189,196,-7
2018,47,MN,98,97,1
2018,47,MO,184,195,-11
2018,47,MS,820,831,-11
2018,47,MT,55,56,-1
2018,47,NC,2048,1784,264
2018,47,ND,79,86,-7
2018,47,NE,69,69,0
2018,47,NH,194,196,-2
2018,47,NJ,3183,3224,-41
2018,47,NM,99,101,-2
2018,47,NV,108,118,-10
2018,47,NY,2552,2600,-48
2018,47,OH,303,324,-21
2018,47,OK,152,151,1
2018,47,OR,469,485,-16
2018,47,PA,780,804,-24
2018,47,PR,38,114,-76
2018,47,RI,165,178,-13
2018,47,SC,3204,3054,150
2018,47,SD,36,36,0
2018,47,TN,454,465,-11
2018,47,TX,10004,9938,66
2018,47,UT,73,73,0
2018,47,VA,1480,1456,24
2018,47,VI,10,9,1
2018,47,VT,74,78,-4
2018,47,WA,632,674,-42
2018,47,WI,120,113,7
2018,47,WV,108,127,-19
2018,47,WY,29,28,1
2018,48,AK,24,26,-2
2018,48,AL,794,796,-2
2018,48,AR,115,111,4
2018,48,AZ,298,308,-10
2018,48,CA,5439,5815,-376
2018,48,CO,227,228,-1
2018,48,CT,372,385,-13
2018,48,DC,32,26,6
2018,48,DE,299,297,2
2018,48,FL,20577,20889,-312
2018,48,GA,1169,1195,-26
2018,48,HI,368,326,42
2018,48,IA,92,91,1
2018,48,ID,56,60,-4
2018,48,IL,290,302,-12
2018,48,IN,187,199,-12
2018,48,KS,92,103,-11
2018,48,KY,184,182,2
2018,48,LA,5337,5264,73
2018,48,MA,810,815,-5
2018,48,MD,602,593,9
2018,48,ME,124,136,-12
2018,48,MI,208,193,15
2018,48,MN,72,91,-19
2018,48,MO,207,212,-5
2018,48,MS,826,830,-4
2018,48,MT,35,32,3
2018,48,NC,1770,1635,135
2018,48,ND,83,89,-6
2018,48,NE,42,42,0
2018,48,NH,95,87,8
2018,48,NJ,1925,1923,2
2018,48,NM,106,107,-1
2018,48,NV,117,118,-1
2018,48,NY,2532,2586,-54
2018,48,OH,320,334,-14
2018,48,OK,130,133,-3
2018,48,OR,435,437,-2
2018,48,PA,651,664,-13
2018,48,PR,35,22,13
2018,48,RI,211,218,-7
2018,48,SC,3656,3560,96
2018,48,SD,30,31,-1
2018,48,TN,282,302,-20
2018,48,TX,7967,8002,-35
2018,48,UT,38,42,-4
2018,48,VA,1367,1311,56
2018,48,VI,45,45,0
2018,48,VT,32,27,5
2018,48,WA,535,569,-34
2018,48,WI,185,189,-4
2018,48,WV,103,118,-15
2018,48,WY,15,15,0
2018,49,AK,24,25,-1
2018,49,AL,488,500,-12
2018,49,AR,124,125,-1
2018,49,AZ,351,334,17
2018,49,CA,5534,5699,-165
2018,49,CO,208,215,-7
2018,49,CT,481,485,-4
2018,49,DC,24,25,-1
2018,49,DE,317,317,0
2018,49,FL,21214,21860,-646
2018,49,GA,1041,1076,-35
2018,49,HI,1389,1386,3
2018,49,IA,113,121,-8
2018,49,ID,56,66,-10
2018,49,IL,463,483,-20
2018,49,IN,182,181,1
2018,49,KS,112,121,-9
2018,49,KY,159,176,-17
2018,49,LA,5736,5765,-29
2018,49,MA,742,758,-16
2018,49,MD,887,894,-7
2018,49,ME,120,117,3
2018,49,MI,196,188,8
2018,49,MN,62,65,-3
2018,49,MO,191,187,4
2018,49,MS,745,740,5
2018,49,MT,38,42,-4
2018,49,NC,1897,1699,198
2018,49,ND,81,88,-7
2018,49,NE,57,59,-2
2018,49,NH,64,62,2
2018,49,NJ,2652,2710,-58
2018,49,NM,100,108,-8
2018,49,NV,123,128,-5
2018,49,NY,2541,2589,-48
2018,49,OH,420,434,-14
2018,49,OK,132,149,-17
2018,49,OR,376,403,-27
2018,49,PA,636,641,-5
2018,49,PR,41,39,2
2018,49,RI,138,142,-4
2018,49,SC,2490,2418,72
2018,49,SD,29,29,0
2018,49,TN,312,314,-2
2018,49,TX,8172,8037,135
2018,49,UT,36,38,-2
2018,49,VA,1310,1273,37
2018,49,VI,7,6,1
2018,49,VT,37,41,-4
2018,49,WA,537,572,-35
2018,49,WI,115,105,10
2018,49,WV,111,122,-11
2018,49,WY,16,19,-3
2018,50,AK,19,16,3
2018,50,AL,508,502,6
2018,50,AR,183,173,10
2018,50,AZ,315,328,-13
2018,50,CA,4780,4503,277
2018,50,CO,260,274,-14
2018,50,CT,289,293,-4
2018,50,DC,29,29,0
2018,50,DE,327,312,15
2018,50,FL,21199,21810,-611
2018,50,GA,998,1096,-98
2018,50,GU,3,3,0
2018,50,HI,1253,929,324
2018,50,IA,124,128,-4
2018,50,ID,57,60,-3
2018,50,IL,308,336,-28
2018,50,IN,189,207,-18
2018,50,KS,67,76,-9
2018,50,KY,196,247,-51
2018,50,LA,6850,6964,-114
2018,50,MA,800,790,10
2018,50,MD,710,717,-7
2018,50,ME,115,117,-2
2018,50,MI,150,145,5
2018,50,MN,80,85,-5
2018,50,MO,180,192,-12
2018,50,MS,759,790,-31
2018,50,MT,35,41,-6
2018,50,NC,2654,2545,109
2018,50,ND,86,88,-2
2018,50,NE,52,50,2
2018,50,NH,102,93,9
2018,50,NJ,2429,2471,-42
2018,50,NM,83,90,-7
2018,50,NV,109,119,-10
2018,50,NY,2824,2913,-89
2018,50,OH,270,294,-24
2018,50,OK,128,143,-15
2018,50,OR,374,408,-34
2018,50,PA,657,692,-35
2018,50,PR,35,18,17
2018,50,RI,142,148,-6
2018,50,SC,2613,2557,56
2018,50,SD,35,39,-4
2018,50,TN,308,328,-20
2018,50,TX,8028,8188,-160
2018,50,UT,80,74,6
2018,50,VA,1191,1203,-12
2018,50,VI,7,6,1
2018,50,VT,27,28,-1
2018,50,WA,636,674,-38
2018,50,WI,98,94,4
2018,50,WV,123,124,-1
2018,50,WY,24,24,0
2018,51,AK,18,15,3
2018,51,AL,389,391,-2
2018,51,AR,78,79,-1
2018,51,AZ,236,226,10
2018,51,CA,3282,3148,134
2018,51,CO,193,197,-4
2018,51,CT,273,266,7
2018,51,DC,21,21,0
2018,51,DE,200,189,11
2018,51,FL,16408,16496,-88
2018,51,GA,706,727,-21
2018,51,HI,1200,1166,34
2018,51,IA,83,86,-3
2018,51,ID,43,35,8
2018,51,IL,189,190,-1
2018,51,IN,130,136,-6
2018,51,KS,73,72,1
2018,51,KY,118,112,6
2018,51,LA,4101,4123,-22
2018,51,MA,764,764,0
2018,51,MD,968,942,26
2018,51,ME,72,67,5
2018,51,MI,106,106,0
2018,51,MN,65,60,5
2018,51,MO,130,125,5
2018,51,MS,499,491,8
2018,51,MT,17,19,-2
2018,51,NC,1271,1068,203
2018,51,ND,58,72,-14
2018,51,NE,39,48,-9
2018,51,NH,52,50,2
2018,51,NJ,1625,1603,22
2018,51,NM,74,77,-3
2018,51,NV,78,77,1
2018,51,NY,2268,2301,-33
2018,51,OH,210,216,-6
2018,51,OK,85,91,-6
2018,51,OR,321,333,-12
2018,51,PA,444,448,-4
2018,51,PR,60,65,-5
2018,51,RI,75,80,-5
2018,51,SC,1795,1714,81
2018,51,SD,19,20,-1
2018,51,TN,296,293,3
2018,51,TX,5911,5727,184
2018,51,UT,41,39,2
2018,51,VA,753,761,-8
2018,51,VI,2,1,1
2018,51,VT,23,29,-6
2018,51,WA,399,417,-18
2018,51,WI,228,66,162
2018,51,WV,68,71,-3
2018,51,WY,13,13,0
2018,52,AK,7,5,2
2018,52,AL,218,215,3
2018,52,AR,25,27,-2
2018,52,AZ,102,103,-1
2018,52,CA,1303,1321,-18
2018,52,CO,79,79,0
2018,52,CT,84,87,-3
2018,52,DC,9,9,0
2018,52,DE,61,65,-4
2018,52,FL,9526,9113,413
2018,52,GA,278,301,-23
2018,52,HI,62,118,-56
2018,52,IA,24,21,3
2018,52,ID,19,20,-1
2018,52,IL,73,79,-6
2018,52,IN,49,51,-2
2018,52,KS,24,27,-3
2018,52,KY,43,43,0
2018,52,LA,1953,2033,-80
2018,52,MA,252,263,-11
2018,52,MD,197,197,0
2018,52,ME,22,25,-3
2018,52,MI,56,58,-2
2018,52,MN,32,33,-1
2018,52,MO,55,53,2
2018,52,MS,216,213,3
2018,52,MT,9,8,1
2018,52,NC,496,453,43
2018,52,ND,50,56,-6
2018,52,NE,28,28,0
2018,52,NH,16,18,-2
2018,52,NJ,502,524,-22
2018,52,NM,33,32,1
2018,52,NV,29,37,-8
2018,52,NY,739,735,4
2018,52,OH,80,82,-2
2018,52,OK,45,40,5
2018,52,OR,107,157,-50
2018,52,PA,185,184,1
2018,52,PR,10,9,1
2018,52,RI,38,39,-1
2018,52,SC,1338,1352,-14
2018,52,SD,8,9,-1
2018,52,TN,98,97,1
2018,52,TX,2448,2481,-33
2018,52,UT,12,12,0
2018,52,VA,330,331,-1
2018,52,VT,4,4,0
2018,52,WA,161,175,-14
2018,52,WI,30,27,3
2018,52,WV,30,32,-2
2018,52,WY,2,3,-1
2019,0,AK,11,10,1
2019,0,AL,288,292,-4
2019,0,AR,65,77,-12
2019,0,AZ,208,213,-5
2019,0,CA,3898,3951,-53
2019,0,CO,139,152,-13
2019,0,CT,221,259,-38
2019,0,DC,23,20,3
2019,0,DE,321,322,-1
2019,0,FL,20123,20289,-166
2019,0,GA,741,721,20
2019,0,HI,261,271,-10
2019,0,IA,91,89,2
2019,0,ID,45,46,-1
2019,0,IL,250,229,21
2019,0,IN,143,145,-2
2019,0,KS,57,62,-5
2019,0,KY,107,111,-4
2019,0,LA,3027,2977,50
2019,0,MA,467,458,9
2019,0,MD,505,497,8
2019,0,ME,68,71,-3
2019,0,MI,93,93,0
2019,0,MN,50,50,0
2019,0,MO,109,103,6
2019,0,MS,499,500,-1
2019,0,MT,26,28,-2
2019,0,NC,1234,1114,120
2019,0,ND,59,66,-7
2019,0,NE,71,63,8
2019,0,NH,47,46,1
2019,0,NJ,1361,1384,-23
2019,0,NM,66,67,-1
2019,0,NV,82,82,0
2019,0,NY,1506,1520,-14
2019,0,OH,162,165,-3
2019,0,OK,81,80,1
2019,0,OR,274,304,-30
2019,0,PA,421,424,-3
2019,0,PR,21,22,-1
2019,0,RI,72,73,-1
2019,0,SC,1597,1590,7
2019,0,SD,20,18,2
2019,0,TN,181,186,-5
2019,0,TX,4581,4602,-21
2019,0,UT,23,23,0
2019,0,VA,808,799,9
2019,0,VI,2,3,-1
2019,0,VT,18,16,2
2019,0,WA,286,302,-16
2019,0,WI,143,144,-1
2019,0,WV,68,70,-2
2019,0,WY,4,1,3
2019,1,AK,21,19,2
2019,1,AL,747,738,9
2019,1,AR,102,105,-3
2019,1,AZ,283,299,-16
2019,1,CA,3940,3925,15
2019,1,CO,213,206,7
2019,1,CT,461,563,-102
2019,1,DC,22,24,-2
2019,1,DE,241,238,3
2019,1,FL,18528,18711,-183
2019,1,GA,823,860,-37
2019,1,HI,695,693,2
2019,1,IA,81,91,-10
2019,1,ID,49,54,-5
2019,1,IL,294,570,-276
2019,1,IN,174,185,-11
2019,1,KS,116,119,-3
2019,1,KY,134,140,-6
2019,1,LA,4763,4786,-23
2019,1,MA,507,515,-8
2019,1,MD,647,665,-18
2019,1,ME,92,89,3
2019,1,MI,176,182,-6
2019,1,MN,60,67,-7
2019,1,MO,153,158,-5
2019,1,MS,710,722,-12
2019,1,MT,31,37,-6
2019,1,NC,1493,1386,107
2019,1,ND,182,195,-13
2019,1,NE,49,71,-22
2019,1,NH,65,61,4
2019,1,NJ,1750,1790,-40
2019,1,NM,96,103,-7
2019,1,NV,114,135,-21
2019,1,NY,2149,2195,-46
2019,1,OH,328,337,-9
2019,1,OK,128,135,-7
2019,1,OR,387,422,-35
2019,1,PA,558,596,-38
2019,1,PR,23,33,-10
2019,1,RI,307,306,1
2019,1,SC,1849,1821,28
2019,1,SD,17,21,-4
2019,1,TN,379,379,0
2019,1,TX,6532,6403,129
2019,1,UT,42,42,0
2019,1,VA,878,889,-11
2019,1,VI,4,5,-1
2019,1,VT,27,29,-2
2019,1,WA,428,457,-29
2019,1,WI,139,106,33
2019,1,WV,107,120,-13
2019,1,WY,14,16,-2
2019,2,AK,35,35,0
2019,2,AL,492,498,-6
2019,2,AR,118,121,-3
2019,2,AZ,276,283,-7
2019,2,CA,3802,3806,-4
2019,2,CO,154,165,-11
2019,2,CT,393,387,6
2019,2,DC,22,19,3
2019,2,DE,219,219,0
2019,2,FL,19810,20073,-263
2019,2,GA,887,919,-32
2019,2,HI,1236,1239,-3
2019,2,IA,89,100,-11
2019,2,ID,45,44,1
2019,2,IL,233,260,-27
2019,2,IN,182,188,-6
2019,2,KS,95,103,-8
2019,2,KY,156,157,-1
2019,2,LA,4839,4873,-34
2019,2,MA,534,535,-1
2019,2,MD,1038,1024,14
2019,2,ME,97,96,1
2019,2,MI,141,141,0
2019,2,MN,63,68,-5
2019,2,MO,190,204,-14
2019,2,MS,660,669,-9
2019,2,MT,34,36,-2
2019,2,NC,1806,1703,103
2019,2,ND,174,189,-15
2019,2,NE,44,51,-7
2019,2,NH,81,80,1
2019,2,NJ,1847,1910,-63
2019,2,NM,86,84,2
2019,2,NV,121,127,-6
2019,2,NY,2777,2805,-28
2019,2,OH,224,229,-5
2019,2,OK,98,104,-6
2019,2,OR,351,386,-35
2019,2,PA,568,595,-27
2019,2,PR,32,44,-12
2019,2,RI,96,101,-5
2019,2,SC,2597,2558,39
2019,2,SD,18,19,-1
2019,2,TN,250,233,17
2019,2,TX,6536,6592,-56
2019,2,UT,34,35,-1
2019,2,VA,862,856,6
2019,2,VI,2,4,-2
2019,2,VT,25,27,-2
2019,2,WA,636,638,-2
2019,2,WI,183,183,0
2019,2,WV,108,109,-1
2019,2,WY,17,19,-2
2019,3,AK,18,17,1
2019,3,AL,385,393,-8
2019,3,AR,88,101,-13
2019,3,AZ,225,218,7
2019,3,CA,2616,2603,13
2019,3,CO,149,161,-12
2019,3,CT,198,199,-1
2019,3,DC,13,15,-2
2019,3,DE,344,339,5
2019,3,FL,16908,17467,-559
2019,3,GA,741,795,-54
2019,3,HI,464,428,36
2019,3,IA,72,70,2
2019,3,ID,38,37,1
2019,3,IL,212,213,-1
2019,3,IN,136,141,-5
2019,3,KS,67,67,0
2019,3,KY,117,131,-14
2019,3,LA,4125,4219,-94
2019,3,MA,445,446,-1
2019,3,MD,512,526,-14
2019,3,ME,73,76,-3
2019,3,MI,113,126,-13
2019,3,MN,54,59,-5
2019,3,MO,111,121,-10
2019,3,MS,522,515,7
2019,3,MT,29,30,-1
2019,3,NC,1280,1227,53
2019,3,ND,79,90,-11
2019,3,NE,43,47,-4
2019,3,NH,50,55,-5
2019,3,NJ,1568,1632,-64
2019,3,NM,64,67,-3
2019,3,NV,64,72,-8
2019,3,NY,1668,1757,-89
2019,3,OH,189,202,-13
2019,3,OK,117,118,-1
2019,3,OR,297,260,37
2019,3,PA,443,455,-12
2019,3,PR,24,91,-67
2019,3,RI,81,85,-4
2019,3,SC,1854,1801,53
2019,3,SD,16,17,-1
2019,3,TN,225,240,-15
2019,3,TX,5381,5464,-83
2019,3,UT,29,30,-1
2019,3,VA,762,773,-11
2019,3,VI,12,13,-1
2019,3,VT,24,26,-2
2019,3,WA,315,328,-13
2019,3,WI,85,86,-1
2019,3,WV,74,82,-8
2019,3,WY,7,7,0
2019,4,AK,24,22,2
2019,4,AL,950,871,79
2019,4,AR,149,155,-6
2019,4,AZ,287,300,-13
2019,4,CA,3189,3372,-183
2019,4,CO,260,263,-3
2019,4,CT,304,313,-9
2019,4,DC,39,44,-5
2019,4,DE,233,211,22
2019,4,FL,21113,21744,-631
2019,4,GA,1036,1085,-49
2019,4,HI,1496,1453,43
2019,4,IA,132,130,2
2019,4,ID,74,71,3
2019,4,IL,341,344,-3
2019,4,IN,193,200,-7
2019,4,KS,89,89,0
2019,4,KY,149,154,-5
2019,4,LA,5867,5881,-14
2019,4,MA,495,542,-47
2019,4,MD,637,644,-7
2019,4,ME,73,76,-3
2019,4,MI,141,144,-3
2019,4,MN,86,85,1
2019,4,MO,189,200,-11
2019,4,MS,930,952,-22
2019,4,MT,47,50,-3
2019,4,NC,1686,1556,130
2019,4,ND,122,124,-2
2019,4,NE,53,52,1
2019,4,NH,48,52,-4
2019,4,NJ,2426,2493,-67
2019,4,NM,94,88,6
2019,4,NV,152,158,-6
2019,4,NY,1964,2010,-46
2019,4,OH,225,257,-32
2019,4,OK,99,110,-11
2019,4,OR,383,383,0
2019,4,PA,592,668,-76
2019,4,PR,28,37,-9
2019,4,RI,98,107,-9
2019,4,SC,2304,2365,-61
2019,4,SD,20,20,0
2019,4,TN,260,277,-17
2019,4,TX,6996,6998,-2
2019,4,UT,38,42,-4
2019,4,VA,1020,1007,13
2019,4,VI,6,10,-4
2019,4,VT,48,48,0
2019,4,WA,474,499,-25
2019,4,WI,93,92,1
2019,4,WV,102,104,-2
2019,4,WY,9,13,-4
2019,5,AK,15,15,0
2019,5,AL,546,549,-3
2019,5,AR,145,151,-6
2019,5,AZ,303,304,-1
2019,5,CA,4737,4859,-122
2019,5,CO,404,393,11
2019,5,CT,240,244,-4
2019,5,DC,20,20,0
2019,5,DE,208,208,0
2019,5,FL,17324,17199,125
2019,5,GA,840,875,-35
2019,5,HI,577,545,32
2019,5,IA,108,107,1
2019,5,ID,108,121,-13
2019,5,IL,353,375,-22
2019,5,IN,214,228,-14
2019,5,KS,82,98,-16
2019,5,KY,178,182,-4
2019,5,LA,5599,5557,42
2019,5,MA,581,569,12
2019,5,MD,516,517,-1
2019,5,ME,130,128,2
2019,5,MI,171,166,5
2019,5,MN,100,100,0
2019,5,MO,165,168,-3
2019,5,MS,779,775,4
2019,5,MT,64,73,-9
2019,5,NC,1533,1428,105
2019,5,ND,159,178,-19
2019,5,NE,69,66,3
2019,5,NH,42,43,-1
2019,5,NJ,1991,2020,-29
2019,5,NM,76,85,-9
2019,5,NV,157,163,-6
2019,5,NY,2056,2099,-43
2019,5,OH,320,339,-19
2019,5,OK,129,132,-3
2019,5,OR,337,343,-6
2019,5,PA,613,665,-52
2019,5,PR,29,42,-13
2019,5,RI,116,114,2
2019,5,SC,1972,1910,62
2019,5,SD,23,26,-3
2019,5,TN,280,279,1
2019,5,TX,6823,6755,68
2019,5,UT,119,121,-2
2019,5,VA,924,922,2
2019,5,VI,6,10,-4
2019,5,VT,45,47,-2
2019,5,WA,419,470,-51
2019,5,WI,89,89,0
2019,5,WV,143,151,-8
2019,5,WY,18,17,1
2019,6,AK,30,30,0
2019,6,AL,707,692,15
2019,6,AR,135,140,-5
2019,6,AZ,342,346,-4
2019,6,CA,3754,3722,32
2019,6,CO,277,281,-4
2019,6,CT,261,266,-5
2019,6,DC,27,30,-3
2019,6,DE,195,197,-2
2019,6,FL,21135,21085,50
2019,6,GA,921,936,-15
2019,6,HI,804,800,4
2019,6,IA,127,120,7
2019,6,ID,88,86,2
2019,6,IL,692,705,-13
2019,6,IN,236,237,-1
2019,6,KS,109,108,1
2019,6,KY,151,153,-2
2019,6,LA,5546,5491,55
2019,6,MA,974,974,0
2019,6,MD,566,577,-11
2019,6,ME,87,81,6
2019,6,MI,169,174,-5
2019,6,MN,109,108,1
2019,6,MO,194,198,-4
2019,6,MS,759,782,-23
2019,6,MT,57,62,-5
2019,6,NC,1775,1663,112
2019,6,ND,214,224,-10
2019,6,NE,78,86,-8
2019,6,NH,70,68,2
2019,6,NJ,1967,2004,-37
2019,6,NM,88,96,-8
2019,6,NV,152,163,-11
2019,6,NY,2135,2226,-91
2019,6,OH,306,326,-20
2019,6,OK,118,125,-7
2019,6,OR,315,356,-41
2019,6,PA,750,789,-39
2019,6,PR,32,58,-26
2019,6,RI,118,119,-1
2019,6,SC,2315,2228,87
2019,6,SD,29,28,1
2019,6,TN,286,302,-16
2019,6,TX,6731,6668,63
2019,6,UT,38,36,2
2019,6,VA,1041,1045,-4
2019,6,VI,7,14,-7
2019,6,VT,41,45,-4
2019,6,WA,476,495,-19
2019,6,WI,115,106,9
2019,6,WV,126,133,-7
2019,6,WY,26,24,2
2019,7,AK,21,20,1
2019,7,AL,659,687,-28
2019,7,AR,149,156,-7
2019,7,AZ,286,298,-12
2019,7,CA,3359,3433,-74
2019,7,CO,192,203,-11
2019,7,CT,255,254,1
2019,7,DC,37,36,1
2019,7,DE,241,238,3
2019,7,FL,19332,20005,-673
2019,7,GA,896,939,-43
2019,7,HI,1273,1303,-30
2019,7,IA,126,131,-5
2019,7,ID,82,87,-5
2019,7,IL,327,345,-18
2019,7,IN,198,195,3
2019,7,KS,97,106,-9
2019,7,KY,178,196,-18
2019,7,LA,5882,5923,-41
2019,7,MA,526,540,-14
2019,7,MD,485,483,2
2019,7,ME,85,78,7
2019,7,MI,191,194,-3
2019,7,MN,97,103,-6
2019,7,MO,169,176,-7
2019,7,MS,806,825,-19
2019,7,MT,58,65,-7
2019,7,NC,1666,1594,72
2019,7,ND,167,172,-5
2019,7,NE,98,99,-1
2019,7,NH,71,67,4
2019,7,NJ,1795,1826,-31
2019,7,NM,97,103,-6
2019,7,NV,139,150,-11
2019,7,NY,2619,2680,-61
2019,7,OH,401,407,-6
2019,7,OK,120,122,-2
2019,7,OR,335,352,-17
2019,7,PA,770,813,-43
2019,7,PR,44,62,-18
2019,7,RI,92,100,-8
2019,7,SC,2049,2013,36
2019,7,SD,24,26,-2
2019,7,TN,295,307,-12
2019,7,TX,7333,7433,-100
2019,7,UT,69,72,-3
2019,7,VA,1043,1049,-6
2019,7,VI,6,12,-6
2019,7,VT,32,29,3
2019,7,WA,407,429,-22
2019,7,WI,117,118,-1
2019,7,WV,148,155,-7
2019,7,WY,12,12,0
2019,8,AK,34,35,-1
2019,8,AL,820,831,-11
2019,8,AR,148,170,-22
2019,8,AZ,339,344,-5
2019,8,CA,3277,3241,36
2019,8,CO,265,280,-15
2019,8,CT,347,375,-28
2019,8,DC,29,30,-1
2019,8,DE,281,278,3
2019,8,FL,27274,28062,-788
2019,8,GA,1245,1359,-114
2019,8,HI,1288,1429,-141
2019,8,IA,191,192,-1
2019,8,ID,121,130,-9
2019,8,IL,413,425,-12
2019,8,IN,270,282,-12
2019,8,KS,124,129,-5
2019,8,KY,201,204,-3
2019,8,LA,7941,7974,-33
2019,8,MA,651,660,-9
2019,8,MD,1021,1097,-76
2019,8,ME,129,123,6
2019,8,MI,224,219,5
2019,8,MN,184,190,-6
2019,8,MO,275,284,-9
2019,8,MS,1043,1046,-3
2019,8,MT,101,106,-5
2019,8,NC,2560,2489,71
2019,8,ND,275,292,-17
2019,8,NE,81,82,-1
2019,8,NH,91,80,11
2019,8,NJ,2593,2688,-95
2019,8,NM,108,122,-14
2019,8,NV,136,147,-11
2019,8,NY,3074,3119,-45
2019,8,OH,339,378,-39
2019,8,OK,152,151,1
2019,8,OR,408,433,-25
2019,8,PA,836,886,-50
2019,8,PR,47,78,-31
2019,8,RI,338,347,-9
2019,8,SC,3219,3173,46
2019,8,SD,32,39,-7
2019,8,TN,460,534,-74
2019,8,TX,10489,10515,-26
2019,8,UT,72,74,-2
2019,8,VA,1404,1430,-26
2019,8,VI,11,15,-4
2019,8,VT,54,49,5
2019,8,WA,495,511,-16
2019,8,WI,157,152,5
2019,8,WV,144,153,-9
2019,8,WY,23,25,-2
2019,9,AK,25,23,2
2019,9,AL,427,432,-5
2019,9,AR,125,128,-3
2019,9,AZ,246,254,-8
2019,9,CA,2917,2837,80
2019,9,CO,241,246,-5
2019,9,CT,299,320,-21
2019,9,DC,23,21,2
2019,9,DE,220,217,3
2019,9,FL,21389,21653,-264
2019,9,GA,982,1034,-52
2019,9,HI,648,657,-9
2019,9,IA,184,175,9
2019,9,ID,121,140,-19
2019,9,IL,464,471,-7
2019,9,IN,218,214,4
2019,9,KS,115,118,-3
2019,9,KY,186,194,-8
2019,9,LA,6049,6084,-35
2019,9,MA,521,527,-6
2019,9,MD,559,573,-14
2019,9,ME,81,89,-8
2019,9,MI,153,159,-6
2019,9,MN,189,178,11
2019,9,MO,201,201,0
2019,9,MS,775,794,-19
2019,9,MT,66,73,-7
2019,9,NC,1658,1571,87
2019,9,ND,323,338,-15
2019,9,NE,73,68,5
2019,9,NH,73,69,4
2019,9,NJ,1843,1894,-51
2019,9,NM,114,120,-6
2019,9,NV,132,143,-11
2019,9,NY,2680,2731,-51
2019,9,OH,284,291,-7
2019,9,OK,121,132,-11
2019,9,OR,276,286,-10
2019,9,PA,677,702,-25
2019,9,PR,69,201,-132
2019,9,RI,120,128,-8
2019,9,SC,2188,2150,38
2019,9,SD,43,42,1
2019,9,TN,395,387,8
2019,9,TX,7752,7838,-86
2019,9,UT,62,68,-6
2019,9,VA,1120,1150,-30
2019,9,VI,10,22,-12
2019,9,VT,74,77,-3
2019,9,WA,452,470,-18
2019,9,WI,143,122,21
2019,9,WV,104,117,-13
2019,9,WY,24,20,4
2019,10,AK,15,20,-5
2019,10,AL,520,521,-1
2019,10,AR,138,140,-2
2019,10,AZ,288,289,-1
2019,10,CA,3650,3307,343
2019,10,CO,263,259,4
2019,10,CT,305,323,-18
2019,10,DC,28,26,2
2019,10,DE,256,251,5
2019,10,FL,21844,22094,-250
2019,10,GA,994,1080,-86
2019,10,HI,617,602,15
2019,10,IA,210,209,1
2019,10,ID,114,113,1
2019,10,IL,399,401,-2
2019,10,IN,287,297,-10
2019,10,KS,126,139,-13
2019,10,KY,225,225,0
2019,10,LA,6635,6719,-84
2019,10,MA,1006,1037,-31
2019,10,MD,531,550,-19
2019,10,ME,92,82,10
2019,10,MI,201,197,4
2019,10,MN,227,223,4
2019,10,MO,243,249,-6
2019,10,MS,950,963,-13
2019,10,MT,127,148,-21
2019,10,NC,1780,1718,62
2019,10,ND,456,460,-4
2019,10,NE,89,95,-6
2019,10,NH,119,119,0
2019,10,NJ,2228,2286,-58
2019,10,NM,90,98,-8
2019,10,NV,144,147,-3
2019,10,NY,2454,2496,-42
2019,10,OH,340,338,2
2019,10,OK,129,142,-13
2019,10,OR,301,299,2
2019,10,PA,696,723,-27
2019,10,PR,108,88,20
2019,10,RI,100,107,-7
2019,10,SC,3062,2971,91
2019,10,SD,66,60,6
2019,10,TN,419,436,-17
2019,10,TX,7759,7729,30
2019,10,UT,69,74,-5
2019,10,VA,1059,1121,-62
2019,10,VI,11,19,-8
2019,10,VT,44,47,-3
2019,10,WA,451,450,1
2019,10,WI,156,147,9
2019,10,WV,155,152,3
2019,10,WY,37,35,2
2019,11,AK,24,29,-5
2019,11,AL,544,561,-17
2019,11,AR,159,168,-9
2019,11,AZ,265,260,5
2019,11,CA,3644,3671,-27
2019,11,CO,225,238,-13
2019,11,CT,325,338,-13
2019,11,DC,23,25,-2
2019,11,DE,285,290,-5
2019,11,FL,20327,20755,-428
2019,11,GA,960,1003,-43
2019,11,HI,789,710,79
2019,11,IA,235,190,45
2019,11,ID,121,101,20
2019,11,IL,453,467,-14
2019,11,IN,293,294,-1
2019,11,KS,115,117,-2
2019,11,KY,190,200,-10
2019,11,LA,6514,6501,13
2019,11,MA,675,688,-13
2019,11,MD,1087,1090,-3
2019,11,ME,90,92,-2
2019,11,MI,240,263,-23
2019,11,MN,267,230,37
2019,11,MO,257,241,16
2019,11,MP,1,0,1
2019,11,MS,899,926,-27
2019,11,MT,116,140,-24
2019,11,NC,1669,1574,95
2019,11,ND,402,396,6
2019,11,NE,76,69,7
2019,11,NH,78,87,-9
2019,11,NJ,1813,1881,-68
2019,11,NM,108,109,-1
2019,11,NV,130,127,3
2019,11,NY,2069,2117,-48
2019,11,OH,334,363,-29
2019,11,OK,141,145,-4
2019,11,OR,293,294,-1
2019,11,PA,669,721,-52
2019,11,PR,41,69,-28
2019,11,RI,127,134,-7
2019,11,SC,2381,2351,30
2019,11,SD,83,64,19
2019,11,TN,471,422,49
2019,11,TX,8182,8272,-90
2019,11,UT,60,60,0
2019,11,VA,1569,1571,-2
2019,11,VI,36,56,-20
2019,11,VT,38,43,-5
2019,11,WA,358,344,14
2019,11,WI,166,157,9
2019,11,WV,128,137,-9
2019,11,WY,39,38,1
2019,12,AK,27,27,0
2019,12,AL,887,871,16
2019,12,AR,240,241,-1
2019,12,AZ,421,330,91
2019,12,CA,3499,3297,202
2019,12,CO,306,303,3
2019,12,CT,318,328,-10
2019,12,DC,20,28,-8
2019,12,DE,272,284,-12
2019,12,FL,25209,25649,-440
2019,12,GA,1277,1315,-38
2019,12,HI,610,613,-3
2019,12,IA,359,271,88
2019,12,ID,273,177,96
2019,12,IL,542,566,-24
2019,12,IN,268,290,-22
2019,12,KS,155,155,0
2019,12,KY,279,290,-11
2019,12,LA,8365,8339,26
2019,12,MA,569,587,-18
2019,12,MD,874,896,-22
2019,12,ME,108,100,8
2019,12,MI,269,280,-11
2019,12,MN,733,305,428
2019,12,MO,458,403,55
2019,12,MS,1223,1218,5
2019,12,MT,184,199,-15
2019,12,NC,2237,2154,83
2019,12,ND,620,458,162
2019,12,NE,125,116,9
2019,12,NH,115,119,-4
2019,12,NJ,2097,2153,-56
2019,12,NM,108,115,-7
2019,12,NV,152,153,-1
2019,12,NY,2292,2329,-37
2019,12,OH,423,431,-8
2019,12,OK,163,179,-16
2019,12,OR,276,274,2
2019,12,PA,796,838,-42
2019,12,PR,59,115,-56
2019,12,RI,130,140,-10
2019,12,SC,2957,2872,85
2019,12,SD,162,95,67
2019,12,TN,566,470,96
2019,12,TX,10553,10465,88
2019,12,UT,71,62,9
2019,12,VA,1588,1597,-9
2019,12,VI,8,18,-10
2019,12,VT,32,33,-1
2019,12,WA,449,463,-14
2019,12,WI,293,193,100
2019,12,WV,181,184,-3
2019,12,WY,42,35,7
2019,13,AK,24,28,-4
2019,13,AL,988,996,-8
2019,13,AR,208,214,-6
2019,13,AZ,342,337,5
2019,13,CA,2752,2422,330
2019,13,CO,313,292,21
2019,13,CT,361,383,-22
2019,13,DC,26,26,0
2019,13,DE,261,258,3
2019,13,FL,28266,28794,-528
2019,13,GA,1211,1244,-33
2019,13,HI,623,587,36
2019,13,IA,353,226,127
2019,13,ID,212,106,106
2019,13,IL,555,544,11
2019,13,IN,279,305,-26
2019,13,KS,126,124,2
2019,13,KY,252,261,-9
2019,13,LA,7617,7830,-213
2019,13,MA,484,528,-44
2019,13,MD,829,836,-7
2019,13,ME,121,107,14
2019,13,MI,214,219,-5
2019,13,MN,1376,344,1032
2019,13,MO,371,343,28
2019,13,MS,1018,1021,-3
2019,13,MT,221,184,37
2019,13,NC,2277,2171,106
2019,13,ND,631,405,226
2019,13,NE,156,145,11
2019,13,NH,87,85,2
2019,13,NJ,2850,2919,-69
2019,13,NM,143,119,24
2019,13,NV,116,105,11
2019,13,NY,2945,3018,-73
2019,13,OH,383,414,-31
2019,13,OK,155,163,-8
2019,13,OR,325,320,5
2019,13,PA,704,747,-43
2019,13,PR,53,246,-193
2019,13,RI,117,131,-14
2019,13,SC,3618,3442,176
2019,13,SD,198,65,133
2019,13,TN,445,411,34
2019,13,TX,9709,9621,88
2019,13,UT,95,75,20
2019,13,VA,1193,1184,9
2019,13,VI,8,12,-4
2019,13,VT,37,38,-1
2019,13,WA,383,398,-15
2019,13,WI,412,197,215
2019,13,WV,183,200,-17
2019,13,WY,49,47,2
2019,14,AK,30,34,-4
2019,14,AL,683,682,1
2019,14,AR,161,169,-8
2019,14,AZ,245,242,3
2019,14,CA,2497,2414,83
2019,14,CO,334,283,51
2019,14,CT,310,316,-6
2019,14,DC,20,20,0
2019,14,DE,263,263,0
2019,14,FL,22181,22588,-407
2019,14,GA,992,1020,-28
2019,14,HI,313,310,3
2019,14,IA,507,225,282
2019,14,ID,215,122,93
2019,14,IL,512,459,53
2019,14,IN,253,261,-8
2019,14,KS,177,145,32
2019,14,KY,204,213,-9
2019,14,LA,7852,7876,-24
2019,14,MA,652,652,0
2019,14,MD,608,622,-14
2019,14,ME,144,133,11
2019,14,MI,222,222,0
2019,14,MN,1787,297,1490
2019,14,MO,362,293,69
2019,14,MS,1085,1068,17
2019,14,MT,204,185,19
2019,14,NC,1699,1609,90
2019,14,ND,1068,354,714
2019,14,NE,136,85,51
2019,14,NH,78,75,3
2019,14,NJ,1737,1788,-51
2019,14,NM,85,89,-4
2019,14,NV,118,117,1
2019,14,NY,1882,1935,-53
2019,14,OH,364,374,-10
2019,14,OK,175,179,-4
2019,14,OR,271,265,6
2019,14,PA,714,741,-27
2019,14,PR,43,273,-230
2019,14,RI,157,163,-6
2019,14,SC,2388,2314,74
2019,14,SD,199,73,126
2019,14,TN,394,354,40
2019,14,TX,9291,9147,144
2019,14,UT,80,56,24
2019,14,VA,1061,1056,5
2019,14,VI,53,60,-7
2019,14,VT,44,48,-4
2019,14,WA,350,351,-1
2019,14,WI,558,219,339
2019,14,WV,154,156,-2
2019,14,WY,58,43,15
2019,15,AK,29,30,-1
2019,15,AL,2915,2930,-15
2019,15,AR,142,167,-25
2019,15,AZ,315,303,12
2019,15,CA,2655,2637,18
2019,15,CO,417,334,83
2019,15,CT,336,348,-12
2019,15,DC,29,30,-1
2019,15,DE,305,296,9
2019,15,FL,27448,27734,-286
2019,15,GA,1137,1187,-50
2019,15,HI,670,448,222
2019,15,IA,413,209,204
2019,15,ID,132,91,41
2019,15,IL,508,475,33
2019,15,IN,261,270,-9
2019,15,KS,185,142,43
2019,15,KY,199,226,-27
2019,15,LA,8814,8674,140
2019,15,MA,528,549,-21
2019,15,MD,640,626,14
2019,15,ME,132,97,35
2019,15,MI,221,206,15
2019,15,MN,426,176,250
2019,15,MO,409,304,105
2019,15,MS,1085,1075,10
2019,15,MT,139,141,-2
2019,15,NC,2075,1973,102
2019,15,ND,465,236,229
2019,15,NE,198,94,104
2019,15,NH,71,80,-9
2019,15,NJ,2359,2408,-49
2019,15,NM,109,131,-22
2019,15,NV,127,121,6
2019,15,NY,2056,2082,-26
2019,15,OH,335,357,-22
2019,15,OK,194,187,7
2019,15,OR,271,273,-2
2019,15,PA,601,601,0
2019,15,PR,42,139,-97
2019,15,RI,97,100,-3
2019,15,SC,2966,2852,114
2019,15,SD,106,53,53
2019,15,TN,420,407,13
2019,15,TX,9865,9662,203
2019,15,UT,114,68,46
2019,15,VA,1355,1334,21
2019,15,VI,12,21,-9
2019,15,VT,48,48,0
2019,15,WA,385,407,-22
2019,15,WI,272,183,89
2019,15,WV,126,130,-4
2019,15,WY,66,40,26
2019,16,AK,32,30,2
2019,16,AL,815,818,-3
2019,16,AR,137,125,12
2019,16,AZ,276,285,-9
2019,16,CA,2435,2410,25
2019,16,CO,478,413,65
2019,16,CT,290,312,-22
2019,16,DC,24,20,4
2019,16,DE,317,311,6
2019,16,FL,26545,26732,-187
2019,16,GA,1076,1099,-23
2019,16,HI,1260,1261,-1
2019,16,IA,278,176,102
2019,16,ID,114,87,27
2019,16,IL,530,468,62
2019,16,IN,256,264,-8
2019,16,KS,213,155,58
2019,16,KY,209,221,-12
2019,16,LA,9253,9044,209
2019,16,MA,500,521,-21
2019,16,MD,657,642,15
2019,16,ME,125,124,1
2019,16,MI,233,226,7
2019,16,MN,192,156,36
2019,16,MO,459,333,126
2019,16,MS,1231,1224,7
2019,16,MT,136,127,9
2019,16,NC,2006,1846,160
2019,16,ND,185,166,19
2019,16,NE,186,112,74
2019,16,NH,69,70,-1
2019,16,NJ,1939,1984,-45
2019,16,NM,105,103,2
2019,16,NV,106,112,-6
2019,16,NY,2541,2640,-99
2019,16,OH,358,405,-47
2019,16,OK,156,161,-5
2019,16,OR,255,274,-19
2019,16,PA,648,673,-25
2019,16,PR,42,91,-49
2019,16,RI,121,131,-10
2019,16,SC,2614,2526,88
2019,16,SD,94,53,41
2019,16,TN,398,378,20
2019,16,TX,11260,11070,190
2019,16,UT,73,52,21
2019,16,VA,1259,1261,-2
2019,16,VI,14,19,-5
2019,16,VT,41,42,-1
2019,16,WA,377,379,-2
2019,16,WI,190,152,38
2019,16,WV,145,152,-7
2019,16,WY,61,43,18
2019,17,AK,37,40,-3
2019,17,AL,1467,1477,-10
2019,17,AR,165,174,-9
2019,17,AZ,402,387,15
2019,17,CA,2556,2424,132
2019,17,CO,460,424,36
2019,17,CT,380,385,-5
2019,17,DC,29,31,-2
2019,17,DE,343,336,7
2019,17,FL,39097,39696,-599
2019,17,GA,1439,1479,-40
2019,17,HI,2051,1989,62
2019,17,IA,218,174,44
2019,17,ID,390,382,8
2019,17,IL,574,537,37
2019,17,IN,264,275,-11
2019,17,KS,166,160,6
2019,17,KY,207,217,-10
2019,17,LA,10793,10791,2
2019,17,MA,606,624,-18
2019,17,MD,663,686,-23
2019,17,ME,103,106,-3
2019,17,MI,205,197,8
2019,17,MN,140,134,6
2019,17,MO,334,298,36
2019,17,MS,1434,1448,-14
2019,17,MT,99,121,-22
2019,17,NC,2611,2513,98
2019,17,ND,124,128,-4
2019,17,NE,161,112,49
2019,17,NH,72,72,0
2019,17,NJ,3095,3159,-64
2019,17,NM,129,121,8
2019,17,NV,120,116,4
2019,17,NY,2638,2673,-35
2019,17,OH,355,373,-18
2019,17,OK,191,193,-2
2019,17,OR,599,616,-17
2019,17,PA,721,770,-49
2019,17,PR,57,86,-29
2019,17,RI,123,134,-11
2019,17,SC,4283,4025,258
2019,17,SD,68,51,17
2019,17,TN,387,377,10
2019,17,TX,14833,14597,236
2019,17,UT,179,162,17
2019,17,VA,1621,1619,2
2019,17,VI,6,11,-5
2019,17,VT,46,45,1
2019,17,WA,453,479,-26
2019,17,WI,163,149,14
2019,17,WV,121,129,-8
2019,17,WY,49,44,5
2019,18,AK,25,27,-2
2019,18,AL,583,583,0
2019,18,AR,145,141,4
2019,18,AZ,263,271,-8
2019,18,CA,2242,2039,203
2019,18,CO,350,376,-26
2019,18,CT,282,285,-3
2019,18,DC,22,20,2
2019,18,DE,287,288,-1
2019,18,FL,27626,27686,-60
2019,18,GA,1098,1121,-23
2019,18,HI,346,348,-2
2019,18,IA,179,127,52
2019,18,ID,117,101,16
2019,18,IL,510,494,16
2019,18,IN,212,231,-19
2019,18,KS,143,118,25
2019,18,KY,201,213,-12
2019,18,LA,8482,8339,143
2019,18,MA,714,616,98
2019,18,MD,611,637,-26
2019,18,ME,74,72,2
2019,18,MI,184,174,10
2019,18,MN,110,108,2
2019,18,MO,223,206,17
2019,18,MS,1194,1178,16
2019,18,MT,119,158,-39
2019,18,NC,1910,1793,117
2019,18,ND,81,79,2
2019,18,NE,114,82,32
2019,18,NH,78,76,2
2019,18,NJ,1905,1939,-34
2019,18,NM,97,99,-2
2019,18,NV,89,97,-8
2019,18,NY,2571,2601,-30
2019,18,OH,262,285,-23
2019,18,OK,200,204,-4
2019,18,OR,244,229,15
2019,18,PA,570,617,-47
2019,18,PR,40,357,-317
2019,18,RI,180,186,-6
2019,18,SC,2603,2486,117
2019,18,SD,60,41,19
2019,18,TN,330,308,22
2019,18,TX,12087,11790,297
2019,18,UT,71,56,15
2019,18,VA,1231,1202,29
2019,18,VI,18,20,-2
2019,18,VT,34,38,-4
2019,18,WA,361,376,-15
2019,18,WI,156,138,18
2019,18,WV,135,138,-3
2019,18,WY,35,36,-1
2019,19,AK,34,36,-2
2019,19,AL,750,749,1
2019,19,AR,123,134,-11
2019,19,AZ,341,344,-3
2019,19,CA,2144,2109,35
2019,19,CO,354,351,3
2019,19,CT,314,321,-7
2019,19,DC,21,21,0
2019,19,DE,322,332,-10
2019,19,FL,26540,27062,-522
2019,19,GA,1565,1326,239
2019,19,HI,1144,1143,1
2019,19,IA,170,150,20
2019,19,ID,105,99,6
2019,19,IL,518,509,9
2019,19,IN,203,215,-12
2019,19,KS,149,123,26
2019,19,KY,208,214,-6
2019,19,LA,9102,8969,133
2019,19,MA,511,524,-13
2019,19,MD,545,559,-14
2019,19,ME,72,79,-7
2019,19,MI,227,229,-2
2019,19,MN,122,117,5
2019,19,MO,247,232,15
2019,19,MS,1275,1240,35
2019,19,MT,87,120,-33
2019,19,NC,2418,2253,165
2019,19,ND,87,94,-7
2019,19,NE,112,77,35
2019,19,NH,68,68,0
2019,19,NJ,2111,2201,-90
2019,19,NM,91,92,-1
2019,19,NV,104,102,2
2019,19,NY,2416,2452,-36
2019,19,OH,293,310,-17
2019,19,OK,208,195,13
2019,19,OR,257,264,-7
2019,19,PA,665,689,-24
2019,19,PR,83,88,-5
2019,19,RI,118,117,1
2019,19,SC,3386,3327,59
2019,19,SD,49,46,3
2019,19,TN,361,367,-6
2019,19,TX,13197,12907,290
2019,19,UT,69,55,14
2019,19,VA,1490,1489,1
2019,19,VI,11,18,-7
2019,19,VT,40,40,0
2019,19,WA,328,355,-27
2019,19,WI,129,111,18
2019,19,WV,114,119,-5
2019,19,WY,38,37,1
2019,20,AK,36,35,1
2019,20,AL,991,985,6
2019,20,AR,149,151,-2
2019,20,AZ,323,326,-3
2019,20,CA,2024,1986,38
2019,20,CO,440,438,2
2019,20,CT,332,348,-16
2019,20,DC,25,20,5
2019,20,DE,315,313,2
2019,20,FL,27807,28400,-593
2019,20,GA,1314,1350,-36
2019,20,HI,763,780,-17
2019,20,IA,232,208,24
2019,20,ID,95,99,-4
2019,20,IL,416,415,1
2019,20,IN,211,214,-3
2019,20,KS,147,134,13
2019,20,KY,265,283,-18
2019,20,LA,9572,9546,26
2019,20,MA,557,577,-20
2019,20,MD,601,627,-26
2019,20,ME,81,79,2
2019,20,MI,182,180,2
2019,20,MN,91,103,-12
2019,20,MO,265,238,27
2019,20,MS,1158,1170,-12
2019,20,MT,87,128,-41
2019,20,NC,2300,2179,121
2019,20,ND,74,81,-7
2019,20,NE,97,80,17
2019,20,NH,62,59,3
2019,20,NJ,2418,2462,-44
2019,20,NM,116,113,3
2019,20,NV,193,203,-10
2019,20,NY,2722,2685,37
2019,20,OH,267,298,-31
2019,20,OK,184,183,1
2019,20,OR,272,276,-4
2019,20,PA,779,815,-36
2019,20,PR,62,96,-34
2019,20,RI,134,145,-11
2019,20,SC,3502,3431,71
2019,20,SD,42,46,-4
2019,20,TN,382,373,9
2019,20,TX,15845,16022,-177
2019,20,UT,55,52,3
2019,20,VA,1406,1374,32
2019,20,VI,15,20,-5
2019,20,VT,28,26,2
2019,20,WA,333,357,-24
2019,20,WI,172,175,-3
2019,20,WV,109,116,-7
2019,20,WY,34,34,0
2019,21,AK,22,24,-2
2019,21,AL,1355,1352,3
2019,21,AR,203,195,8
2019,21,AZ,346,351,-5
2019,21,CA,2299,2215,84
2019,21,CO,445,354,91
2019,21,CT,444,459,-15
2019,21,DC,31,30,1
2019,21,DE,502,495,7
2019,21,FL,40388,40765,-377
2019,21,GA,1523,1627,-104
2019,21,HI,1157,1086,71
2019,21,IA,203,182,21
2019,21,ID,69,71,-2
2019,21,IL,507,461,46
2019,21,IN,232,238,-6
2019,21,KS,191,158,33
2019,21,KY,244,247,-3
2019,21,LA,12243,12242,1
2019,21,MA,680,694,-14
2019,21,MD,806,817,-11
2019,21,ME,95,99,-4
2019,21,MI,262,193,69
2019,21,MN,122,132,-10
2019,21,MO,302,297,5
2019,21,MS,1505,1550,-45
2019,21,MT,79,108,-29
2019,21,NC,2645,2460,185
2019,21,ND,85,89,-4
2019,21,NE,140,142,-2
2019,21,NH,94,96,-2
2019,21,NJ,2856,2891,-35
2019,21,NM,105,99,6
2019,21,NV,94,86,8
2019,21,NY,2599,2780,-181
2019,21,OH,343,357,-14
2019,21,OK,186,182,4
2019,21,OR,429,433,-4
2019,21,PA,746,747,-1
2019,21,PR,41,74,-33
2019,21,RI,169,180,-11
2019,21,SC,4071,3986,85
2019,21,SD,58,59,-1
2019,21,TN,484,533,-49
2019,21,TX,19208,18904,304
2019,21,UT,88,79,9
2019,21,VA,1899,1927,-28
2019,21,VI,11,16,-5
2019,21,VT,26,26,0
2019,21,WA,420,434,-14
2019,21,WI,187,165,22
2019,21,WV,156,155,1
2019,21,WY,37,39,-2
2019,22,AK,33,40,-7
2019,22,AL,1059,1041,18
2019,22,AR,250,254,-4
2019,22,AZ,274,268,6
2019,22,CA,2039,1961,78
2019,22,CO,348,329,19
2019,22,CT,280,294,-14
2019,22,DC,264,262,2
2019,22,DE,385,389,-4
2019,22,FL,27607,27678,-71
2019,22,GA,1629,1626,3
2019,22,HI,548,508,40
2019,22,IA,180,170,10
2019,22,ID,99,106,-7
2019,22,IL,418,375,43
2019,22,IN,224,230,-6
2019,22,KS,190,125,65
2019,22,KY,238,232,6
2019,22,LA,10412,10251,161
2019,22,MA,601,615,-14
2019,22,MD,813,831,-18
2019,22,ME,70,81,-11
2019,22,MI,219,154,65
2019,22,MN,91,92,-1
2019,22,MO,258,242,16
2019,22,MS,1444,1442,2
2019,22,MT,60,83,-23
2019,22,NC,2502,2339,163
2019,22,ND,90,95,-5
2019,22,NE,120,103,17
2019,22,NH,81,77,4
2019,22,NJ,2533,2553,-20
2019,22,NM,89,85,4
2019,22,NV,107,114,-7
2019,22,NY,2325,2404,-79
2019,22,OH,297,325,-28
2019,22,OK,243,248,-5
2019,22,OR,345,269,76
2019,22,PA,555,581,-26
2019,22,PR,49,88,-39
2019,22,RI,123,125,-2
2019,22,SC,3395,3455,-60
2019,22,SD,71,77,-6
2019,22,TN,619,621,-2
2019,22,TX,20585,16437,4148
2019,22,UT,65,64,1
2019,22,VA,1445,1451,-6
2019,22,VI,11,16,-5
2019,22,VT,33,31,2
2019,22,WA,437,313,124
2019,22,WI,136,133,3
2019,22,WV,106,110,-4
2019,22,WY,25,28,-3
2019,23,AK,28,28,0
2019,23,AL,875,861,14
2019,23,AR,190,198,-8
2019,23,AZ,349,376,-27
2019,23,CA,2148,2123,25
2019,23,CO,421,387,34
2019,23,CT,393,393,0
2019,23,DC,20,19,1
2019,23,DE,332,325,7
2019,23,FL,31842,32105,-263
2019,23,GA,1404,1453,-49
2019,23,HI,1212,1125,87
2019,23,IA,150,140,10
2019,23,ID,75,72,3
2019,23,IL,552,556,-4
2019,23,IN,242,252,-10
2019,23,KS,245,163,82
2019,23,KY,259,260,-1
2019,23,LA,11435,11133,302
2019,23,MA,700,713,-13
2019,23,MD,711,727,-16
2019,23,ME,77,74,3
2019,23,MI,227,212,15
2019,23,MN,106,113,-7
2019,23,MO,285,282,3
2019,23,MS,1305,1287,18
2019,23,MT,75,88,-13
2019,23,NC,2488,2287,201
2019,23,ND,98,110,-12
2019,23,NE,114,90,24
2019,23,NH,104,105,-1
2019,23,NJ,2248,2147,101
2019,23,NM,107,103,4
2019,23,NV,95,102,-7
2019,23,NY,2429,2526,-97
2019,23,OH,378,357,21
2019,23,OK,200,189,11
2019,23,OR,279,285,-6
2019,23,PA,613,642,-29
2019,23,PR,54,81,-27
2019,23,RI,156,167,-11
2019,23,SC,3786,3650,136
2019,23,SD,44,50,-6
2019,23,TN,523,526,-3
2019,23,TX,21516,18279,3237
2019,23,UT,42,45,-3
2019,23,VA,1693,1665,28
2019,23,VI,20,24,-4
2019,23,VT,33,34,-1
2019,23,WA,310,334,-24
2019,23,WI,189,198,-9
2019,23,WV,127,130,-3
2019,23,WY,32,38,-6
2019,24,AK,24,26,-2
2019,24,AL,799,808,-9
2019,24,AR,180,189,-9
2019,24,AZ,310,318,-8
2019,24,CA,1971,1883,88
2019,24,CO,552,519,33
2019,24,CT,356,367,-11
2019,24,DC,39,40,-1
2019,24,DE,349,335,14
2019,24,FL,31543,31829,-286
2019,24,GA,1459,1549,-90
2019,24,HI,377,378,-1
2019,24,IA,157,141,16
2019,24,ID,67,61,6
2019,24,IL,379,382,-3
2019,24,IN,248,247,1
2019,24,KS,378,143,235
2019,24,KY,204,214,-10
2019,24,LA,11429,11092,337
2019,24,MA,683,713,-30
2019,24,MD,803,837,-34
2019,24,ME,76,84,-8
2019,24,MI,227,193,34
2019,24,MN,100,98,2
2019,24,MO,281,266,15
2019,24,MS,1502,1497,5
2019,24,MT,72,77,-5
2019,24,NC,2920,2721,199
2019,24,ND,73,79,-6
2019,24,NE,105,93,12
2019,24,NH,75,73,2
2019,24,NJ,2637,2656,-19
2019,24,NM,118,115,3
2019,24,NV,88,89,-1
2019,24,NY,2720,2708,12
2019,24,OH,358,357,1
2019,24,OK,371,212,159
2019,24,OR,229,241,-12
2019,24,PA,643,679,-36
2019,24,PR,153,77,76
2019,24,RI,171,187,-16
2019,24,SC,4112,3975,137
2019,24,SD,39,38,1
2019,24,TN,555,564,-9
2019,24,TX,21256,19657,1599
2019,24,UT,50,42,8
2019,24,VA,1925,1905,20
2019,24,VI,98,104,-6
2019,24,VT,25,26,-1
2019,24,WA,355,378,-23
2019,24,WI,101,93,8
2019,24,WV,115,125,-10
2019,24,WY,32,31,1
2019,25,AK,28,28,0
2019,25,AL,890,896,-6
2019,25,AR,226,183,43
2019,25,AZ,363,374,-11
2019,25,CA,2006,1982,24
2019,25,CO,332,310,22
2019,25,CT,401,420,-19
2019,25,DC,30,31,-1
2019,25,DE,368,371,-3
2019,25,FL,37235,37606,-371
2019,25,GA,1608,1757,-149
2019,25,HI,2653,2637,16
2019,25,IA,170,148,22
2019,25,ID,72,74,-2
2019,25,IL,538,503,35
2019,25,IN,241,245,-4
2019,25,KS,214,136,78
2019,25,KY,167,173,-6
2019,25,LA,13027,12548,479
2019,25,MA,845,861,-16
2019,25,MD,1083,1108,-25
2019,25,ME,82,90,-8
2019,25,MI,239,213,26
2019,25,MN,105,117,-12
2019,25,MO,292,261,31
2019,25,MS,1306,1309,-3
2019,25,MT,151,154,-3
2019,25,NC,2972,2725,247
2019,25,ND,163,175,-12
2019,25,NE,138,110,28
2019,25,NH,62,72,-10
2019,25,NJ,2683,2735,-52
2019,25,NM,105,108,-3
2019,25,NV,103,109,-6
2019,25,NY,3077,3004,73
2019,25,OH,373,374,-1
2019,25,OK,385,181,204
2019,25,OR,203,215,-12
2019,25,PA,641,651,-10
2019,25,PR,35,78,-43
2019,25,RI,156,162,-6
2019,25,SC,4661,4482,179
2019,25,SD,76,70,6
2019,25,TN,495,493,2
2019,25,TX,24796,24085,711
2019,25,UT,55,50,5
2019,25,VA,2125,2152,-27
2019,25,VI,9,13,-4
2019,25,VT,42,38,4
2019,25,WA,287,310,-23
2019,25,WI,120,111,9
2019,25,WV,121,130,-9
2019,25,WY,16,16,0
2019,26,AK,25,25,0
2019,26,AL,1034,1032,2
2019,26,AR,221,183,38
2019,26,AZ,347,362,-15
2019,26,CA,2048,1976,72
2019,26,CO,360,327,33
2019,26,CT,471,488,-17
2019,26,DC,59,58,1
2019,26,DE,580,574,6
2019,26,FL,40361,40220,141
2019,26,GA,2061,2101,-40
2019,26,HI,1323,1139,184
2019,26,IA,301,287,14
2019,26,ID,72,57,15
2019,26,IL,1125,1050,75
2019,26,IN,254,268,-14
2019,26,KS,176,153,23
2019,26,KY,187,191,-4
2019,26,LA,15052,13688,1364
2019,26,MA,705,725,-20
2019,26,MD,1596,1610,-14
2019,26,ME,103,113,-10
2019,26,MI,237,198,39
2019,26,MN,91,88,3
2019,26,MO,325,273,52
2019,26,MS,1558,1567,-9
2019,26,MT,70,73,-3
2019,26,NC,3192,2733,459
2019,26,ND,147,151,-4
2019,26,NE,171,157,14
2019,26,NH,90,89,1
2019,26,NJ,2718,2767,-49
2019,26,NM,117,120,-3
2019,26,NV,107,114,-7
2019,26,NY,2711,2852,-141
2019,26,OH,404,419,-15
2019,26,OK,284,212,72
2019,26,OR,269,280,-11
2019,26,PA,718,732,-14
2019,26,PR,54,76,-22
2019,26,RI,192,198,-6
2019,26,SC,4834,4554,280
2019,26,SD,87,82,5
2019,26,TN,418,431,-13
2019,26,TX,33648,31334,2314
2019,26,UT,49,47,2
2019,26,VA,2541,2500,41
2019,26,VI,10,8,2
2019,26,VT,32,30,2
2019,26,WA,342,327,15
2019,26,WI,161,149,12
2019,26,WV,149,154,-5
2019,26,WY,25,25,0
2019,27,AK,23,24,-1
2019,27,AL,826,807,19
2019,27,AR,156,146,10
2019,27,AZ,408,420,-12
2019,27,CA,2114,2087,27
2019,27,CO,310,308,2
2019,27,CT,398,397,1
2019,27,DC,31,28,3
2019,27,DE,332,331,1
2019,27,FL,32049,32200,-151
2019,27,GA,1727,1761,-34
2019,27,HI,473,463,10
2019,27,IA,186,184,2
2019,27,ID,52,55,-3
2019,27,IL,674,426,248
2019,27,IN,315,325,-10
2019,27,KS,161,139,22
2019,27,KY,205,217,-12
2019,27,LA,12294,11263,1031
2019,27,MA,561,580,-19
2019,27,MD,866,859,7
2019,27,ME,104,107,-3
2019,27,MI,253,210,43
2019,27,MN,94,101,-7
2019,27,MO,258,235,23
2019,27,MS,1293,1275,18
2019,27,MT,52,57,-5
2019,27,NC,2825,2476,349
2019,27,ND,63,75,-12
2019,27,NE,101,105,-4
2019,27,NH,68,66,2
2019,27,NJ,3256,3315,-59
2019,27,NM,119,122,-3
2019,27,NV,85,98,-13
2019,27,NY,2702,2604,98
2019,27,OH,334,341,-7
2019,27,OK,224,199,25
2019,27,OR,246,249,-3
2019,27,PA,589,615,-26
2019,27,PR,135,100,35
2019,27,RI,182,185,-3
2019,27,SC,3885,3639,246
2019,27,SD,28,29,-1
2019,27,TN,499,410,89
2019,27,TX,25166,24370,796
2019,27,UT,41,42,-1
2019,27,VA,2021,1956,65
2019,27,VI,10,14,-4
2019,27,VT,34,34,0
2019,27,WA,311,321,-10
2019,27,WI,136,125,11
2019,27,WV,118,120,-2
2019,27,WY,27,25,2
2019,28,AK,31,31,0
2019,28,AL,763,749,14
2019,28,AR,172,162,10
2019,28,AZ,430,440,-10
2019,28,CA,2108,2092,16
2019,28,CO,333,336,-3
2019,28,CT,448,464,-16
2019,28,DC,33,34,-1
2019,28,DE,334,334,0
2019,28,FL,33022,32832,190
2019,28,GA,1677,1753,-76
2019,28,HI,843,836,7
2019,28,IA,182,196,-14
2019,28,ID,54,58,-4
2019,28,IL,418,400,18
2019,28,IN,328,326,2
2019,28,KS,159,156,3
2019,28,KY,195,190,5
2019,28,LA,12180,11951,229
2019,28,MA,831,845,-14
2019,28,MD,1110,1144,-34
2019,28,ME,102,101,1
2019,28,MI,260,226,34
2019,28,MN,115,136,-21
2019,28,MO,244,242,2
2019,28,MS,1357,1354,3
2019,28,MT,77,93,-16
2019,28,NC,3246,2934,312
2019,28,ND,83,94,-11
2019,28,NE,120,116,4
2019,28,NH,131,129,2
2019,28,NJ,3025,3052,-27
2019,28,NM,128,125,3
2019,28,NV,101,97,4
2019,28,NY,2636,2700,-64
2019,28,OH,426,395,31
2019,28,OK,245,202,43
2019,28,OR,269,267,2
2019,28,PA,666,674,-8
2019,28,PR,39,58,-19
2019,28,RI,168,168,0
2019,28,SC,4091,3891,200
2019,28,SD,36,40,-4
2019,28,TN,431,391,40
2019,28,TX,25273,25417,-144
2019,28,UT,64,58,6
2019,28,VA,2179,2130,49
2019,28,VI,4,8,-4
2019,28,VT,50,49,1
2019,28,WA,360,367,-7
2019,28,WI,176,179,-3
2019,28,WV,125,133,-8
2019,28,WY,22,23,-1
2019,29,AK,32,32,0
2019,29,AL,779,791,-12
2019,29,AR,173,176,-3
2019,29,AZ,376,388,-12
2019,29,CA,2044,2077,-33
2019,29,CO,290,309,-19
2019,29,CT,428,443,-15
2019,29,DC,33,103,-70
2019,29,DE,354,341,13
2019,29,FL,30952,31101,-149
2019,29,GA,1738,1768,-30
2019,29,HI,366,368,-2
2019,29,IA,220,221,-1
2019,29,ID,55,55,0
2019,29,IL,539,551,-12
2019,29,IN,286,304,-18
2019,29,KS,142,126,16
2019,29,KY,243,241,2
2019,29,LA,10839,10645,194
2019,29,MA,735,755,-20
2019,29,MD,1021,1035,-14
2019,29,ME,111,117,-6
2019,29,MI,233,201,32
2019,29,MN,144,155,-11
2019,29,MO,242,234,8
2019,29,MS,1109,1125,-16
2019,29,MT,56,59,-3
2019,29,NC,2712,2500,212
2019,29,ND,95,101,-6
2019,29,NE,88,84,4
2019,29,NH,81,90,-9
2019,29,NJ,2262,2288,-26
2019,29,NM,123,130,-7
2019,29,NV,104,103,1
2019,29,NY,2804,2835,-31
2019,29,OH,402,403,-1
2019,29,OK,249,220,29
2019,29,OR,247,257,-10
2019,29,PA,667,669,-2
2019,29,PR,41,65,-24
2019,29,RI,192,200,-8
2019,29,SC,3766,3613,153
2019,29,SD,46,56,-10
2019,29,TN,402,377,25
2019,29,TX,22221,21755,466
2019,29,UT,35,40,-5
2019,29,VA,2184,2176,8
2019,29,VI,7,10,-3
2019,29,VT,35,34,1
2019,29,WA,330,328,2
2019,29,WI,166,163,3
2019,29,WV,138,140,-2
2019,29,WY,22,22,0
2019,30,AK,49,48,1
2019,30,AL,1172,1194,-22
2019,30,AR,168,155,13
2019,30,AZ,388,402,-14
2019,30,CA,2100,2107,-7
2019,30,CO,297,294,3
2019,30,CT,434,458,-24
2019,30,DC,38,38,0
2019,30,DE,346,347,-1
2019,30,FL,32437,32993,-556
2019,30,GA,1776,1825,-49
2019,30,HI,1006,834,172
2019,30,IA,180,188,-8
2019,30,ID,49,52,-3
2019,30,IL,718,751,-33
2019,30,IN,276,281,-5
2019,30,KS,146,157,-11
2019,30,KY,185,223,-38
2019,30,LA,10873,10808,65
2019,30,MA,788,816,-28
2019,30,MD,978,993,-15
2019,30,ME,103,104,-1
2019,30,MI,195,187,8
2019,30,MN,122,122,0
2019,30,MO,275,271,4
2019,30,MS,1263,1279,-16
2019,30,MT,48,51,-3
2019,30,NC,2870,2723,147
2019,30,ND,75,82,-7
2019,30,NE,129,115,14
2019,30,NH,88,85,3
2019,30,NJ,3013,3062,-49
2019,30,NM,148,154,-6
2019,30,NV,122,137,-15
2019,30,NY,2576,2622,-46
2019,30,OH,353,365,-12
2019,30,OK,196,185,11
2019,30,OR,232,257,-25
2019,30,PA,798,765,33
2019,30,PR,59,68,-9
2019,30,RI,220,227,-7
2019,30,SC,4180,4273,-93
2019,30,SD,30,29,1
2019,30,TN,457,438,19
2019,30,TX,19330,18743,587
2019,30,UT,55,60,-5
2019,30,VA,2188,2224,-36
2019,30,VI,12,12,0
2019,30,VT,36,39,-3
2019,30,WA,354,352,2
2019,30,WI,179,165,14
2019,30,WV,127,136,-9
2019,30,WY,19,15,4
2019,31,AK,29,28,1
2019,31,AL,715,677,38
2019,31,AR,180,169,11
2019,31,AZ,452,477,-25
2019,31,CA,2163,2089,74
2019,31,CO,309,360,-51
2019,31,CT,481,486,-5
2019,31,DC,50,31,19
2019,31,DE,341,333,8
2019,31,FL,28187,27728,459
2019,31,GA,1750,1732,18
2019,31,HI,876,878,-2
2019,31,IA,301,314,-13
2019,31,ID,71,64,7
2019,31,IL,358,344,14
2019,31,IN,289,291,-2
2019,31,KS,126,126,0
2019,31,KY,203,210,-7
2019,31,LA,11410,9360,2050
2019,31,MA,681,691,-10
2019,31,MD,779,728,51
2019,31,ME,90,95,-5
2019,31,MI,204,181,23
2019,31,MN,96,90,6
2019,31,MO,205,193,12
2019,31,MS,1116,1088,28
2019,31,MT,45,45,0
2019,31,NC,2798,2519,279
2019,31,ND,74,74,0
2019,31,NE,96,85,11
2019,31,NH,66,74,-8
2019,31,NJ,2570,2340,230
2019,31,NM,168,175,-7
2019,31,NV,133,131,2
2019,31,NY,2550,2527,23
2019,31,OH,383,373,10
2019,31,OK,220,204,16
2019,31,OR,214,213,1
2019,31,PA,670,680,-10
2019,31,PR,49,138,-89
2019,31,RI,213,211,2
2019,31,SC,3772,3603,169
2019,31,SD,57,51,6
2019,31,TN,415,400,15
2019,31,TX,19897,17884,2013
2019,31,UT,42,44,-2
2019,31,VA,2233,2051,182
2019,31,VI,8,6,2
2019,31,VT,40,36,4
2019,31,WA,343,339,4
2019,31,WI,140,128,12
2019,31,WV,137,143,-6
2019,31,WY,27,30,-3
2019,32,AK,28,29,-1
2019,32,AL,733,733,0
2019,32,AR,169,163,6
2019,32,AZ,456,464,-8
2019,32,CA,2109,2079,30
2019,32,CO,321,352,-31
2019,32,CT,438,451,-13
2019,32,DC,48,38,10
2019,32,DE,425,416,9
2019,32,FL,30502,29939,563
2019,32,GA,2008,2013,-5
2019,32,HI,1336,1318,18
2019,32,IA,169,173,-4
2019,32,ID,70,66,4
2019,32,IL,381,396,-15
2019,32,IN,270,271,-1
2019,32,KS,124,117,7
2019,32,KY,244,241,3
2019,32,LA,11205,9487,1718
2019,32,MA,753,759,-6
2019,32,MD,881,856,25
2019,32,ME,104,135,-31
2019,32,MI,232,231,1
2019,32,MN,119,121,-2
2019,32,MO,235,208,27
2019,32,MS,1068,1053,15
2019,32,MT,47,51,-4
2019,32,NC,3244,2937,307
2019,32,ND,107,121,-14
2019,32,NE,104,90,14
2019,32,NH,64,74,-10
2019,32,NJ,3619,3653,-34
2019,32,NM,155,174,-19
2019,32,NV,110,119,-9
2019,32,NY,2577,2659,-82
2019,32,OH,417,409,8
2019,32,OK,202,190,12
2019,32,OR,338,338,0
2019,32,PA,760,764,-4
2019,32,PR,45,60,-15
2019,32,RI,451,457,-6
2019,32,SC,4383,4083,300
2019,32,SD,31,35,-4
2019,32,TN,449,415,34
2019,32,TX,21205,20217,988
2019,32,UT,53,50,3
2019,32,VA,2108,1953,155
2019,32,VI,19,16,3
2019,32,VT,38,37,1
2019,32,WA,376,360,16
2019,32,WI,148,154,-6
2019,32,WV,156,166,-10
2019,32,WY,17,18,-1
2019,33,AK,20,20,0
2019,33,AL,920,915,5
2019,33,AR,186,173,13
2019,33,AZ,693,429,264
2019,33,CA,2171,2193,-22
2019,33,CO,301,323,-22
2019,33,CT,631,641,-10
2019,33,DC,27,24,3
2019,33,DE,342,336,6
2019,33,FL,27651,27481,170
2019,33,GA,1564,1597,-33
2019,33,HI,2597,2592,5
2019,33,IA,170,172,-2
2019,33,ID,43,45,-2
2019,33,IL,551,569,-18
2019,33,IN,218,256,-38
2019,33,KS,103,109,-6
2019,33,KY,191,211,-20
2019,33,LA,10089,9375,714
2019,33,MA,941,966,-25
2019,33,MD,902,926,-24
2019,33,ME,114,126,-12
2019,33,MI,205,190,15
2019,33,MN,103,109,-6
2019,33,MO,233,218,15
2019,33,MS,1097,1132,-35
2019,33,MT,52,55,-3
2019,33,NC,2778,2625,153
2019,33,ND,108,113,-5
2019,33,NE,88,88,0
2019,33,NH,72,71,1
2019,33,NJ,2770,2787,-17
2019,33,NM,151,160,-9
2019,33,NV,142,150,-8
2019,33,NY,3159,3056,103
2019,33,OH,392,385,7
2019,33,OK,161,159,2
2019,33,OR,316,326,-10
2019,33,PA,1005,1019,-14
2019,33,PR,46,65,-19
2019,33,RI,232,237,-5
2019,33,SC,4083,3955,128
2019,33,SD,53,55,-2
2019,33,TN,486,481,5
2019,33,TX,15408,15181,227
2019,33,UT,42,47,-5
2019,33,VA,2120,2026,94
2019,33,VI,19,19,0
2019,33,VT,32,36,-4
2019,33,WA,334,338,-4
2019,33,WI,156,151,5
2019,33,WV,129,142,-13
2019,33,WY,28,37,-9
2019,34,AK,37,39,-2
2019,34,AL,904,916,-12
2019,34,AR,197,192,5
2019,34,AZ,654,440,214
2019,34,CA,2308,2294,14
2019,34,CO,380,466,-86
2019,34,CT,552,575,-23
2019,34,DC,112,109,3
2019,34,DE,587,594,-7
2019,34,FL,31577,31528,49
2019,34,GA,1878,1892,-14
2019,34,HI,2475,2473,2
2019,34,IA,175,177,-2
2019,34,ID,51,54,-3
2019,34,IL,496,466,30
2019,34,IN,254,276,-22
2019,34,KS,115,121,-6
2019,34,KY,258,259,-1
2019,34,LA,11568,11371,197
2019,34,MA,1034,1075,-41
2019,34,MD,1010,1043,-33
2019,34,ME,96,115,-19
2019,34,MI,230,230,0
2019,34,MN,121,123,-2
2019,34,MO,258,250,8
2019,34,MS,1257,1274,-17
2019,34,MT,50,55,-5
2019,34,NC,3217,2990,227
2019,34,ND,117,143,-26
2019,34,NE,111,106,5
2019,34,NH,84,90,-6
2019,34,NJ,3462,3532,-70
2019,34,NM,170,181,-11
2019,34,NV,137,150,-13
2019,34,NY,3086,3190,-104
2019,34,OH,427,445,-18
2019,34,OK,217,215,2
2019,34,OR,311,317,-6
2019,34,PA,829,886,-57
2019,34,PR,50,51,-1
2019,34,RI,308,319,-11
2019,34,SC,4395,4311,84
2019,34,SD,69,72,-3
2019,34,TN,450,459,-9
2019,34,TX,16691,16504,187
2019,34,UT,69,70,-1
2019,34,VA,2720,2694,26
2019,34,VI,6,8,-2
2019,34,VT,46,45,1
2019,34,WA,391,404,-13
2019,34,WI,153,168,-15
2019,34,WV,170,191,-21
2019,34,WY,21,21,0
2019,35,AK,27,25,2
2019,35,AL,802,805,-3
2019,35,AR,141,137,4
2019,35,AZ,449,401,48
2019,35,CA,2121,2171,-50
2019,35,CO,303,338,-35
2019,35,CT,453,471,-18
2019,35,DC,44,49,-5
2019,35,DE,358,360,-2
2019,35,FL,26740,26637,103
2019,35,GA,1527,1546,-19
2019,35,GU,1,2,-1
2019,35,HI,1526,1466,60
2019,35,IA,154,156,-2
2019,35,ID,48,44,4
2019,35,IL,347,355,-8
2019,35,IN,218,230,-12
2019,35,KS,119,120,-1
2019,35,KY,182,191,-9
2019,35,LA,8126,8059,67
2019,35,MA,754,770,-16
2019,35,MD,875,884,-9
2019,35,ME,94,102,-8
2019,35,MI,168,169,-1
2019,35,MN,75,77,-2
2019,35,MO,208,203,5
2019,35,MS,962,978,-16
2019,35,MT,48,47,1
2019,35,NC,2685,2434,251
2019,35,ND,146,161,-15
2019,35,NE,82,83,-1
2019,35,NH,131,121,10
2019,35,NJ,2587,2642,-55
2019,35,NM,132,144,-12
2019,35,NV,113,123,-10
2019,35,NY,2835,2937,-102
2019,35,OH,343,357,-14
2019,35,OK,174,163,11
2019,35,OR,440,443,-3
2019,35,PA,716,698,18
2019,35,PR,44,53,-9
2019,35,RI,198,201,-3
2019,35,SC,3277,3083,194
2019,35,SD,28,33,-5
2019,35,TN,363,357,6
2019,35,TX,12893,12709,184
2019,35,UT,59,66,-7
2019,35,VA,1925,1892,33
2019,35,VI,13,15,-2
2019,35,VT,52,49,3
2019,35,WA,344,357,-13
2019,35,WI,163,157,6
2019,35,WV,138,152,-14
2019,35,WY,18,20,-2
2019,36,AK,29,28,1
2019,36,AL,1399,1428,-29
2019,36,AR,158,165,-7
2019,36,AZ,360,396,-36
2019,36,CA,2317,2365,-48
2019,36,CO,343,343,0
2019,36,CT,474,479,-5
2019,36,DC,30,31,-1
2019,36,DE,401,403,-2
2019,36,FL,25391,24869,522
2019,36,GA,1445,1482,-37
2019,36,HI,2821,1622,1199
2019,36,IA,139,144,-5
2019,36,ID,45,48,-3
2019,36,IL,329,349,-20
2019,36,IN,196,205,-9
2019,36,KS,120,129,-9
2019,36,KY,190,199,-9
2019,36,LA,9059,9084,-25
2019,36,MA,889,902,-13
2019,36,MD,719,756,-37
2019,36,ME,114,119,-5
2019,36,MI,217,207,10
2019,36,MN,91,101,-10
2019,36,MO,226,215,11
2019,36,MS,892,906,-14
2019,36,MT,53,54,-1
2019,36,NC,2566,2434,132
2019,36,ND,166,174,-8
2019,36,NE,80,73,7
2019,36,NH,104,107,-3
2019,36,NJ,2426,2523,-97
2019,36,NM,141,150,-9
2019,36,NV,102,102,0
2019,36,NY,3145,3269,-124
2019,36,OH,322,358,-36
2019,36,OK,165,169,-4
2019,36,OR,277,289,-12
2019,36,PA,705,742,-37
2019,36,PR,52,56,-4
2019,36,RI,247,253,-6
2019,36,SC,3401,3301,100
2019,36,SD,50,49,1
2019,36,TN,358,365,-7
2019,36,TX,13483,13242,241
2019,36,UT,41,47,-6
2019,36,VA,1966,1972,-6
2019,36,VI,19,19,0
2019,36,VT,34,38,-4
2019,36,WA,360,348,12
2019,36,WI,156,158,-2
2019,36,WV,149,161,-12
2019,36,WY,18,18,0
2019,37,AK,37,41,-4
2019,37,AL,721,752,-31
2019,37,AR,180,190,-10
2019,37,AZ,495,511,-16
2019,37,CA,2547,2614,-67
2019,37,CO,312,341,-29
2019,37,CT,517,533,-16
2019,37,DC,51,50,1
2019,37,DE,393,385,8
2019,37,FL,25726,25908,-182
2019,37,GA,1667,1734,-67
2019,37,HI,1044,1066,-22
2019,37,IA,150,143,7
2019,37,ID,71,66,5
2019,37,IL,371,354,17
2019,37,IN,244,259,-15
2019,37,KS,133,124,9
2019,37,KY,204,219,-15
2019,37,LA,12790,13253,-463
2019,37,MA,985,1013,-28
2019,37,MD,991,1039,-48
2019,37,ME,102,104,-2
2019,37,MI,259,257,2
2019,37,MN,97,101,-4
2019,37,MO,232,270,-38
2019,37,MS,1158,1175,-17
2019,37,MT,54,52,2
2019,37,NC,2695,2556,139
2019,37,ND,160,174,-14
2019,37,NE,77,73,4
2019,37,NH,92,95,-3
2019,37,NJ,3222,3327,-105
2019,37,NM,145,147,-2
2019,37,NV,125,128,-3
2019,37,NY,3292,3254,38
2019,37,OH,346,364,-18
2019,37,OK,186,199,-13
2019,37,OR,256,264,-8
2019,37,PA,852,879,-27
2019,37,PR,55,78,-23
2019,37,RI,212,213,-1
2019,37,SC,4207,4130,77
2019,37,SD,45,46,-1
2019,37,TN,414,429,-15
2019,37,TX,14112,13805,307
2019,37,UT,53,61,-8
2019,37,VA,1972,1984,-12
2019,37,VI,8,7,1
2019,37,VT,35,39,-4
2019,37,WA,391,392,-1
2019,37,WI,159,148,11
2019,37,WV,136,145,-9
2019,37,WY,13,17,-4
2019,38,AK,46,46,0
2019,38,AL,864,885,-21
2019,38,AR,200,206,-6
2019,38,AZ,484,542,-58
2019,38,CA,2828,2854,-26
2019,38,CO,277,323,-46
2019,38,CT,540,547,-7
2019,38,DC,34,35,-1
2019,38,DE,503,518,-15
2019,38,FL,31672,31379,293
2019,38,GA,1778,1771,7
2019,38,HI,1984,1700,284
2019,38,IA,309,317,-8
2019,38,ID,63,58,5
2019,38,IL,448,449,-1
2019,38,IN,240,264,-24
2019,38,KS,143,142,1
2019,38,KY,223,238,-15
2019,38,LA,14944,15567,-623
2019,38,MA,1118,1170,-52
2019,38,MD,1081,1103,-22
2019,38,ME,129,135,-6
2019,38,MI,224,233,-9
2019,38,MN,119,120,-1
2019,38,MO,255,246,9
2019,38,MS,1199,1235,-36
2019,38,MT,49,44,5
2019,38,NC,2978,2765,213
2019,38,ND,146,155,-9
2019,38,NE,96,83,13
2019,38,NH,115,108,7
2019,38,NJ,3261,3340,-79
2019,38,NM,124,130,-6
2019,38,NV,154,157,-3
2019,38,NY,3832,3927,-95
2019,38,OH,425,455,-30
2019,38,OK,206,209,-3
2019,38,OR,340,345,-5
2019,38,PA,783,820,-37
2019,38,PR,64,64,0
2019,38,RI,325,337,-12
2019,38,SC,4063,3944,119
2019,38,SD,53,48,5
2019,38,TN,441,472,-31
2019,38,TX,17828,18247,-419
2019,38,UT,59,62,-3
2019,38,VA,2386,2451,-65
2019,38,VI,11,15,-4
2019,38,VT,42,44,-2
2019,38,WA,436,469,-33
2019,38,WI,218,236,-18
2019,38,WV,145,156,-11
2019,38,WY,17,17,0
2019,39,AK,38,39,-1
2019,39,AL,1277,1389,-112
2019,39,AR,203,217,-14
2019,39,AZ,402,462,-60
2019,39,CA,3011,3105,-94
2019,39,CO,327,338,-11
2019,39,CT,567,593,-26
2019,39,DC,44,50,-6
2019,39,DE,587,608,-21
2019,39,FL,43303,45409,-2106
2019,39,GA,2610,2813,-203
2019,39,HI,1492,1447,45
2019,39,IA,147,157,-10
2019,39,ID,68,66,2
2019,39,IL,461,466,-5
2019,39,IN,295,308,-13
2019,39,KS,144,162,-18
2019,39,KY,248,266,-18
2019,39,LA,11846,12453,-607
2019,39,MA,1105,1131,-26
2019,39,MD,1587,1649,-62
2019,39,ME,160,165,-5
2019,39,MI,174,181,-7
2019,39,MN,121,125,-4
2019,39,MO,265,259,6
2019,39,MS,1088,1155,-67
2019,39,MT,36,40,-4
2019,39,NC,3785,3797,-12
2019,39,ND,117,126,-9
2019,39,NE,106,94,12
2019,39,NH,125,126,-1
2019,39,NJ,3462,3570,-108
2019,39,NM,138,142,-4
2019,39,NV,106,112,-6
2019,39,NY,3716,3865,-149
2019,39,OH,435,455,-20
2019,39,OK,199,207,-8
2019,39,OR,326,332,-6
2019,39,PA,1043,1096,-53
2019,39,PR,94,59,35
2019,39,RI,213,231,-18
2019,39,SC,6091,6274,-183
2019,39,SD,32,36,-4
2019,39,TN,511,565,-54
2019,39,TX,23495,24855,-1360
2019,39,UT,64,68,-4
2019,39,VA,3737,3802,-65
2019,39,VI,11,12,-1
2019,39,VT,46,49,-3
2019,39,WA,517,546,-29
2019,39,WI,206,223,-17
2019,39,WV,161,157,4
2019,39,WY,26,26,0
2019,40,AK,28,29,-1
2019,40,AL,963,1048,-85
2019,40,AR,166,181,-15
2019,40,AZ,500,589,-89
2019,40,CA,3190,3309,-119
2019,40,CO,283,282,1
2019,40,CT,558,587,-29
2019,40,DC,74,96,-22
2019,40,DE,656,693,-37
2019,40,FL,26859,27230,-371
2019,40,GA,2024,2278,-254
2019,40,HI,1081,1109,-28
2019,40,IA,119,124,-5
2019,40,ID,65,65,0
2019,40,IL,409,412,-3
2019,40,IN,256,285,-29
2019,40,KS,108,121,-13
2019,40,KY,195,206,-11
2019,40,LA,9343,9669,-326
2019,40,MA,1190,1257,-67
2019,40,MD,1312,1477,-165
2019,40,ME,156,167,-11
2019,40,MI,240,242,-2
2019,40,MN,115,117,-2
2019,40,MO,230,229,1
2019,40,MS,927,992,-65
2019,40,MT,42,42,0
2019,40,NC,3618,4201,-583
2019,40,ND,107,122,-15
2019,40,NE,77,71,6
2019,40,NH,107,102,5
2019,40,NJ,2989,3130,-141
2019,40,NM,104,113,-9
2019,40,NV,120,132,-12
2019,40,NY,3691,3914,-223
2019,40,OH,370,413,-43
2019,40,OK,209,212,-3
2019,40,OR,349,358,-9
2019,40,PA,1029,1139,-110
2019,40,PR,42,45,-3
2019,40,RI,224,230,-6
2019,40,SC,3982,4362,-380
2019,40,SD,43,43,0
2019,40,TN,478,525,-47
2019,40,TX,20984,22933,-1949
2019,40,UT,80,62,18
2019,40,VA,3351,4073,-722
2019,40,VI,13,13,0
2019,40,VT,56,58,-2
2019,40,WA,423,442,-19
2019,40,WI,149,146,3
2019,40,WV,163,184,-21
2019,40,WY,13,13,0
2019,41,AK,31,31,0
2019,41,AL,657,686,-29
2019,41,AR,161,174,-13
2019,41,AZ,485,529,-44
2019,41,CA,3721,3883,-162
2019,41,CO,358,374,-16
2019,41,CT,554,590,-36
2019,41,DC,43,51,-8
2019,41,DE,427,450,-23
2019,41,FL,27980,28686,-706
2019,41,GA,1695,1794,-99
2019,41,HI,1432,1451,-19
2019,41,IA,128,133,-5
2019,41,ID,75,72,3
2019,41,IL,441,413,28
2019,41,IN,261,285,-24
2019,41,KS,120,126,-6
2019,41,KY,218,226,-8
2019,41,LA,8700,8802,-102
2019,41,MA,1152,1202,-50
2019,41,MD,1048,1144,-96
2019,41,ME,214,213,1
2019,41,MI,227,225,2
2019,41,MN,121,125,-4
2019,41,MO,210,218,-8
2019,41,MS,841,856,-15
2019,41,MT,43,48,-5
2019,41,NC,2836,3046,-210
2019,41,ND,113,116,-3
2019,41,NE,90,84,6
2019,41,NH,84,91,-7
2019,41,NJ,2910,3002,-92
2019,41,NM,166,169,-3
2019,41,NV,119,131,-12
2019,41,NY,3448,3550,-102
2019,41,OH,359,392,-33
2019,41,OK,179,179,0
2019,41,OR,485,514,-29
2019,41,PA,912,992,-80
2019,41,PR,31,42,-11
2019,41,RI,207,212,-5
2019,41,SC,3671,3728,-57
2019,41,SD,45,48,-3
2019,41,TN,395,422,-27
2019,41,TX,17447,17490,-43
2019,41,UT,77,77,0
2019,41,VA,2495,2669,-174
2019,41,VI,8,10,-2
2019,41,VT,43,39,4
2019,41,WA,569,516,53
2019,41,WI,151,156,-5
2019,41,WV,114,123,-9
2019,41,WY,16,18,-2
2019,42,AK,37,42,-5
2019,42,AL,710,737,-27
2019,42,AR,157,170,-13
2019,42,AZ,461,444,17
2019,42,CA,3987,4110,-123
2019,42,CO,379,388,-9
2019,42,CT,577,495,82
2019,42,DC,41,44,-3
2019,42,DE,389,396,-7
2019,42,FL,25403,25923,-520
2019,42,GA,1594,1671,-77
2019,42,HI,1143,1138,5
2019,42,IA,204,196,8
2019,42,ID,69,66,3
2019,42,IL,374,377,-3
2019,42,IN,272,285,-13
2019,42,KS,113,128,-15
2019,42,KY,175,198,-23
2019,42,LA,7499,7649,-150
2019,42,MA,1008,1046,-38
2019,42,MD,908,943,-35
2019,42,ME,142,147,-5
2019,42,MI,209,201,8
2019,42,MN,141,155,-14
2019,42,MO,228,236,-8
2019,42,MS,935,1011,-76
2019,42,MT,48,52,-4
2019,42,NC,2610,2726,-116
2019,42,ND,135,140,-5
2019,42,NE,85,66,19
2019,42,NH,89,95,-6
2019,42,NJ,2736,2790,-54
2019,42,NM,115,130,-15
2019,42,NV,148,160,-12
2019,42,NY,2659,2717,-58
2019,42,OH,373,403,-30
2019,42,OK,210,216,-6
2019,42,OR,363,377,-14
2019,42,PA,871,912,-41
2019,42,PR,31,38,-7
2019,42,RI,183,191,-8
2019,42,SC,3500,3699,-199
2019,42,SD,36,26,10
2019,42,TN,394,389,5
2019,42,TX,17328,15022,2306
2019,42,UT,74,77,-3
2019,42,VA,2307,2472,-165
2019,42,VI,7,7,0
2019,42,VT,53,56,-3
2019,42,WA,520,531,-11
2019,42,WI,176,171,5
2019,42,WV,151,163,-12
2019,42,WY,23,22,1
2019,43,AK,28,32,-4
2019,43,AL,1086,1105,-19
2019,43,AR,154,172,-18
2019,43,AZ,423,465,-42
2019,43,CA,3848,4081,-233
2019,43,CO,381,406,-25
2019,43,CT,439,465,-26
2019,43,DC,39,39,0
2019,43,DE,603,617,-14
2019,43,FL,31521,32038,-517
2019,43,GA,1621,1731,-110
2019,43,HI,2149,1871,278
2019,43,IA,192,173,19
2019,43,ID,78,77,1
2019,43,IL,486,489,-3
2019,43,IN,261,281,-20
2019,43,KS,129,139,-10
2019,43,KY,212,223,-11
2019,43,LA,8531,8688,-157
2019,43,MA,1305,1321,-16
2019,43,MD,1160,1189,-29
2019,43,ME,156,163,-7
2019,43,MI,241,224,17
2019,43,MN,133,141,-8
2019,43,MO,250,248,2
2019,43,MS,865,901,-36
2019,43,MT,49,46,3
2019,43,NC,2666,2811,-145
2019,43,ND,164,163,1
2019,43,NE,110,92,18
2019,43,NH,118,121,-3
2019,43,NJ,3210,3293,-83
2019,43,NM,110,121,-11
2019,43,NV,130,140,-10
2019,43,NY,3110,3287,-177
2019,43,OH,396,407,-11
2019,43,OK,219,209,10
2019,43,OR,445,445,0
2019,43,PA,1072,1108,-36
2019,43,PR,28,39,-11
2019,43,RI,205,219,-14
2019,43,SC,3738,3894,-156
2019,43,SD,43,39,4
2019,43,TN,438,448,-10
2019,43,TX,15083,14408,675
2019,43,UT,154,326,-172
2019,43,VA,1949,2058,-109
2019,43,VI,7,7,0
2019,43,VT,49,51,-2
2019,43,WA,634,665,-31
2019,43,WI,166,188,-22
2019,43,WV,132,144,-12
2019,43,WY,22,25,-3
2019,44,AK,31,32,-1
2019,44,AL,707,677,30
2019,44,AR,152,160,-8
2019,44,AZ,327,340,-13
2019,44,CA,3671,3857,-186
2019,44,CO,220,229,-9
2019,44,CT,377,392,-15
2019,44,DC,36,46,-10
2019,44,DE,273,288,-15
2019,44,FL,20077,20742,-665
2019,44,GA,1259,1367,-108
2019,44,HI,616,613,3
2019,44,IA,117,119,-2
2019,44,ID,65,55,10
2019,44,IL,317,304,13
2019,44,IN,231,238,-7
2019,44,KS,107,114,-7
2019,44,KY,225,223,2
2019,44,LA,6150,6214,-64
2019,44,MA,823,842,-19
2019,44,MD,674,700,-26
2019,44,ME,137,138,-1
2019,44,MI,177,161,16
2019,44,MN,183,183,0
2019,44,MO,248,253,-5
2019,44,MS,838,853,-15
2019,44,MT,44,45,-1
2019,44,NC,2527,2721,-194
2019,44,ND,115,103,12
2019,44,NE,61,49,12
2019,44,NH,75,78,-3
2019,44,NJ,2503,2540,-37
2019,44,NM,93,96,-3
2019,44,NV,112,115,-3
2019,44,NY,2273,2358,-85
2019,44,OH,298,301,-3
2019,44,OK,173,171,2
2019,44,OR,399,388,11
2019,44,PA,687,735,-48
2019,44,PR,29,46,-17
2019,44,RI,152,163,-11
2019,44,SC,2878,3071,-193
2019,44,SD,35,30,5
2019,44,TN,376,375,1
2019,44,TX,10693,10426,267
2019,44,UT,62,71,-9
2019,44,VA,1525,1957,-432
2019,44,VI,1,2,-1
2019,44,VT,50,50,0
2019,44,WA,668,658,10
2019,44,WI,155,138,17
2019,44,WV,124,136,-12
2019,44,WY,22,27,-5
2019,45,AK,15,18,-3
2019,45,AL,865,879,-14
2019,45,AR,125,138,-13
2019,45,AZ,335,354,-19
2019,45,CA,4079,4225,-146
2019,45,CO,275,274,1
2019,45,CT,564,591,-27
2019,45,DC,25,27,-2
2019,45,DE,332,335,-3
2019,45,FL,21651,22452,-801
2019,45,GA,1223,1290,-67
2019,45,HI,453,466,-13
2019,45,IA,125,119,6
2019,45,ID,77,73,4
2019,45,IL,344,345,-1
2019,45,IN,213,224,-11
2019,45,KS,110,121,-11
2019,45,KY,156,168,-12
2019,45,LA,6347,6407,-60
2019,45,MA,858,887,-29
2019,45,MD,849,893,-44
2019,45,ME,114,119,-5
2019,45,MI,193,172,21
2019,45,MN,104,90,14
2019,45,MO,215,184,31
2019,45,MS,919,948,-29
2019,45,MT,48,49,-1
2019,45,NC,2475,2584,-109
2019,45,ND,105,85,20
2019,45,NE,75,70,5
2019,45,NH,75,79,-4
2019,45,NJ,2786,2822,-36
2019,45,NM,101,106,-5
2019,45,NV,122,134,-12
2019,45,NY,2493,2528,-35
2019,45,OH,294,306,-12
2019,45,OK,155,143,12
2019,45,OR,506,497,9
2019,45,PA,713,721,-8
2019,45,PR,27,36,-9
2019,45,RI,133,152,-19
2019,45,SC,3159,3264,-105
2019,45,SD,31,31,0
2019,45,TN,350,363,-13
2019,45,TX,11214,11112,102
2019,45,UT,48,56,-8
2019,45,VA,1585,1666,-81
2019,45,VI,3,2,1
2019,45,VT,44,41,3
2019,45,WA,603,628,-25
2019,45,WI,125,119,6
2019,45,WV,130,139,-9
2019,45,WY,16,14,2
2019,46,AK,85,83,2
2019,46,AL,513,533,-20
2019,46,AR,131,134,-3
2019,46,AZ,329,350,-21
2019,46,CA,4285,4496,-211
2019,46,CO,208,217,-9
2019,46,CT,419,436,-17
2019,46,DC,21,21,0
2019,46,DE,337,333,4
2019,46,FL,21326,21416,-90
2019,46,GA,1073,1152,-79
2019,46,GU,1,0,1
2019,46,HI,362,372,-10
2019,46,IA,112,107,5
2019,46,ID,63,60,3
2019,46,IL,318,315,3
2019,46,IN,214,224,-10
2019,46,KS,98,103,-5
2019,46,KY,192,198,-6
2019,46,LA,6133,6143,-10
2019,46,MA,773,795,-22
2019,46,MD,830,834,-4
2019,46,ME,126,121,5
2019,46,MI,189,156,33
2019,46,MN,96,85,11
2019,46,MO,196,196,0
2019,46,MS,882,916,-34
2019,46,MT,32,30,2
2019,46,NC,2154,2231,-77
2019,46,ND,111,87,24
2019,46,NE,73,66,7
2019,46,NH,78,75,3
2019,46,NJ,2650,2701,-51
2019,46,NM,112,110,2
2019,46,NV,119,133,-14
2019,46,NY,2356,2407,-51
2019,46,OH,354,373,-19
2019,46,OK,175,165,10
2019,46,OR,455,469,-14
2019,46,PA,600,673,-73
2019,46,PR,45,55,-10
2019,46,RI,146,155,-9
2019,46,SC,3050,3137,-87
2019,46,SD,30,22,8
2019,46,TN,334,330,4
2019,46,TX,10425,10193,232
2019,46,UT,63,65,-2
2019,46,VA,1543,1610,-67
2019,46,VI,14,12,2
2019,46,VT,53,52,1
2019,46,WA,581,580,1
2019,46,WI,115,115,0
2019,46,WV,111,119,-8
2019,46,WY,23,20,3
2019,47,AK,38,35,3
2019,47,AL,544,543,1
2019,47,AR,108,112,-4
2019,47,AZ,286,307,-21
2019,47,CA,5708,6156,-448
2019,47,CO,200,199,1
2019,47,CT,349,580,-231
2019,47,DC,61,58,3
2019,47,DE,334,345,-11
2019,47,FL,19993,20466,-473
2019,47,GA,1010,1090,-80
2019,47,HI,1327,1329,-2
2019,47,IA,121,119,2
2019,47,ID,64,55,9
2019,47,IL,327,317,10
2019,47,IN,204,210,-6
2019,47,KS,88,97,-9
2019,47,KY,176,188,-12
2019,47,LA,6441,6422,19
2019,47,MA,801,822,-21
2019,47,MD,897,923,-26
2019,47,ME,89,87,2
2019,47,MI,211,187,24
2019,47,MN,100,86,14
2019,47,MO,179,220,-41
2019,47,MS,741,747,-6
2019,47,MT,38,43,-5
2019,47,NC,1856,1893,-37
2019,47,ND,105,81,24
2019,47,NE,75,59,16
2019,47,NH,182,184,-2
2019,47,NJ,2909,2951,-42
2019,47,NM,102,106,-4
2019,47,NV,108,118,-10
2019,47,NY,2297,2345,-48
2019,47,OH,269,278,-9
2019,47,OK,145,138,7
2019,47,OR,401,417,-16
2019,47,PA,677,691,-14
2019,47,PR,21,34,-13
2019,47,RI,161,166,-5
2019,47,SC,2540,2601,-61
2019,47,SD,41,38,3
2019,47,TN,421,420,1
2019,47,TX,9770,9662,108
2019,47,UT,58,59,-1
2019,47,VA,1406,1447,-41
2019,47,VI,11,9,2
2019,47,VT,55,63,-8
2019,47,WA,576,614,-38
2019,47,WI,121,112,9
2019,47,WV,100,106,-6
2019,47,WY,25,26,-1
2019,48,AK,26,22,4
2019,48,AL,941,954,-13
2019,48,AR,115,119,-4
2019,48,AZ,300,320,-20
2019,48,CA,5226,5538,-312
2019,48,CO,193,217,-24
2019,48,CT,672,690,-18
2019,48,DC,23,69,-46
2019,48,DE,312,321,-9
2019,48,FL,22324,22472,-148
2019,48,GA,1013,1056,-43
2019,48,HI,657,666,-9
2019,48,IA,96,95,1
2019,48,ID,63,59,4
2019,48,IL,380,379,1
2019,48,IN,187,201,-14
2019,48,KS,107,102,5
2019,48,KY,182,193,-11
2019,48,LA,5482,5539,-57
2019,48,MA,778,816,-38
2019,48,MD,667,692,-25
2019,48,ME,134,137,-3
2019,48,MI,193,167,26
2019,48,MN,126,93,33
2019,48,MO,208,212,-4
2019,48,MS,869,891,-22
2019,48,MT,38,43,-5
2019,48,NC,1891,1923,-32
2019,48,ND,106,86,20
2019,48,NE,55,49,6
2019,48,NH,129,136,-7
2019,48,NJ,2021,2065,-44
2019,48,NM,111,104,7
2019,48,NV,108,113,-5
2019,48,NY,2605,2660,-55
2019,48,OH,328,336,-8
2019,48,OK,154,141,13
2019,48,OR,447,471,-24
2019,48,PA,697,739,-42
2019,48,PR,23,33,-10
2019,48,RI,213,237,-24
2019,48,SC,2701,2741,-40
2019,48,SD,38,31,7
2019,48,TN,313,311,2
2019,48,TX,9731,9495,236
2019,48,UT,39,39,0
2019,48,VA,1346,1363,-17
2019,48,VI,42,44,-2
2019,48,VT,40,40,0
2019,48,WA,520,552,-32
2019,48,WI,121,119,2
2019,48,WV,114,115,-1
2019,48,WY,21,19,2
2019,49,AK,27,26,1
2019,49,AL,556,579,-23
2019,49,AR,120,122,-2
2019,49,AZ,285,312,-27
2019,49,CA,5177,5477,-300
2019,49,CO,198,213,-15
2019,49,CT,326,332,-6
2019,49,DC,24,22,2
2019,49,DE,303,299,4
2019,49,FL,18192,18623,-431
2019,49,GA,947,1008,-61
2019,49,HI,532,539,-7
2019,49,IA,100,103,-3
2019,49,ID,69,61,8
2019,49,IL,264,271,-7
2019,49,IN,160,176,-16
2019,49,KS,85,94,-9
2019,49,KY,151,167,-16
2019,49,LA,5645,5490,155
2019,49,MA,719,739,-20
2019,49,MD,850,865,-15
2019,49,ME,105,111,-6
2019,49,MI,235,200,35
2019,49,MN,71,64,7
2019,49,MO,187,195,-8
2019,49,MS,689,714,-25
2019,49,MT,35,35,0
2019,49,NC,1773,1813,-40
2019,49,ND,89,88,1
2019,49,NE,60,62,-2
2019,49,NH,69,69,0
2019,49,NJ,2329,2419,-90
2019,49,NM,89,101,-12
2019,49,NV,121,122,-1
2019,49,NY,2417,2475,-58
2019,49,OH,395,405,-10
2019,49,OK,133,133,0
2019,49,OR,375,387,-12
2019,49,PA,621,640,-19
2019,49,PR,28,30,-2
2019,49,RI,127,136,-9
2019,49,SC,2306,2394,-88
2019,49,SD,26,25,1
2019,49,TN,290,289,1
2019,49,TX,8257,8083,174
2019,49,UT,36,37,-1
2019,49,VA,1214,1221,-7
2019,49,VI,6,6,0
2019,49,VT,40,40,0
2019,49,WA,489,517,-28
2019,49,WI,111,109,2
2019,49,WV,100,106,-6
2019,49,WY,16,16,0
2019,50,AK,20,25,-5
2019,50,AL,535,541,-6
2019,50,AR,183,187,-4
2019,50,AZ,374,362,12
2019,50,CA,4708,5048,-340
2019,50,CO,277,300,-23
2019,50,CT,485,481,4
2019,50,DC,31,32,-1
2019,50,DE,346,353,-7
2019,50,FL,24144,24684,-540
2019,50,GA,1065,1147,-82
2019,50,GU,2,2,0
2019,50,HI,1230,1239,-9
2019,50,IA,127,137,-10
2019,50,ID,79,63,16
2019,50,IL,324,337,-13
2019,50,IN,199,201,-2
2019,50,KS,83,90,-7
2019,50,KY,182,187,-5
2019,50,LA,6175,6251,-76
2019,50,MA,864,888,-24
2019,50,MD,801,768,33
2019,50,ME,115,122,-7
2019,50,MI,196,173,23
2019,50,MN,91,84,7
2019,50,MO,199,202,-3
2019,50,MS,803,816,-13
2019,50,MT,39,40,-1
2019,50,NC,2091,2128,-37
2019,50,ND,97,90,7
2019,50,NE,69,65,4
2019,50,NH,95,102,-7
2019,50,NJ,2544,2591,-47
2019,50,NM,84,86,-2
2019,50,NV,114,123,-9
2019,50,NY,2911,3024,-113
2019,50,OH,280,289,-9
2019,50,OK,164,145,19
2019,50,OR,400,397,3
2019,50,PA,659,682,-23
2019,50,PR,24,38,-14
2019,50,RI,144,147,-3
2019,50,SC,2976,2973,3
2019,50,SD,31,41,-10
2019,50,TN,345,340,5
2019,50,TX,9340,9105,235
2019,50,UT,84,86,-2
2019,50,VA,1337,1355,-18
2019,50,VI,8,10,-2
2019,50,VT,27,26,1
2019,50,WA,624,620,4
2019,50,WI,119,115,4
2019,50,WV,136,135,1
2019,50,WY,25,23,2
2019,51,AK,18,21,-3
2019,51,AL,376,383,-7
2019,51,AR,71,77,-6
2019,51,AZ,238,234,4
2019,51,CA,3074,3212,-138
2019,51,CO,150,161,-11
2019,51,CT,295,258,37
2019,51,DC,22,21,1
2019,51,DE,212,200,12
2019,51,FL,14085,14421,-336
2019,51,GA,610,632,-22
2019,51,GU,1,1,0
2019,51,HI,1011,1019,-8
2019,51,IA,93,93,0
2019,51,ID,40,37,3
2019,51,IL,179,177,2
2019,51,IN,113,125,-12
2019,51,KS,66,71,-5
2019,51,KY,124,128,-4
2019,51,LA,3916,3956,-40
2019,51,MA,439,440,-1
2019,51,MD,917,924,-7
2019,51,ME,74,82,-8
2019,51,MI,107,100,7
2019,51,MN,72,63,9
2019,51,MO,111,128,-17
2019,51,MS,490,504,-14
2019,51,MT,14,14,0
2019,51,NC,1112,1147,-35
2019,51,ND,68,49,19
2019,51,NE,51,41,10
2019,51,NH,54,58,-4
2019,51,NJ,1912,1968,-56
2019,51,NM,71,79,-8
2019,51,NV,70,75,-5
2019,51,NY,2161,2205,-44
2019,51,OH,171,191,-20
2019,51,OK,86,80,6
2019,51,OR,232,247,-15
2019,51,PA,416,421,-5
2019,51,PR,18,32,-14
2019,51,RI,87,86,1
2019,51,SC,1558,1541,17
2019,51,SD,18,20,-2
2019,51,TN,294,299,-5
2019,51,TX,6000,5540,460
2019,51,UT,54,35,19
2019,51,VA,758,752,6
2019,51,VI,3,3,0
2019,51,VT,24,23,1
2019,51,WA,382,401,-19
2019,51,WI,230,217,13
2019,51,WV,62,65,-3
2019,51,WY,12,12,0
2019,52,AK,7,9,-2
2019,52,AL,262,285,-23
2019,52,AR,37,46,-9
2019,52,AZ,153,157,-4
2019,52,CA,1643,1813,-170
2019,52,CO,119,130,-11
2019,52,CT,120,129,-9
2019,52,DC,11,13,-2
2019,52,DE,104,107,-3
2019,52,FL,13420,13628,-208
2019,52,GA,431,457,-26
2019,52,HI,88,98,-10
2019,52,IA,34,38,-4
2019,52,ID,29,30,-1
2019,52,IL,127,135,-8
2019,52,IN,63,76,-13
2019,52,KS,30,38,-8
2019,52,KY,53,55,-2
2019,52,LA,2828,2920,-92
2019,52,MA,343,640,-297
2019,52,MD,262,288,-26
2019,52,ME,36,38,-2
2019,52,MI,73,77,-4
2019,52,MN,118,49,69
2019,52,MO,75,84,-9
2019,52,MS,327,351,-24
2019,52,MT,11,17,-6
2019,52,NC,720,772,-52
2019,52,ND,68,67,1
2019,52,NE,35,34,1
2019,52,NH,24,26,-2
2019,52,NJ,804,851,-47
2019,52,NM,46,51,-5
2019,52,NV,44,46,-2
2019,52,NY,1058,1104,-46
2019,52,OH,134,132,2
2019,52,OK,48,66,-18
2019,52,OR,145,154,-9
2019,52,PA,273,291,-18
2019,52,PR,39,43,-4
2019,52,RI,50,57,-7
2019,52,SC,1653,1707,-54
2019,52,SD,13,12,1
2019,52,TN,133,142,-9
2019,52,TX,3844,4056,-212
2019,52,UT,20,20,0
2019,52,VA,474,505,-31
2019,52,VT,10,10,0
2019,52,WA,218,227,-9
2019,52,WI,48,49,-1
2019,52,WV,48,52,-4
2019,52,WY,10,10,0
2020,0,AK,8,7,1
2020,0,AL,241,247,-6
2020,0,AR,51,53,-2
2020,0,AZ,213,163,50
2020,0,CA,3170,3258,-88
2020,0,CO,130,131,-1
2020,0,CT,180,176,4
2020,0,DC,18,17,1
2020,0,DE,297,294,3
2020,0,FL,19335,19168,167
2020,0,GA,2233,2182,51
2020,0,HI,246,252,-6
2020,0,IA,72,73,-1
2020,0,ID,37,32,5
2020,0,IL,250,195,55
2020,0,IN,122,129,-7
2020,0,KS,55,50,5
2020,0,KY,100,95,5
2020,0,LA,2309,2293,16
2020,0,MA,369,385,-16
2020,0,MD,369,353,16
2020,0,ME,47,44,3
2020,0,MI,104,74,30
2020,0,MN,53,46,7
2020,0,MO,94,87,7
2020,0,MS,363,369,-6
2020,0,MT,21,20,1
2020,0,NC,925,957,-32
2020,0,ND,56,47,9
2020,0,NE,64,63,1
2020,0,NH,45,44,1
2020,0,NJ,1138,1166,-28
2020,0,NM,51,52,-1
2020,0,NV,67,71,-4
2020,0,NY,1248,1252,-4
2020,0,OH,132,130,2
2020,0,OK,69,69,0
2020,0,OR,222,212,10
2020,0,PA,318,337,-19
2020,0,PR,11,16,-5
2020,0,RI,65,64,1
2020,0,SC,1233,1245,-12
2020,0,SD,22,13,9
2020,0,TN,148,146,2
2020,0,TX,4676,4382,294
2020,0,UT,24,24,0
2020,0,VA,653,645,8
2020,0,VT,17,17,0
2020,0,WA,230,230,0
2020,0,WI,143,136,7
2020,0,WV,62,63,-1
2020,0,WY,6,6,0
2020,1,AK,26,27,-1
2020,1,AL,491,513,-22
2020,1,AR,96,99,-3
2020,1,AZ,275,295,-20
2020,1,CA,3954,4224,-270
2020,1,CO,229,227,2
2020,1,CT,384,404,-20
2020,1,DC,26,26,0
2020,1,DE,245,255,-10
2020,1,FL,20268,20555,-287
2020,1,GA,804,859,-55
2020,1,HI,589,595,-6
2020,1,IA,98,98,0
2020,1,ID,49,48,1
2020,1,IL,272,285,-13
2020,1,IN,162,177,-15
2020,1,KS,108,113,-5
2020,1,KY,134,136,-2
2020,1,LA,4739,4756,-17
2020,1,MA,513,525,-12
2020,1,MD,638,653,-15
2020,1,ME,97,103,-6
2020,1,MI,169,138,31
2020,1,MN,80,73,7
2020,1,MO,165,163,2
2020,1,MS,687,713,-26
2020,1,MT,31,30,1
2020,1,NC,1516,1538,-22
2020,1,ND,185,181,4
2020,1,NE,65,52,13
2020,1,NH,65,69,-4
2020,1,NJ,2041,2101,-60
2020,1,NM,92,99,-7
2020,1,NV,102,122,-20
2020,1,NY,2184,2244,-60
2020,1,OH,349,352,-3
2020,1,OK,108,120,-12
2020,1,OR,386,405,-19
2020,1,PA,476,501,-25
2020,1,PR,15,19,-4
2020,1,RI,300,305,-5
2020,1,SC,1930,1963,-33
2020,1,SD,35,28,7
2020,1,TN,276,263,13
2020,1,TX,6920,6754,166
2020,1,UT,39,40,-1
2020,1,VA,1120,1125,-5
2020,1,VI,3,3,0
2020,1,VT,33,31,2
2020,1,WA,452,446,6
2020,1,WI,99,130,-31
2020,1,WV,92,103,-11
2020,1,WY,12,12,0
2020,2,AK,40,38,2
2020,2,AL,495,516,-21
2020,2,AR,122,116,6
2020,2,AZ,279,301,-22
2020,2,CA,3570,3824,-254
2020,2,CO,160,156,4
2020,2,CT,439,458,-19
2020,2,DC,22,22,0
2020,2,DE,235,233,2
2020,2,FL,20507,20877,-370
2020,2,GA,868,898,-30
2020,2,HI,670,656,14
2020,2,IA,86,91,-5
2020,2,ID,57,51,6
2020,2,IL,237,240,-3
2020,2,IN,174,182,-8
2020,2,KS,97,104,-7
2020,2,KY,142,145,-3
2020,2,LA,4976,4995,-19
2020,2,MA,520,538,-18
2020,2,MD,795,817,-22
2020,2,ME,108,109,-1
2020,2,MI,211,186,25
2020,2,MN,67,68,-1
2020,2,MO,184,189,-5
2020,2,MS,696,726,-30
2020,2,MT,37,38,-1
2020,2,NC,1726,1743,-17
2020,2,ND,177,175,2
2020,2,NE,65,63,2
2020,2,NH,88,85,3
2020,2,NJ,1946,2013,-67
2020,2,NM,92,94,-2
2020,2,NV,111,112,-1
2020,2,NY,3049,2833,216
2020,2,OH,221,233,-12
2020,2,OK,107,110,-3
2020,2,OR,331,331,0
2020,2,PA,627,639,-12
2020,2,PR,32,31,1
2020,2,RI,97,102,-5
2020,2,SC,2453,2476,-23
2020,2,SD,23,19,4
2020,2,TN,256,257,-1
2020,2,TX,7054,6859,195
2020,2,UT,41,41,0
2020,2,VA,947,977,-30
2020,2,VI,2,3,-1
2020,2,VT,26,24,2
2020,2,WA,579,588,-9
2020,2,WI,194,185,9
2020,2,WV,92,107,-15
2020,2,WY,11,17,-6
2020,3,AK,19,20,-1
2020,3,AL,386,393,-7
2020,3,AR,90,92,-2
2020,3,AZ,211,208,3
2020,3,CA,2488,2621,-133
2020,3,CO,160,161,-1
2020,3,CT,298,311,-13
2020,3,DC,14,13,1
2020,3,DE,408,408,0
2020,3,FL,16362,16789,-427
2020,3,GA,730,760,-30
2020,3,HI,441,439,2
2020,3,IA,78,72,6
2020,3,ID,37,37,0
2020,3,IL,227,208,19
2020,3,IN,135,139,-4
2020,3,KS,67,74,-7
2020,3,KY,124,128,-4
2020,3,LA,4077,4148,-71
2020,3,MA,476,496,-20
2020,3,MD,708,723,-15
2020,3,ME,57,67,-10
2020,3,MI,150,115,35
2020,3,MN,64,60,4
2020,3,MO,109,108,1
2020,3,MS,541,545,-4
2020,3,MT,28,27,1
2020,3,NC,1624,1652,-28
2020,3,ND,91,89,2
2020,3,NE,47,45,2
2020,3,NH,34,37,-3
2020,3,NJ,1518,1572,-54
2020,3,NM,61,64,-3
2020,3,NV,62,70,-8
2020,3,NY,1642,1681,-39
2020,3,OH,185,202,-17
2020,3,OK,94,97,-3
2020,3,OR,292,310,-18
2020,3,PA,425,448,-23
2020,3,PR,13,17,-4
2020,3,RI,77,81,-4
2020,3,SC,1953,1990,-37
2020,3,SD,24,18,6
2020,3,TN,234,233,1
2020,3,TX,5666,5755,-89
2020,3,UT,26,22,4
2020,3,VA,761,776,-15
2020,3,VI,11,11,0
2020,3,VT,26,26,0
2020,3,WA,360,339,21
2020,3,WI,99,85,14
2020,3,WV,77,85,-8
2020,3,WY,10,11,-1
2020,4,AK,24,28,-4
2020,4,AL,931,954,-23
2020,4,AR,148,152,-4
2020,4,AZ,302,313,-11
2020,4,CA,3067,3178,-111
2020,4,CO,214,270,-56
2020,4,CT,342,356,-14
2020,4,DC,41,42,-1
2020,4,DE,241,241,0
2020,4,FL,22517,22957,-440
2020,4,GA,977,1019,-42
2020,4,HI,1273,1278,-5
2020,4,IA,113,91,22
2020,4,ID,66,66,0
2020,4,IL,315,324,-9
2020,4,IN,173,185,-12
2020,4,KS,112,112,0
2020,4,KY,145,155,-10
2020,4,LA,5835,5974,-139
2020,4,MA,526,542,-16
2020,4,MD,620,642,-22
2020,4,ME,85,93,-8
2020,4,MI,178,154,24
2020,4,MN,88,80,8
2020,4,MO,159,173,-14
2020,4,MS,960,942,18
2020,4,MT,40,41,-1
2020,4,NC,1596,1593,3
2020,4,ND,155,130,25
2020,4,NE,73,64,9
2020,4,NH,48,51,-3
2020,4,NJ,2497,2552,-55
2020,4,NM,90,93,-3
2020,4,NV,133,152,-19
2020,4,NY,1918,2022,-104
2020,4,OH,227,242,-15
2020,4,OK,102,114,-12
2020,4,OR,740,565,175
2020,4,PA,586,617,-31
2020,4,PR,28,31,-3
2020,4,RI,103,107,-4
2020,4,SC,2440,2470,-30
2020,4,SD,29,21,8
2020,4,TN,243,255,-12
2020,4,TX,7201,7126,75
2020,4,UT,43,53,-10
2020,4,VA,1036,1059,-23
2020,4,VI,5,7,-2
2020,4,VT,52,52,0
2020,4,WA,452,448,4
2020,4,WI,109,101,8
2020,4,WV,96,99,-3
2020,4,WY,13,10,3
2020,5,AK,10,14,-4
2020,5,AL,437,455,-18
2020,5,AR,136,149,-13
2020,5,AZ,299,306,-7
2020,5,CA,4146,4482,-336
2020,5,CO,194,214,-20
2020,5,CT,223,240,-17
2020,5,DC,65,20,45
2020,5,DE,204,211,-7
2020,5,FL,16535,16917,-382
2020,5,GA,816,834,-18
2020,5,HI,796,801,-5
2020,5,IA,130,127,3
2020,5,ID,90,101,-11
2020,5,IL,345,343,2
2020,5,IN,183,201,-18
2020,5,KS,76,86,-10
2020,5,KY,175,171,4
2020,5,LA,5636,5625,11
2020,5,MA,601,622,-21
2020,5,MD,530,534,-4
2020,5,ME,121,127,-6
2020,5,MI,196,171,25
2020,5,MN,130,102,28
2020,5,MO,182,178,4
2020,5,MS,796,814,-18
2020,5,MT,47,54,-7
2020,5,NC,1518,1535,-17
2020,5,ND,221,157,64
2020,5,NE,85,77,8
2020,5,NH,48,56,-8
2020,5,NJ,1977,2037,-60
2020,5,NM,92,84,8
2020,5,NV,125,142,-17
2020,5,NY,2585,2037,548
2020,5,OH,314,325,-11
2020,5,OK,118,122,-4
2020,5,OR,323,333,-10
2020,5,PA,572,596,-24
2020,5,PR,31,26,5
2020,5,RI,105,109,-4
2020,5,SC,1893,1925,-32
2020,5,SD,37,23,14
2020,5,TN,286,294,-8
2020,5,TX,7294,6989,305
2020,5,UT,39,39,0
2020,5,VA,925,959,-34
2020,5,VI,1,3,-2
2020,5,VT,41,43,-2
2020,5,WA,422,415,7
2020,5,WI,113,97,16
2020,5,WV,126,136,-10
2020,5,WY,18,19,-1
2020,6,AK,25,27,-2
2020,6,AL,810,815,-5
2020,6,AR,134,137,-3
2020,6,AZ,333,344,-11
2020,6,CA,3810,4053,-243
2020,6,CO,400,394,6
2020,6,CT,254,267,-13
2020,6,DC,33,29,4
2020,6,DE,218,211,7
2020,6,FL,21539,21824,-285
2020,6,GA,923,934,-11
2020,6,HI,846,849,-3
2020,6,IA,118,120,-2
2020,6,ID,92,93,-1
2020,6,IL,670,658,12
2020,6,IN,249,244,5
2020,6,KS,100,106,-6
2020,6,KY,152,154,-2
2020,6,LA,5754,5722,32
2020,6,MA,973,990,-17
2020,6,MD,545,548,-3
2020,6,ME,83,82,1
2020,6,MI,217,161,56
2020,6,MN,128,113,15
2020,6,MO,190,201,-11
2020,6,MS,811,773,38
2020,6,MT,54,57,-3
2020,6,NC,1697,1690,7
2020,6,ND,283,207,76
2020,6,NE,88,78,10
2020,6,NH,63,66,-3
2020,6,NJ,2025,2075,-50
2020,6,NM,95,94,1
2020,6,NV,130,151,-21
2020,6,NY,2237,2268,-31
2020,6,OH,258,277,-19
2020,6,OK,135,135,0
2020,6,OR,352,370,-18
2020,6,PA,622,660,-38
2020,6,PR,30,29,1
2020,6,RI,132,138,-6
2020,6,SC,2486,2382,104
2020,6,SD,42,31,11
2020,6,TN,319,303,16
2020,6,TX,7718,7186,532
2020,6,UT,120,121,-1
2020,6,VA,1003,1018,-15
2020,6,VI,6,5,1
2020,6,VT,44,44,0
2020,6,WA,493,498,-5
2020,6,WI,133,125,8
2020,6,WV,130,130,0
2020,6,WY,23,27,-4
2020,7,AK,25,24,1
2020,7,AL,678,678,0
2020,7,AR,148,156,-8
2020,7,AZ,247,274,-27
2020,7,CA,3183,3360,-177
2020,7,CO,206,204,2
2020,7,CT,253,266,-13
2020,7,DC,35,35,0
2020,7,DE,226,237,-11
2020,7,FL,22041,22092,-51
2020,7,GA,855,891,-36
2020,7,HI,1369,1379,-10
2020,7,IA,123,121,2
2020,7,ID,89,93,-4
2020,7,IL,290,317,-27
2020,7,IN,186,198,-12
2020,7,KS,86,98,-12
2020,7,KY,164,171,-7
2020,7,LA,5806,5767,39
2020,7,MA,620,627,-7
2020,7,MD,496,504,-8
2020,7,ME,86,94,-8
2020,7,MI,228,184,44
2020,7,MN,129,102,27
2020,7,MO,164,167,-3
2020,7,MS,817,783,34
2020,7,MT,45,57,-12
2020,7,NC,1601,1597,4
2020,7,ND,341,181,160
2020,7,NE,108,84,24
2020,7,NH,77,71,6
2020,7,NJ,1787,1831,-44
2020,7,NM,108,97,11
2020,7,NV,128,144,-16
2020,7,NY,2456,2483,-27
2020,7,OH,387,398,-11
2020,7,OK,120,128,-8
2020,7,OR,336,331,5
2020,7,PA,786,809,-23
2020,7,PR,36,40,-4
2020,7,RI,85,92,-7
2020,7,SC,1906,1958,-52
2020,7,SD,49,28,21
2020,7,TN,295,287,8
2020,7,TX,7680,7315,365
2020,7,UT,67,61,6
2020,7,VA,1034,1067,-33
2020,7,VI,7,7,0
2020,7,VT,33,31,2
2020,7,WA,425,403,22
2020,7,WI,135,117,18
2020,7,WV,134,141,-7
2020,7,WY,17,16,1
2020,8,AK,24,25,-1
2020,8,AL,495,505,-10
2020,8,AR,137,125,12
2020,8,AZ,288,303,-15
2020,8,CA,2807,2873,-66
2020,8,CO,188,188,0
2020,8,CT,282,279,3
2020,8,DC,25,26,-1
2020,8,DE,247,242,5
2020,8,FL,22489,22832,-343
2020,8,GA,1041,1079,-38
2020,8,HI,1005,974,31
2020,8,IA,170,162,8
2020,8,ID,84,84,0
2020,8,IL,331,320,11
2020,8,IN,214,227,-13
2020,8,KS,100,106,-6
2020,8,KY,164,182,-18
2020,8,LA,6919,6952,-33
2020,8,MA,478,487,-9
2020,8,MD,723,736,-13
2020,8,ME,73,78,-5
2020,8,MI,214,209,5
2020,8,MN,308,193,115
2020,8,MO,192,196,-4
2020,8,MS,898,887,11
2020,8,MT,75,79,-4
2020,8,NC,2146,2099,47
2020,8,ND,776,222,554
2020,8,NE,105,87,18
2020,8,NH,77,76,1
2020,8,NJ,1982,2040,-58
2020,8,NM,97,99,-2
2020,8,NV,112,123,-11
2020,8,NY,2155,2733,-578
2020,8,OH,284,302,-18
2020,8,OK,134,137,-3
2020,8,OR,318,336,-18
2020,8,PA,709,734,-25
2020,8,PR,35,39,-4
2020,8,RI,309,315,-6
2020,8,SC,2542,2542,0
2020,8,SD,49,32,17
2020,8,TN,338,340,-2
2020,8,TX,9140,8684,456
2020,8,UT,63,65,-2
2020,8,VA,1294,1298,-4
2020,8,VI,6,7,-1
2020,8,VT,32,35,-3
2020,8,WA,404,395,9
2020,8,WI,131,115,16
2020,8,WV,120,128,-8
2020,8,WY,21,21,0
2020,9,AK,34,37,-3
2020,9,AL,466,466,0
2020,9,AR,142,140,2
2020,9,AZ,268,285,-17
2020,9,CA,3054,3175,-121
2020,9,CO,261,258,3
2020,9,CT,364,387,-23
2020,9,DC,23,26,-3
2020,9,DE,252,232,20
2020,9,FL,27161,26579,582
2020,9,GA,1025,999,26
2020,9,HI,259,264,-5
2020,9,IA,201,194,7
2020,9,ID,133,140,-7
2020,9,IL,414,420,-6
2020,9,IN,221,227,-6
2020,9,KS,118,122,-4
2020,9,KY,173,182,-9
2020,9,LA,6579,6499,80
2020,9,MA,619,630,-11
2020,9,MD,781,787,-6
2020,9,ME,102,102,0
2020,9,MI,210,181,29
2020,9,MN,403,220,183
2020,9,MO,237,238,-1
2020,9,MS,841,838,3
2020,9,MT,51,66,-15
2020,9,NC,2154,2138,16
2020,9,ND,1241,349,892
2020,9,NE,124,82,42
2020,9,NH,56,60,-4
2020,9,NJ,2181,2216,-35
2020,9,NM,114,119,-5
2020,9,NV,131,135,-4
2020,9,NY,2527,2510,17
2020,9,OH,277,291,-14
2020,9,OK,115,118,-3
2020,9,OR,299,294,5
2020,9,PA,732,754,-22
2020,9,PR,32,72,-40
2020,9,RI,110,111,-1
2020,9,SC,2589,2467,122
2020,9,SD,66,37,29
2020,9,TN,466,444,22
2020,9,TX,8681,8167,514
2020,9,UT,65,62,3
2020,9,VA,1014,1025,-11
2020,9,VI,10,9,1
2020,9,VT,77,79,-2
2020,9,WA,526,505,21
2020,9,WI,235,168,67
2020,9,WV,112,118,-6
2020,9,WY,22,20,2
2020,10,AK,23,19,4
2020,10,AL,508,501,7
2020,10,AR,133,133,0
2020,10,AZ,245,243,2
2020,10,CA,2790,2971,-181
2020,10,CO,235,250,-15
2020,10,CT,284,302,-18
2020,10,DC,23,25,-2
2020,10,DE,256,250,6
2020,10,FL,21312,21456,-144
2020,10,GA,987,987,0
2020,10,HI,827,815,12
2020,10,IA,207,209,-2
2020,10,ID,91,101,-10
2020,10,IL,489,483,6
2020,10,IN,257,267,-10
2020,10,KS,119,124,-5
2020,10,KY,192,205,-13
2020,10,LA,6355,6289,66
2020,10,MA,868,886,-18
2020,10,MD,479,454,25
2020,10,ME,82,93,-11
2020,10,MI,208,171,37
2020,10,MN,381,207,174
2020,10,MO,236,228,8
2020,10,MS,936,931,5
2020,10,MT,102,114,-12
2020,10,NC,1874,1785,89
2020,10,ND,1316,447,869
2020,10,NE,86,70,16
2020,10,NH,117,115,2
2020,10,NJ,1952,1989,-37
2020,10,NM,91,91,0
2020,10,NV,134,135,-1
2020,10,NY,2904,2929,-25
2020,10,OH,286,300,-14
2020,10,OK,127,128,-1
2020,10,OR,286,280,6
2020,10,PA,646,672,-26
2020,10,PR,37,39,-2
2020,10,RI,111,114,-3
2020,10,SC,2781,2694,87
2020,10,SD,73,51,22
2020,10,TN,428,397,31
2020,10,TX,8615,8187,428
2020,10,UT,58,58,0
2020,10,VA,1196,1185,11
2020,10,VI,11,13,-2
2020,10,VT,39,41,-2
2020,10,WA,448,431,17
2020,10,WI,172,130,42
2020,10,WV,131,136,-5
2020,10,WY,33,32,1
2020,11,AK,22,24,-2
2020,11,AL,547,544,3
2020,11,AR,129,132,-3
2020,11,AZ,286,294,-8
2020,11,CA,3220,3906,-686
2020,11,CO,227,237,-10
2020,11,CT,313,323,-10
2020,11,DC,22,24,-2
2020,11,DE,236,227,9
2020,11,FL,21770,22024,-254
2020,11,GA,1002,1048,-46
2020,11,HI,840,839,1
2020,11,IA,212,212,0
2020,11,ID,96,121,-25
2020,11,IL,400,415,-15
2020,11,IN,265,276,-11
2020,11,KS,124,122,2
2020,11,KY,213,211,2
2020,11,LA,6631,6831,-200
2020,11,MA,792,811,-19
2020,11,MD,1100,1111,-11
2020,11,ME,86,93,-7
2020,11,MI,260,222,38
2020,11,MN,444,266,178
2020,11,MO,261,245,16
2020,11,MP,1,1,0
2020,11,MS,1024,966,58
2020,11,MT,120,129,-9
2020,11,NC,1725,1695,30
2020,11,ND,967,410,557
2020,11,NE,103,84,19
2020,11,NH,83,81,2
2020,11,NJ,1985,2067,-82
2020,11,NM,111,117,-6
2020,11,NV,125,133,-8
2020,11,NY,1970,2009,-39
2020,11,OH,322,339,-17
2020,11,OK,142,137,5
2020,11,OR,298,306,-8
2020,11,PA,651,693,-42
2020,11,PR,32,99,-67
2020,11,RI,124,128,-4
2020,11,SC,2871,2828,43
2020,11,SD,120,91,29
2020,11,TN,458,464,-6
2020,11,TX,8748,8231,517
2020,11,UT,65,66,-1
2020,11,VA,1101,1144,-43
2020,11,VI,32,32,0
2020,11,VT,44,46,-2
2020,11,WA,385,388,-3
2020,11,WI,215,161,54
2020,11,WV,129,131,-2
2020,11,WY,29,35,-6
2020,12,AK,18,23,-5
2020,12,AL,820,843,-23
2020,12,AR,242,246,-4
2020,12,AZ,287,295,-8
2020,12,CA,3486,3708,-222
2020,12,CO,384,399,-15
2020,12,CT,330,344,-14
2020,12,DC,25,21,4
2020,12,DE,338,320,18
2020,12,FL,23902,24224,-322
2020,12,GA,1112,1145,-33
2020,12,HI,532,535,-3
2020,12,IA,300,344,-44
2020,12,ID,178,222,-44
2020,12,IL,546,576,-30
2020,12,IN,277,302,-25
2020,12,KS,151,152,-1
2020,12,KY,244,246,-2
2020,12,LA,7775,7841,-66
2020,12,MA,516,534,-18
2020,12,MD,820,843,-23
2020,12,ME,89,95,-6
2020,12,MI,270,256,14
2020,12,MN,469,489,-20
2020,12,MO,427,438,-11
2020,12,MS,1202,1197,5
2020,12,MT,128,157,-29
2020,12,NC,1975,2021,-46
2020,12,ND,914,542,372
2020,12,NE,133,114,19
2020,12,NH,71,78,-7
2020,12,NJ,1811,1860,-49
2020,12,NM,100,110,-10
2020,12,NV,128,140,-12
2020,12,NY,2345,2389,-44
2020,12,OH,389,406,-17
2020,12,OK,164,160,4
2020,12,OR,267,270,-3
2020,12,PA,699,739,-40
2020,12,PR,55,66,-11
2020,12,RI,119,120,-1
2020,12,SC,2747,2654,93
2020,12,SD,143,142,1
2020,12,TN,516,547,-31
2020,12,TX,10574,10013,561
2020,12,UT,59,66,-7
2020,12,VA,2003,2028,-25
2020,12,VI,8,8,0
2020,12,VT,31,32,-1
2020,12,WA,471,466,5
2020,12,WI,372,239,133
2020,12,WV,165,164,1
2020,12,WY,34,38,-4
2020,13,AK,25,23,2
2020,13,AL,1034,1063,-29
2020,13,AR,209,228,-19
2020,13,AZ,419,438,-19
2020,13,CA,2804,2961,-157
2020,13,CO,298,319,-21
2020,13,CT,418,417,1
2020,13,DC,26,25,1
2020,13,DE,286,286,0
2020,13,FL,30362,30433,-71
2020,13,GA,1413,1404,9
2020,13,HI,624,461,163
2020,13,IA,262,304,-42
2020,13,ID,122,221,-99
2020,13,IL,652,555,97
2020,13,IN,266,279,-13
2020,13,KS,121,135,-14
2020,13,KY,244,260,-16
2020,13,LA,8276,8347,-71
2020,13,MA,539,559,-20
2020,13,MD,878,883,-5
2020,13,ME,108,120,-12
2020,13,MI,268,244,24
2020,13,MN,766,1119,-353
2020,13,MO,412,420,-8
2020,13,MS,1024,1006,18
2020,13,MT,138,196,-58
2020,13,NC,2520,2491,29
2020,13,ND,589,600,-11
2020,13,NE,155,162,-7
2020,13,NH,95,109,-14
2020,13,NJ,2368,2414,-46
2020,13,NM,137,139,-2
2020,13,NV,119,132,-13
2020,13,NY,2934,2725,209
2020,13,OH,380,392,-12
2020,13,OK,155,150,5
2020,13,OR,324,328,-4
2020,13,PA,756,783,-27
2020,13,PR,31,39,-8
2020,13,RI,124,129,-5
2020,13,SC,4443,4048,395
2020,13,SD,130,149,-19
2020,13,TN,508,534,-26
2020,13,TX,11046,10745,301
2020,13,UT,77,82,-5
2020,13,VA,1436,1442,-6
2020,13,VI,4,3,1
2020,13,VT,37,40,-3
2020,13,WA,384,402,-18
2020,13,WI,308,383,-75
2020,13,WV,179,187,-8
2020,13,WY,37,46,-9
2020,14,AK,28,31,-3
2020,14,AL,547,561,-14
2020,14,AR,151,171,-20
2020,14,AZ,232,248,-16
2020,14,CA,2420,2559,-139
2020,14,CO,353,393,-40
2020,14,CT,309,321,-12
2020,14,DC,21,19,2
2020,14,DE,264,257,7
2020,14,FL,23484,23706,-222
2020,14,GA,970,990,-20
2020,14,HI,483,486,-3
2020,14,IA,319,427,-108
2020,14,ID,128,212,-84
2020,14,IL,446,479,-33
2020,14,IN,240,254,-14
2020,14,KS,148,159,-11
2020,14,KY,197,208,-11
2020,14,LA,7315,7322,-7
2020,14,MA,438,446,-8
2020,14,MD,615,625,-10
2020,14,ME,117,135,-18
2020,14,MI,244,215,29
2020,14,MN,777,1745,-968
2020,14,MO,309,330,-21
2020,14,MS,1044,1048,-4
2020,14,MT,134,217,-83
2020,14,NC,1699,1659,40
2020,14,ND,653,885,-232
2020,14,NE,91,110,-19
2020,14,NH,77,80,-3
2020,14,NJ,2174,2214,-40
2020,14,NM,80,93,-13
2020,14,NV,108,124,-16
2020,14,NY,2164,2222,-58
2020,14,OH,349,359,-10
2020,14,OK,177,176,1
2020,14,OR,262,281,-19
2020,14,PA,651,706,-55
2020,14,PR,47,50,-3
2020,14,RI,226,232,-6
2020,14,SC,2409,2363,46
2020,14,SD,174,232,-58
2020,14,TN,370,377,-7
2020,14,TX,9382,9022,360
2020,14,UT,67,84,-17
2020,14,VA,1036,1088,-52
2020,14,VI,4,6,-2
2020,14,VT,41,35,6
2020,14,WA,336,345,-9
2020,14,WI,326,510,-184
2020,14,WV,136,141,-5
2020,14,WY,45,60,-15
2020,15,AK,37,36,1
2020,15,AL,1053,1067,-14
2020,15,AR,147,159,-12
2020,15,AZ,274,274,0
2020,15,CA,2614,2658,-44
2020,15,CO,336,382,-46
2020,15,CT,317,316,1
2020,15,DC,28,32,-4
2020,15,DE,307,318,-11
2020,15,FL,28325,28667,-342
2020,15,GA,1130,1125,5
2020,15,HI,432,432,0
2020,15,IA,357,453,-96
2020,15,ID,110,153,-43
2020,15,IL,479,511,-32
2020,15,IN,250,264,-14
2020,15,KS,167,191,-24
2020,15,KY,184,187,-3
2020,15,LA,8816,8931,-115
2020,15,MA,691,691,0
2020,15,MD,578,598,-20
2020,15,ME,125,143,-18
2020,15,MI,250,235,15
2020,15,MN,401,850,-449
2020,15,MO,358,400,-42
2020,15,MS,1102,1118,-16
2020,15,MT,108,156,-48
2020,15,NC,2081,2058,23
2020,15,ND,493,727,-234
2020,15,NE,154,200,-46
2020,15,NH,67,69,-2
2020,15,NJ,2197,2278,-81
2020,15,NM,108,108,0
2020,15,NV,116,116,0
2020,15,NY,1973,1995,-22
2020,15,OH,310,309,1
2020,15,OK,177,193,-16
2020,15,OR,274,278,-4
2020,15,PA,586,610,-24
2020,15,PR,35,42,-7
2020,15,RI,178,186,-8
2020,15,SC,2754,2718,36
2020,15,SD,116,127,-11
2020,15,TN,556,560,-4
2020,15,TX,10347,9957,390
2020,15,UT,83,88,-5
2020,15,VA,1295,1312,-17
2020,15,VI,57,58,-1
2020,15,VT,54,57,-3
2020,15,WA,392,396,-4
2020,15,WI,267,344,-77
2020,15,WV,121,130,-9
2020,15,WY,44,61,-17
2020,16,AK,28,33,-5
2020,16,AL,657,687,-30
2020,16,AR,137,133,4
2020,16,AZ,295,300,-5
2020,16,CA,2432,2507,-75
2020,16,CO,416,479,-63
2020,16,CT,291,305,-14
2020,16,DC,23,26,-3
2020,16,DE,307,308,-1
2020,16,FL,24333,24613,-280
2020,16,GA,1079,1086,-7
2020,16,HI,775,767,8
2020,16,IA,272,317,-45
2020,16,ID,97,128,-31
2020,16,IL,500,536,-36
2020,16,IN,254,269,-15
2020,16,KS,175,196,-21
2020,16,KY,211,210,1
2020,16,LA,8503,8716,-213
2020,16,MA,432,466,-34
2020,16,MD,601,609,-8
2020,16,ME,103,107,-4
2020,16,MI,216,212,4
2020,16,MN,184,221,-37
2020,16,MO,378,422,-44
2020,16,MS,1131,1149,-18
2020,16,MT,92,139,-47
2020,16,NC,2077,2036,41
2020,16,ND,197,228,-31
2020,16,NE,151,195,-44
2020,16,NH,66,64,2
2020,16,NJ,2065,2123,-58
2020,16,NM,96,109,-13
2020,16,NV,113,116,-3
2020,16,NY,2540,2578,-38
2020,16,OH,412,364,48
2020,16,OK,173,164,9
2020,16,OR,235,251,-16
2020,16,PA,623,646,-23
2020,16,PR,30,36,-6
2020,16,RI,109,109,0
2020,16,SC,2825,2802,23
2020,16,SD,84,98,-14
2020,16,TN,382,390,-8
2020,16,TX,10985,10718,267
2020,16,UT,62,99,-37
2020,16,VA,1223,1239,-16
2020,16,VI,9,9,0
2020,16,VT,35,33,2
2020,16,WA,366,377,-11
2020,16,WI,192,199,-7
2020,16,WV,150,136,14
2020,16,WY,51,62,-11
2020,17,AK,37,35,2
2020,17,AL,1430,1451,-21
2020,17,AR,156,164,-8
2020,17,AZ,398,412,-14
2020,17,CA,2531,2708,-177
2020,17,CO,362,414,-52
2020,17,CT,377,392,-15
2020,17,DC,26,27,-1
2020,17,DE,348,341,7
2020,17,FL,40744,40787,-43
2020,17,GA,1397,1440,-43
2020,17,HI,2503,2507,-4
2020,17,IA,220,228,-8
2020,17,ID,372,385,-13
2020,17,IL,548,570,-22
2020,17,IN,241,242,-1
2020,17,KS,157,186,-29
2020,17,KY,192,205,-13
2020,17,LA,11765,11834,-69
2020,17,MA,645,655,-10
2020,17,MD,741,749,-8
2020,17,ME,126,132,-6
2020,17,MI,260,237,23
2020,17,MN,135,137,-2
2020,17,MO,328,378,-50
2020,17,MS,1317,1353,-36
2020,17,MT,98,108,-10
2020,17,NC,2735,2726,9
2020,17,ND,138,144,-6
2020,17,NE,141,148,-7
2020,17,NH,80,80,0
2020,17,NJ,2817,2893,-76
2020,17,NM,119,125,-6
2020,17,NV,114,123,-9
2020,17,NY,2265,2321,-56
2020,17,OH,372,370,2
2020,17,OK,188,179,9
2020,17,OR,589,600,-11
2020,17,PA,696,726,-30
2020,17,PR,31,40,-9
2020,17,RI,126,129,-3
2020,17,SC,3702,3501,201
2020,17,SD,66,74,-8
2020,17,TN,403,414,-11
2020,17,TX,15251,14751,500
2020,17,UT,65,81,-16
2020,17,VA,1607,1652,-45
2020,17,VI,11,11,0
2020,17,VT,40,38,2
2020,17,WA,413,428,-15
2020,17,WI,169,179,-10
2020,17,WV,143,155,-12
2020,17,WY,43,51,-8
2020,18,AK,25,24,1
2020,18,AL,701,717,-16
2020,18,AR,135,146,-11
2020,18,AZ,268,279,-11
2020,18,CA,2081,2145,-64
2020,18,CO,367,406,-39
2020,18,CT,273,273,0
2020,18,DC,26,26,0
2020,18,DE,278,289,-11
2020,18,FL,24505,24690,-185
2020,18,GA,1194,1201,-7
2020,18,HI,347,328,19
2020,18,IA,158,171,-13
2020,18,ID,93,99,-6
2020,18,IL,374,394,-20
2020,18,IN,204,228,-24
2020,18,KS,129,145,-16
2020,18,KY,203,214,-11
2020,18,LA,8365,8352,13
2020,18,MA,607,618,-11
2020,18,MD,580,610,-30
2020,18,ME,71,64,7
2020,18,MI,177,173,4
2020,18,MN,119,121,-2
2020,18,MO,207,212,-5
2020,18,MS,1129,1136,-7
2020,18,MT,97,113,-16
2020,18,NC,1865,1840,25
2020,18,ND,97,100,-3
2020,18,NE,115,124,-9
2020,18,NH,72,72,0
2020,18,NJ,2063,2056,7
2020,18,NM,109,117,-8
2020,18,NV,86,81,5
2020,18,NY,2740,2740,0
2020,18,OH,266,269,-3
2020,18,OK,188,194,-6
2020,18,OR,242,252,-10
2020,18,PA,535,573,-38
2020,18,PR,47,59,-12
2020,18,RI,119,124,-5
2020,18,SC,2740,2699,41
2020,18,SD,64,71,-7
2020,18,TN,311,325,-14
2020,18,TX,12861,12076,785
2020,18,UT,55,149,-94
2020,18,VA,1205,1222,-17
2020,18,VI,13,13,0
2020,18,VT,43,44,-1
2020,18,WA,352,360,-8
2020,18,WI,140,142,-2
2020,18,WV,110,124,-14
2020,18,WY,33,38,-5
2020,19,AK,38,35,3
2020,19,AL,1021,1008,13
2020,19,AR,126,130,-4
2020,19,AZ,309,311,-2
2020,19,CA,2266,2350,-84
2020,19,CO,325,355,-30
2020,19,CT,332,335,-3
2020,19,DC,259,260,-1
2020,19,DE,320,315,5
2020,19,FL,27035,27179,-144
2020,19,GA,1547,1544,3
2020,19,HI,1134,1148,-14
2020,19,IA,167,169,-2
2020,19,ID,106,118,-12
2020,19,IL,491,520,-29
2020,19,IN,196,205,-9
2020,19,KS,131,143,-12
2020,19,KY,196,190,6
2020,19,LA,9128,9073,55
2020,19,MA,636,637,-1
2020,19,MD,583,583,0
2020,19,ME,78,88,-10
2020,19,MI,235,225,10
2020,19,MN,107,113,-6
2020,19,MO,242,252,-10
2020,19,MS,1166,1183,-17
2020,19,MT,86,102,-16
2020,19,NC,2495,2408,87
2020,19,ND,95,99,-4
2020,19,NE,104,103,1
2020,19,NH,70,65,5
2020,19,NJ,2164,2162,2
2020,19,NM,77,80,-3
2020,19,NV,111,115,-4
2020,19,NY,3174,3203,-29
2020,19,OH,290,298,-8
2020,19,OK,195,200,-5
2020,19,OR,243,266,-23
2020,19,PA,645,659,-14
2020,19,PR,70,81,-11
2020,19,RI,131,135,-4
2020,19,SC,3084,3070,14
2020,19,SD,46,56,-10
2020,19,TN,373,369,4
2020,19,TX,13602,13034,568
2020,19,UT,72,75,-3
2020,19,VA,1457,1458,-1
2020,19,VI,13,15,-2
2020,19,VT,29,38,-9
2020,19,WA,360,361,-1
2020,19,WI,146,138,8
2020,19,WV,126,118,8
2020,19,WY,35,39,-4
2020,20,AK,46,38,8
2020,20,AL,958,869,89
2020,20,AR,130,137,-7
2020,20,AZ,326,334,-8
2020,20,CA,2074,2105,-31
2020,20,CO,413,444,-31
2020,20,CT,337,342,-5
2020,20,DC,29,26,3
2020,20,DE,323,320,3
2020,20,FL,28362,28489,-127
2020,20,GA,1338,1333,5
2020,20,HI,391,401,-10
2020,20,IA,253,258,-5
2020,20,ID,93,97,-4
2020,20,IL,397,421,-24
2020,20,IN,214,224,-10
2020,20,KS,140,150,-10
2020,20,KY,207,208,-1
2020,20,LA,9506,9327,179
2020,20,MA,566,584,-18
2020,20,MD,580,585,-5
2020,20,ME,69,75,-6
2020,20,MI,226,219,7
2020,20,MN,91,104,-13
2020,20,MO,236,242,-6
2020,20,MS,1249,1239,10
2020,20,MT,80,89,-9
2020,20,NC,2447,2395,52
2020,20,ND,71,78,-7
2020,20,NE,92,95,-3
2020,20,NH,64,66,-2
2020,20,NJ,2549,2564,-15
2020,20,NM,112,120,-8
2020,20,NV,184,188,-4
2020,20,NY,2051,2193,-142
2020,20,OH,275,262,13
2020,20,OK,171,183,-12
2020,20,OR,299,314,-15
2020,20,PA,774,801,-27
2020,20,PR,39,43,-4
2020,20,RI,115,111,4
2020,20,SC,3365,3303,62
2020,20,SD,44,46,-2
2020,20,TN,333,349,-16
2020,20,TX,16488,15643,845
2020,20,UT,61,63,-2
2020,20,VA,1470,1489,-19
2020,20,VI,14,16,-2
2020,20,VT,35,32,3
2020,20,WA,305,311,-6
2020,20,WI,159,167,-8
2020,20,WV,117,112,5
2020,20,WY,26,32,-6
2020,21,AK,28,28,0
2020,21,AL,965,964,1
2020,21,AR,156,174,-18
2020,21,AZ,312,338,-26
2020,21,CA,2130,2168,-38
2020,21,CO,325,329,-4
2020,21,CT,374,385,-11
2020,21,DC,30,32,-2
2020,21,DE,474,477,-3
2020,21,FL,32197,32223,-26
2020,21,GA,1383,1374,9
2020,21,HI,1030,1037,-7
2020,21,IA,134,145,-11
2020,21,ID,60,69,-9
2020,21,IL,431,455,-24
2020,21,IN,207,225,-18
2020,21,KS,132,156,-24
2020,21,KY,192,208,-16
2020,21,LA,10948,10779,169
2020,21,MA,607,612,-5
2020,21,MD,711,718,-7
2020,21,ME,93,98,-5
2020,21,MI,207,193,14
2020,21,MN,110,103,7
2020,21,MO,266,271,-5
2020,21,MS,1401,1388,13
2020,21,MT,90,91,-1
2020,21,NC,2503,2417,86
2020,21,ND,90,97,-7
2020,21,NE,109,114,-5
2020,21,NH,80,81,-1
2020,21,NJ,2528,2563,-35
2020,21,NM,99,105,-6
2020,21,NV,88,92,-4
2020,21,NY,3009,3073,-64
2020,21,OH,329,329,0
2020,21,OK,161,184,-23
2020,21,OR,225,282,-57
2020,21,PA,651,678,-27
2020,21,PR,33,64,-31
2020,21,RI,157,164,-7
2020,21,SC,4076,4021,55
2020,21,SD,51,54,-3
2020,21,TN,426,440,-14
2020,21,TX,18263,17370,893
2020,21,UT,61,90,-29
2020,21,VA,1602,1626,-24
2020,21,VI,7,8,-1
2020,21,VT,19,19,0
2020,21,WA,346,358,-12
2020,21,WI,170,167,3
2020,21,WV,115,121,-6
2020,21,WY,33,30,3
2020,22,AK,39,35,4
2020,22,AL,1535,1546,-11
2020,22,AR,273,289,-16
2020,22,AZ,330,338,-8
2020,22,CA,2376,2459,-83
2020,22,CO,406,422,-16
2020,22,CT,337,345,-8
2020,22,DC,29,28,1
2020,22,DE,452,446,6
2020,22,FL,39139,38933,206
2020,22,GA,1813,1815,-2
2020,22,HI,956,965,-9
2020,22,IA,171,187,-16
2020,22,ID,70,67,3
2020,22,IL,444,493,-49
2020,22,IN,223,246,-23
2020,22,KS,184,208,-24
2020,22,KY,229,227,2
2020,22,LA,12045,11757,288
2020,22,MA,707,725,-18
2020,22,MD,979,782,197
2020,22,ME,58,58,0
2020,22,MI,261,276,-15
2020,22,MN,113,116,-3
2020,22,MO,267,300,-33
2020,22,MS,1541,1535,6
2020,22,MT,70,71,-1
2020,22,NC,2900,2754,146
2020,22,ND,91,94,-3
2020,22,NE,115,118,-3
2020,22,NH,82,90,-8
2020,22,NJ,2857,2868,-11
2020,22,NM,100,109,-9
2020,22,NV,106,110,-4
2020,22,NY,2166,2265,-99
2020,22,OH,305,330,-25
2020,22,OK,192,217,-25
2020,22,OR,515,543,-28
2020,22,PA,599,625,-26
2020,22,PR,40,40,0
2020,22,RI,145,145,0
2020,22,SC,3782,3555,227
2020,22,SD,79,84,-5
2020,22,TN,638,657,-19
2020,22,TX,23339,20040,3299
2020,22,UT,54,61,-7
2020,22,VA,1818,1843,-25
2020,22,VI,7,12,-5
2020,22,VT,30,35,-5
2020,22,WA,361,374,-13
2020,22,WI,143,157,-14
2020,22,WV,130,135,-5
2020,22,WY,35,36,-1
2020,23,AK,14,15,-1
2020,23,AL,853,860,-7
2020,23,AR,165,173,-8
2020,23,AZ,308,323,-15
2020,23,CA,2119,2125,-6
2020,23,CO,318,380,-62
2020,23,CT,319,332,-13
2020,23,DC,256,258,-2
2020,23,DE,314,310,4
2020,23,FL,28802,28525,277
2020,23,GA,1289,1271,18
2020,23,HI,946,957,-11
2020,23,IA,152,164,-12
2020,23,ID,78,75,3
2020,23,IL,509,517,-8
2020,23,IN,212,229,-17
2020,23,KS,156,192,-36
2020,23,KY,215,251,-36
2020,23,LA,11089,10929,160
2020,23,MA,660,688,-28
2020,23,MD,667,672,-5
2020,23,ME,93,91,2
2020,23,MI,198,203,-5
2020,23,MN,78,93,-15
2020,23,MO,226,247,-21
2020,23,MS,1270,1249,21
2020,23,MT,67,69,-2
2020,23,NC,2570,2422,148
2020,23,ND,120,113,7
2020,23,NE,95,99,-4
2020,23,NH,61,59,2
2020,23,NJ,1997,1963,34
2020,23,NM,86,90,-4
2020,23,NV,92,102,-10
2020,23,NY,2017,2085,-68
2020,23,OH,331,345,-14
2020,23,OK,215,237,-22
2020,23,OR,265,289,-24
2020,23,PA,563,579,-16
2020,23,PR,57,54,3
2020,23,RI,131,123,8
2020,23,SC,3576,3518,58
2020,23,SD,29,33,-4
2020,23,TN,503,526,-23
2020,23,TX,23423,22348,1075
2020,23,UT,43,47,-4
2020,23,VA,1634,1626,8
2020,23,VI,14,15,-1
2020,23,VT,32,36,-4
2020,23,WA,417,424,-7
2020,23,WI,125,121,4
2020,23,WV,110,107,3
2020,23,WY,29,28,1
2020,24,AK,32,35,-3
2020,24,AL,739,753,-14
2020,24,AR,172,188,-16
2020,24,AZ,312,330,-18
2020,24,CA,2132,2235,-103
2020,24,CO,543,582,-39
2020,24,CT,352,368,-16
2020,24,DC,30,33,-3
2020,24,DE,364,375,-11
2020,24,FL,36004,35577,427
2020,24,GA,1529,1491,38
2020,24,HI,732,738,-6
2020,24,IA,155,169,-14
2020,24,ID,191,185,6
2020,24,IL,520,430,90
2020,24,IN,220,224,-4
2020,24,KS,225,373,-148
2020,24,KY,243,242,1
2020,24,LA,12270,11423,847
2020,24,MA,604,634,-30
2020,24,MD,877,876,1
2020,24,ME,77,82,-5
2020,24,MI,420,336,84
2020,24,MN,105,122,-17
2020,24,MO,233,247,-14
2020,24,MS,1523,1501,22
2020,24,MT,85,83,2
2020,24,NC,7973,7747,226
2020,24,ND,69,82,-13
2020,24,NE,102,106,-4
2020,24,NH,76,84,-8
2020,24,NJ,2557,2620,-63
2020,24,NM,114,124,-10
2020,24,NV,88,95,-7
2020,24,NY,2967,3065,-98
2020,24,OH,400,361,39
2020,24,OK,236,266,-30
2020,24,OR,228,249,-21
2020,24,PA,629,639,-10
2020,24,PR,37,153,-116
2020,24,RI,182,183,-1
2020,24,SC,4336,4085,251
2020,24,SD,47,42,5
2020,24,TN,491,576,-85
2020,24,TX,23914,20991,2923
2020,24,UT,82,55,27
2020,24,VA,1951,1935,16
2020,24,VI,98,103,-5
2020,24,VT,31,30,1
2020,24,WA,492,497,-5
2020,24,WI,187,184,3
2020,24,WV,123,131,-8
2020,24,WY,26,26,0
2020,25,AK,20,21,-1
2020,25,AL,908,945,-37
2020,25,AR,165,206,-41
2020,25,AZ,312,341,-29
2020,25,CA,2100,2177,-77
2020,25,CO,281,326,-45
2020,25,CT,381,399,-18
2020,25,DC,32,29,3
2020,25,DE,355,348,7
2020,25,FL,34148,34047,101
2020,25,GA,1505,1513,-8
2020,25,HI,777,786,-9
2020,25,IA,130,147,-17
2020,25,ID,75,77,-2
2020,25,IL,385,379,6
2020,25,IN,226,238,-12
2020,25,KS,154,223,-69
2020,25,KY,155,160,-5
2020,25,LA,12373,12292,81
2020,25,MA,566,587,-21
2020,25,MD,973,940,33
2020,25,ME,115,111,4
2020,25,MI,295,224,71
2020,25,MN,93,105,-12
2020,25,MO,241,265,-24
2020,25,MS,1370,1365,5
2020,25,MT,172,168,4
2020,25,NC,3036,2806,230
2020,25,ND,151,166,-15
2020,25,NE,92,107,-15
2020,25,NH,81,57,24
2020,25,NJ,2851,2950,-99
2020,25,NM,80,89,-9
2020,25,NV,86,86,0
2020,25,NY,2288,2364,-76
2020,25,OH,320,329,-9
2020,25,OK,283,387,-104
2020,25,OR,211,216,-5
2020,25,PA,587,613,-26
2020,25,PR,29,34,-5
2020,25,RI,156,166,-10
2020,25,SC,4096,4075,21
2020,25,SD,65,69,-4
2020,25,TN,514,515,-1
2020,25,TX,25763,23618,2145
2020,25,UT,58,53,5
2020,25,VA,1955,2003,-48
2020,25,VI,1,2,-1
2020,25,VT,29,30,-1
2020,25,WA,288,309,-21
2020,25,WI,119,111,8
2020,25,WV,116,116,0
2020,25,WY,18,18,0
2020,26,AK,28,28,0
2020,26,AL,990,1011,-21
2020,26,AR,181,212,-31
2020,26,AZ,382,381,1
2020,26,CA,2087,2189,-102
2020,26,CO,301,358,-57
2020,26,CT,537,556,-19
2020,26,DC,55,61,-6
2020,26,DE,620,623,-3
2020,26,FL,44768,44265,503
2020,26,GA,2080,2064,16
2020,26,HI,2098,1778,320
2020,26,IA,272,312,-40
2020,26,ID,66,85,-19
2020,26,IL,588,1249,-661
2020,26,IN,277,291,-14
2020,26,KS,186,226,-40
2020,26,KY,194,199,-5
2020,26,LA,17972,16753,1219
2020,26,MA,967,991,-24
2020,26,MD,1624,1657,-33
2020,26,ME,101,97,4
2020,26,MI,373,292,81
2020,26,MN,110,112,-2
2020,26,MO,292,345,-53
2020,26,MS,1824,1734,90
2020,26,MT,64,69,-5
2020,26,NC,3732,3561,171
2020,26,ND,154,175,-21
2020,26,NE,173,186,-13
2020,26,NH,97,99,-2
2020,26,NJ,3008,3082,-74
2020,26,NM,118,125,-7
2020,26,NV,116,124,-8
2020,26,NY,3341,3420,-79
2020,26,OH,410,431,-21
2020,26,OK,293,367,-74
2020,26,OR,273,285,-12
2020,26,PA,772,785,-13
2020,26,PR,52,55,-3
2020,26,RI,182,192,-10
2020,26,SC,5446,5362,84
2020,26,SD,91,100,-9
2020,26,TN,423,446,-23
2020,26,TX,39766,33311,6455
2020,26,UT,49,47,2
2020,26,VA,2671,2695,-24
2020,26,VI,12,13,-1
2020,26,VT,42,40,2
2020,26,WA,349,344,5
2020,26,WI,178,168,10
2020,26,WV,147,161,-14
2020,26,WY,27,26,1
2020,27,AK,18,17,1
2020,27,AL,890,914,-24
2020,27,AR,179,186,-7
2020,27,AZ,359,381,-22
2020,27,CA,1966,2050,-84
2020,27,CO,301,342,-41
2020,27,CT,363,368,-5
2020,27,DC,45,37,8
2020,27,DE,342,344,-2
2020,27,FL,36700,35517,1183
2020,27,GA,1795,1765,30
2020,27,HI,479,491,-12
2020,27,IA,196,200,-4
2020,27,ID,65,57,8
2020,27,IL,407,426,-19
2020,27,IN,259,278,-19
2020,27,KS,148,161,-13
2020,27,KY,185,201,-16
2020,27,LA,13081,12884,197
2020,27,MA,609,632,-23
2020,27,MD,829,838,-9
2020,27,ME,106,97,9
2020,27,MI,230,208,22
2020,27,MN,75,79,-4
2020,27,MO,247,267,-20
2020,27,MS,1402,1370,32
2020,27,MT,57,58,-1
2020,27,NC,3042,2969,73
2020,27,ND,64,69,-5
2020,27,NE,92,99,-7
2020,27,NH,70,76,-6
2020,27,NJ,2278,2517,-239
2020,27,NM,112,123,-11
2020,27,NV,79,90,-11
2020,27,NY,2429,2499,-70
2020,27,OH,347,346,1
2020,27,OK,189,219,-30
2020,27,OR,260,271,-11
2020,27,PA,578,594,-16
2020,27,PR,56,137,-81
2020,27,RI,152,161,-9
2020,27,SC,4412,4137,275
2020,27,SD,44,43,1
2020,27,TN,435,447,-12
2020,27,TX,27963,25799,2164
2020,27,UT,42,40,2
2020,27,VA,2018,2080,-62
2020,27,VI,12,11,1
2020,27,VT,26,31,-5
2020,27,WA,314,327,-13
2020,27,WI,124,138,-14
2020,27,WV,102,106,-4
2020,27,WY,28,29,-1
2020,28,AK,28,30,-2
2020,28,AL,761,752,9
2020,28,AR,167,180,-13
2020,28,AZ,453,433,20
2020,28,CA,2477,2535,-58
2020,28,CO,292,340,-48
2020,28,CT,463,480,-17
2020,28,DC,25,26,-1
2020,28,DE,353,352,1
2020,28,FL,34178,34094,84
2020,28,GA,1766,1791,-25
2020,28,HI,522,534,-12
2020,28,IA,180,190,-10
2020,28,ID,65,68,-3
2020,28,IL,674,684,-10
2020,28,IN,266,315,-49
2020,28,KS,166,175,-9
2020,28,KY,188,199,-11
2020,28,LA,12132,12037,95
2020,28,MA,807,852,-45
2020,28,MD,1064,1119,-55
2020,28,ME,121,122,-1
2020,28,MI,362,348,14
2020,28,MN,121,129,-8
2020,28,MO,251,274,-23
2020,28,MS,1341,1349,-8
2020,28,MT,76,87,-11
2020,28,NC,3605,3474,131
2020,28,ND,76,89,-13
2020,28,NE,112,113,-1
2020,28,NH,105,128,-23
2020,28,NJ,3871,3906,-35
2020,28,NM,137,145,-8
2020,28,NV,80,75,5
2020,28,NY,2616,2839,-223
2020,28,OH,389,414,-25
2020,28,OK,221,256,-35
2020,28,OR,251,269,-18
2020,28,PA,640,652,-12
2020,28,PR,45,41,4
2020,28,RI,178,187,-9
2020,28,SC,4195,4173,22
2020,28,SD,35,35,0
2020,28,TN,471,479,-8
2020,28,TX,26371,25936,435
2020,28,UT,53,59,-6
2020,28,VA,2073,2111,-38
2020,28,VI,3,5,-2
2020,28,VT,43,46,-3
2020,28,WA,326,339,-13
2020,28,WI,167,178,-11
2020,28,WV,128,141,-13
2020,28,WY,22,22,0
2020,29,AK,23,26,-3
2020,29,AL,804,792,12
2020,29,AR,165,167,-2
2020,29,AZ,442,385,57
2020,29,CA,1983,2056,-73
2020,29,CO,282,324,-42
2020,29,CT,457,463,-6
2020,29,DC,25,26,-1
2020,29,DE,349,350,-1
2020,29,FL,30511,30219,292
2020,29,GA,1623,1664,-41
2020,29,HI,776,794,-18
2020,29,IA,218,228,-10
2020,29,ID,68,60,8
2020,29,IL,501,522,-21
2020,29,IN,284,306,-22
2020,29,KS,133,142,-9
2020,29,KY,217,235,-18
2020,29,LA,11445,11485,-40
2020,29,MA,852,678,174
2020,29,MD,1151,1165,-14
2020,29,ME,100,98,2
2020,29,MI,275,256,19
2020,29,MN,136,139,-3
2020,29,MO,232,250,-18
2020,29,MS,1201,1198,3
2020,29,MT,57,58,-1
2020,29,NC,2837,2779,58
2020,29,ND,70,104,-34
2020,29,NE,84,87,-3
2020,29,NH,73,79,-6
2020,29,NJ,2353,2412,-59
2020,29,NM,108,112,-4
2020,29,NV,99,99,0
2020,29,NY,2808,2890,-82
2020,29,OH,374,404,-30
2020,29,OK,213,228,-15
2020,29,OR,228,252,-24
2020,29,PA,625,673,-48
2020,29,PR,45,47,-2
2020,29,RI,171,176,-5
2020,29,SC,3869,3812,57
2020,29,SD,43,42,1
2020,29,TN,409,453,-44
2020,29,TX,23909,22982,927
2020,29,UT,55,53,2
2020,29,VA,2035,2058,-23
2020,29,VI,8,7,1
2020,29,VT,48,47,1
2020,29,WA,369,374,-5
2020,29,WI,175,179,-4
2020,29,WV,125,134,-9
2020,29,WY,22,21,1
2020,30,AK,40,42,-2
2020,30,AL,1211,1220,-9
2020,30,AR,189,199,-10
2020,30,AZ,587,445,142
2020,30,CA,2386,2508,-122
2020,30,CO,299,316,-17
2020,30,CT,500,515,-15
2020,30,DC,37,41,-4
2020,30,DE,408,417,-9
2020,30,FL,39437,39581,-144
2020,30,GA,1922,1987,-65
2020,30,HI,1038,1045,-7
2020,30,IA,201,213,-12
2020,30,ID,106,52,54
2020,30,IL,513,520,-7
2020,30,IN,282,300,-18
2020,30,KS,167,166,1
2020,30,KY,235,235,0
2020,30,LA,13240,13200,40
2020,30,MA,903,925,-22
2020,30,MD,1182,1203,-21
2020,30,ME,127,134,-7
2020,30,MI,266,256,10
2020,30,MN,129,148,-19
2020,30,MO,273,292,-19
2020,30,MS,1677,1665,12
2020,30,MT,54,55,-1
2020,30,NC,3267,3261,6
2020,30,ND,89,93,-4
2020,30,NE,123,125,-2
2020,30,NH,84,91,-7
2020,30,NJ,3226,3272,-46
2020,30,NM,148,157,-9
2020,30,NV,113,127,-14
2020,30,NY,2933,3015,-82
2020,30,OH,428,443,-15
2020,30,OK,268,247,21
2020,30,OR,251,265,-14
2020,30,PA,766,801,-35
2020,30,PR,49,52,-3
2020,30,RI,271,291,-20
2020,30,SC,4644,4747,-103
2020,30,SD,34,36,-2
2020,30,TN,479,475,4
2020,30,TX,23582,22723,859
2020,30,UT,73,66,7
2020,30,VA,2557,2607,-50
2020,30,VI,12,11,1
2020,30,VT,40,43,-3
2020,30,WA,398,394,4
2020,30,WI,186,205,-19
2020,30,WV,140,141,-1
2020,30,WY,21,20,1
2020,31,AK,24,26,-2
2020,31,AL,761,766,-5
2020,31,AR,158,163,-5
2020,31,AZ,445,370,75
2020,31,CA,1912,1959,-47
2020,31,CO,242,281,-39
2020,31,CT,433,445,-12
2020,31,DC,34,44,-10
2020,31,DE,312,314,-2
2020,31,FL,23798,23933,-135
2020,31,GA,1533,1544,-11
2020,31,HI,1154,1156,-2
2020,31,IA,130,128,2
2020,31,ID,61,66,-5
2020,31,IL,335,340,-5
2020,31,IN,249,269,-20
2020,31,KS,97,110,-13
2020,31,KY,180,182,-2
2020,31,LA,8864,8677,187
2020,31,MA,644,668,-24
2020,31,MD,659,689,-30
2020,31,ME,86,84,2
2020,31,MI,181,168,13
2020,31,MN,77,80,-3
2020,31,MO,199,201,-2
2020,31,MS,967,968,-1
2020,31,MT,33,33,0
2020,31,NC,2722,2688,34
2020,31,ND,61,75,-14
2020,31,NE,72,79,-7
2020,31,NH,72,69,3
2020,31,NJ,2281,2308,-27
2020,31,NM,150,151,-1
2020,31,NV,112,123,-11
2020,31,NY,2148,2238,-90
2020,31,OH,349,337,12
2020,31,OK,158,176,-18
2020,31,OR,195,212,-17
2020,31,PA,716,734,-18
2020,31,PR,47,46,1
2020,31,RI,175,187,-12
2020,31,SC,3441,3364,77
2020,31,SD,41,48,-7
2020,31,TN,361,383,-22
2020,31,TX,17155,16740,415
2020,31,UT,56,41,15
2020,31,VA,1828,1861,-33
2020,31,VI,6,6,0
2020,31,VT,33,37,-4
2020,31,WA,317,316,1
2020,31,WI,119,116,3
2020,31,WV,105,112,-7
2020,31,WY,33,28,5
2020,32,AK,30,30,0
2020,32,AL,790,771,19
2020,32,AR,167,171,-4
2020,32,AZ,508,458,50
2020,32,CA,2129,2195,-66
2020,32,CO,309,343,-34
2020,32,CT,437,433,4
2020,32,DC,50,50,0
2020,32,DE,442,452,-10
2020,32,FL,30709,31135,-426
2020,32,GA,1868,1918,-50
2020,32,HI,711,717,-6
2020,32,IA,163,166,-3
2020,32,ID,76,66,10
2020,32,IL,389,423,-34
2020,32,IN,268,277,-9
2020,32,KS,127,131,-4
2020,32,KY,217,228,-11
2020,32,LA,12265,12656,-391
2020,32,MA,764,795,-31
2020,32,MD,802,869,-67
2020,32,ME,145,110,35
2020,32,MI,287,273,14
2020,32,MN,119,122,-3
2020,32,MO,227,230,-3
2020,32,MS,1174,1190,-16
2020,32,MT,45,48,-3
2020,32,NC,3364,3222,142
2020,32,ND,99,107,-8
2020,32,NE,111,116,-5
2020,32,NH,67,71,-4
2020,32,NJ,3358,3430,-72
2020,32,NM,166,175,-9
2020,32,NV,108,118,-10
2020,32,NY,2651,2716,-65
2020,32,OH,375,410,-35
2020,32,OK,210,225,-15
2020,32,OR,271,284,-13
2020,32,PA,761,788,-27
2020,32,PR,45,47,-2
2020,32,RI,399,407,-8
2020,32,SC,4365,4445,-80
2020,32,SD,38,41,-3
2020,32,TN,449,472,-23
2020,32,TX,19600,19388,212
2020,32,UT,49,45,4
2020,32,VA,2188,2274,-86
2020,32,VI,17,19,-2
2020,32,VT,43,44,-1
2020,32,WA,400,401,-1
2020,32,WI,156,166,-10
2020,32,WV,151,160,-9
2020,32,WY,20,22,-2
2020,33,AK,23,23,0
2020,33,AL,727,769,-42
2020,33,AR,162,178,-16
2020,33,AZ,630,530,100
2020,33,CA,2241,2264,-23
2020,33,CO,286,288,-2
2020,33,CT,623,648,-25
2020,33,DC,36,39,-3
2020,33,DE,380,372,8
2020,33,FL,28601,28359,242
2020,33,GA,1620,1656,-36
2020,33,HI,1576,1562,14
2020,33,IA,171,168,3
2020,33,ID,80,53,27
2020,33,IL,557,567,-10
2020,33,IN,234,239,-5
2020,33,KS,91,102,-11
2020,33,KY,199,210,-11
2020,33,LA,10353,10097,256
2020,33,MA,758,773,-15
2020,33,MD,884,913,-29
2020,33,ME,104,108,-4
2020,33,MI,247,230,17
2020,33,MN,102,109,-7
2020,33,MO,239,243,-4
2020,33,MS,1112,1076,36
2020,33,MT,60,57,3
2020,33,NC,3073,3007,66
2020,33,ND,105,108,-3
2020,33,NE,71,75,-4
2020,33,NH,62,61,1
2020,33,NJ,2714,2750,-36
2020,33,NM,128,127,1
2020,33,NV,142,147,-5
2020,33,NY,2667,2911,-244
2020,33,OH,391,412,-21
2020,33,OK,161,167,-6
2020,33,OR,246,264,-18
2020,33,PA,969,1008,-39
2020,33,PR,52,52,0
2020,33,RI,235,253,-18
2020,33,SC,4341,4283,58
2020,33,SD,54,57,-3
2020,33,TN,405,406,-1
2020,33,TX,17516,15859,1657
2020,33,UT,63,54,9
2020,33,VA,1969,2057,-88
2020,33,VI,21,19,2
2020,33,VT,35,32,3
2020,33,WA,582,566,16
2020,33,WI,128,146,-18
2020,33,WV,140,148,-8
2020,33,WY,38,37,1
2020,34,AK,33,30,3
2020,34,AL,1053,1019,34
2020,34,AR,212,212,0
2020,34,AZ,616,788,-172
2020,34,CA,2248,2336,-88
2020,34,CO,355,364,-9
2020,34,CT,455,461,-6
2020,34,DC,103,105,-2
2020,34,DE,551,565,-14
2020,34,FL,30094,29195,899
2020,34,GA,1712,1708,4
2020,34,HI,2742,2735,7
2020,34,IA,163,164,-1
2020,34,ID,108,59,49
2020,34,IL,589,479,110
2020,34,IN,210,227,-17
2020,34,KS,105,96,9
2020,34,KY,226,235,-9
2020,34,LA,11011,10681,330
2020,34,MA,1145,1207,-62
2020,34,MD,985,983,2
2020,34,ME,114,106,8
2020,34,MI,214,207,7
2020,34,MN,99,117,-18
2020,34,MO,225,230,-5
2020,34,MS,1169,1175,-6
2020,34,MT,52,53,-1
2020,34,NC,3327,3242,85
2020,34,ND,106,116,-10
2020,34,NE,90,99,-9
2020,34,NH,86,81,5
2020,34,NJ,2831,2814,17
2020,34,NM,164,170,-6
2020,34,NV,116,117,-1
2020,34,NY,3054,3107,-53
2020,34,OH,363,383,-20
2020,34,OK,162,171,-9
2020,34,OR,354,373,-19
2020,34,PA,716,746,-30
2020,34,PR,51,43,8
2020,34,RI,266,276,-10
2020,34,SC,4382,4317,65
2020,34,SD,56,60,-4
2020,34,TN,530,566,-36
2020,34,TX,18009,15478,2531
2020,34,UT,54,51,3
2020,34,VA,2543,2506,37
2020,34,VI,7,8,-1
2020,34,VT,44,41,3
2020,34,WA,388,359,29
2020,34,WI,158,164,-6
2020,34,WV,122,132,-10
2020,34,WY,13,14,-1
2020,35,AK,34,35,-1
2020,35,AL,904,890,14
2020,35,AR,168,175,-7
2020,35,AZ,463,503,-40
2020,35,CA,2403,2435,-32
2020,35,CO,427,448,-21
2020,35,CT,570,586,-16
2020,35,DC,55,45,10
2020,35,DE,412,401,11
2020,35,FL,30581,30768,-187
2020,35,GA,1863,1883,-20
2020,35,HI,2464,2448,16
2020,35,IA,182,183,-1
2020,35,ID,63,51,12
2020,35,IL,407,416,-9
2020,35,IN,251,263,-12
2020,35,KS,121,120,1
2020,35,KY,228,216,12
2020,35,LA,10401,10284,117
2020,35,MA,904,934,-30
2020,35,MD,1484,1423,61
2020,35,ME,103,104,-1
2020,35,MI,221,207,14
2020,35,MN,115,113,2
2020,35,MO,218,239,-21
2020,35,MS,1085,1093,-8
2020,35,MT,54,51,3
2020,35,NC,3355,3256,99
2020,35,ND,146,162,-16
2020,35,NE,92,90,2
2020,35,NH,133,146,-13
2020,35,NJ,3135,3199,-64
2020,35,NM,144,149,-5
2020,35,NV,133,143,-10
2020,35,NY,3125,3126,-1
2020,35,OH,383,403,-20
2020,35,OK,196,224,-28
2020,35,OR,447,464,-17
2020,35,PA,791,772,19
2020,35,PR,65,56,9
2020,35,RI,229,244,-15
2020,35,SC,4040,3994,46
2020,35,SD,51,53,-2
2020,35,TN,421,416,5
2020,35,TX,16411,15476,935
2020,35,UT,69,71,-2
2020,35,VA,2500,2389,111
2020,35,VI,15,12,3
2020,35,VT,35,39,-4
2020,35,WA,414,399,15
2020,35,WI,171,184,-13
2020,35,WV,169,184,-15
2020,35,WY,22,22,0
2020,36,AK,37,37,0
2020,36,AL,1087,1090,-3
2020,36,AR,150,156,-6
2020,36,AZ,369,375,-6
2020,36,CA,2165,2197,-32
2020,36,CO,299,316,-17
2020,36,CT,443,468,-25
2020,36,DC,35,31,4
2020,36,DE,430,416,14
2020,36,FL,24667,24684,-17
2020,36,GA,1448,1465,-17
2020,36,HI,2475,2483,-8
2020,36,IA,121,132,-11
2020,36,ID,58,55,3
2020,36,IL,311,320,-9
2020,36,IN,208,208,0
2020,36,KS,123,127,-4
2020,36,KY,191,198,-7
2020,36,LA,8707,8502,205
2020,36,MA,839,881,-42
2020,36,MD,738,701,37
2020,36,ME,117,115,2
2020,36,MI,245,240,5
2020,36,MN,77,83,-6
2020,36,MO,252,241,11
2020,36,MS,921,913,8
2020,36,MT,58,61,-3
2020,36,NC,2733,2696,37
2020,36,ND,152,157,-5
2020,36,NE,72,78,-6
2020,36,NH,76,78,-2
2020,36,NJ,2659,2707,-48
2020,36,NM,128,126,2
2020,36,NV,97,104,-7
2020,36,NY,2850,2903,-53
2020,36,OH,293,309,-16
2020,36,OK,148,159,-11
2020,36,OR,282,308,-26
2020,36,PA,748,719,29
2020,36,PR,51,40,11
2020,36,RI,253,264,-11
2020,36,SC,3517,3505,12
2020,36,SD,34,41,-7
2020,36,TN,351,366,-15
2020,36,TX,13770,13159,611
2020,36,UT,54,53,1
2020,36,VA,2008,1956,52
2020,36,VI,9,10,-1
2020,36,VT,49,67,-18
2020,36,WA,377,341,36
2020,36,WI,142,145,-3
2020,36,WV,154,156,-2
2020,36,WY,18,22,-4
2020,37,AK,33,34,-1
2020,37,AL,810,785,25
2020,37,AR,163,170,-7
2020,37,AZ,468,503,-35
2020,37,CA,2553,2532,21
2020,37,CO,334,327,7
2020,37,CT,551,565,-14
2020,37,DC,46,50,-4
2020,37,DE,408,407,1
2020,37,FL,26355,26203,152
2020,37,GA,1530,1569,-39
2020,37,HI,1281,1273,8
2020,37,IA,165,164,1
2020,37,ID,67,65,2
2020,37,IL,386,373,13
2020,37,IN,227,239,-12
2020,37,KS,130,131,-1
2020,37,KY,202,200,2
2020,37,LA,12670,12551,119
2020,37,MA,965,986,-21
2020,37,MD,988,966,22
2020,37,ME,118,115,3
2020,37,MI,231,201,30
2020,37,MN,100,104,-4
2020,37,MO,206,212,-6
2020,37,MS,1142,1128,14
2020,37,MT,49,44,5
2020,37,NC,2786,2770,16
2020,37,ND,160,172,-12
2020,37,NE,82,88,-6
2020,37,NH,104,105,-1
2020,37,NJ,2814,2915,-101
2020,37,NM,155,166,-11
2020,37,NV,112,116,-4
2020,37,NY,3371,3449,-78
2020,37,OH,334,351,-17
2020,37,OK,168,168,0
2020,37,OR,265,276,-11
2020,37,PA,791,784,7
2020,37,PR,56,51,5
2020,37,RI,187,196,-9
2020,37,SC,3694,3647,47
2020,37,SD,33,36,-3
2020,37,TN,410,411,-1
2020,37,TX,15049,14371,678
2020,37,UT,55,47,8
2020,37,VA,2140,2116,24
2020,37,VI,22,21,1
2020,37,VT,42,41,1
2020,37,WA,439,414,25
2020,37,WI,150,155,-5
2020,37,WV,118,124,-6
2020,37,WY,13,15,-2
2020,38,AK,39,39,0
2020,38,AL,784,788,-4
2020,38,AR,175,174,1
2020,38,AZ,496,514,-18
2020,38,CA,2705,2706,-1
2020,38,CO,289,290,-1
2020,38,CT,484,504,-20
2020,38,DC,38,35,3
2020,38,DE,463,462,1
2020,38,FL,27968,27681,287
2020,38,GA,1657,1675,-18
2020,38,HI,1270,1285,-15
2020,38,IA,283,298,-15
2020,38,ID,75,66,9
2020,38,IL,422,432,-10
2020,38,IN,218,231,-13
2020,38,KS,137,149,-12
2020,38,KY,229,217,12
2020,38,LA,14489,14082,407
2020,38,MA,975,1001,-26
2020,38,MD,964,995,-31
2020,38,ME,129,122,7
2020,38,MI,326,304,22
2020,38,MN,95,104,-9
2020,38,MO,225,229,-4
2020,38,MS,1191,1131,60
2020,38,MT,57,61,-4
2020,38,NC,2823,2801,22
2020,38,ND,156,167,-11
2020,38,NE,83,87,-4
2020,38,NH,145,146,-1
2020,38,NJ,3221,3290,-69
2020,38,NM,129,144,-15
2020,38,NV,139,146,-7
2020,38,NY,3527,3657,-130
2020,38,OH,374,398,-24
2020,38,OK,193,197,-4
2020,38,OR,288,314,-26
2020,38,PA,832,817,15
2020,38,PR,61,66,-5
2020,38,RI,479,496,-17
2020,38,SC,4415,4420,-5
2020,38,SD,39,49,-10
2020,38,TN,445,437,8
2020,38,TX,19110,15950,3160
2020,38,UT,62,55,7
2020,38,VA,2123,2166,-43
2020,38,VI,11,10,1
2020,38,VT,44,44,0
2020,38,WA,435,433,2
2020,38,WI,203,209,-6
2020,38,WV,148,152,-4
2020,38,WY,13,15,-2
2020,39,AK,50,54,-4
2020,39,AL,1202,1234,-32
2020,39,AR,234,228,6
2020,39,AZ,462,491,-29
2020,39,CA,3139,3229,-90
2020,39,CO,307,311,-4
2020,39,CT,635,651,-16
2020,39,DC,52,49,3
2020,39,DE,540,558,-18
2020,39,FL,43011,44553,-1542
2020,39,GA,2231,2383,-152
2020,39,HI,1810,1819,-9
2020,39,IA,161,179,-18
2020,39,ID,82,74,8
2020,39,IL,463,498,-35
2020,39,IN,289,300,-11
2020,39,KS,130,136,-6
2020,39,KY,253,282,-29
2020,39,LA,13716,13659,57
2020,39,MA,1279,1316,-37
2020,39,MD,1572,1618,-46
2020,39,ME,156,165,-9
2020,39,MI,228,207,21
2020,39,MN,137,149,-12
2020,39,MO,259,283,-24
2020,39,MS,1199,1212,-13
2020,39,MT,52,53,-1
2020,39,NC,3702,3964,-262
2020,39,ND,146,168,-22
2020,39,NE,107,117,-10
2020,39,NH,114,115,-1
2020,39,NJ,3627,3721,-94
2020,39,NM,119,129,-10
2020,39,NV,116,128,-12
2020,39,NY,3826,3908,-82
2020,39,OH,457,500,-43
2020,39,OK,213,225,-12
2020,39,OR,356,354,2
2020,39,PA,1067,1091,-24
2020,39,PR,64,111,-47
2020,39,RI,231,256,-25
2020,39,SC,6168,6407,-239
2020,39,SD,51,53,-2
2020,39,TN,559,576,-17
2020,39,TX,25016,24845,171
2020,39,UT,77,74,3
2020,39,VA,3615,3764,-149
2020,39,VI,10,10,0
2020,39,VT,46,47,-1
2020,39,WA,672,574,98
2020,39,WI,214,232,-18
2020,39,WV,136,144,-8
2020,39,WY,19,32,-13
2020,40,AK,30,32,-2
2020,40,AL,978,1007,-29
2020,40,AR,138,156,-18
2020,40,AZ,412,455,-43
2020,40,CA,2932,3081,-149
2020,40,CO,287,304,-17
2020,40,CT,527,559,-32
2020,40,DC,62,66,-4
2020,40,DE,564,590,-26
2020,40,FL,29034,30208,-1174
2020,40,GA,1923,2139,-216
2020,40,HI,1325,1307,18
2020,40,IA,117,120,-3
2020,40,ID,139,135,4
2020,40,IL,417,438,-21
2020,40,IN,233,254,-21
2020,40,KS,118,131,-13
2020,40,KY,173,183,-10
2020,40,LA,9512,9552,-40
2020,40,MA,1119,1167,-48
2020,40,MD,1165,1231,-66
2020,40,ME,174,174,0
2020,40,MI,233,222,11
2020,40,MN,105,119,-14
2020,40,MO,222,228,-6
2020,40,MS,923,963,-40
2020,40,MT,51,49,2
2020,40,NC,3455,3699,-244
2020,40,ND,83,92,-9
2020,40,NE,79,80,-1
2020,40,NH,99,100,-1
2020,40,NJ,2693,2829,-136
2020,40,NM,123,130,-7
2020,40,NV,104,115,-11
2020,40,NY,3462,3620,-158
2020,40,OH,314,357,-43
2020,40,OK,200,214,-14
2020,40,OR,325,349,-24
2020,40,PA,947,985,-38
2020,40,PR,35,48,-13
2020,40,RI,210,220,-10
2020,40,SC,4047,4349,-302
2020,40,SD,33,32,1
2020,40,TN,415,438,-23
2020,40,TX,20061,21323,-1262
2020,40,UT,61,74,-13
2020,40,VA,2935,3263,-328
2020,40,VI,8,9,-1
2020,40,VT,49,50,-1
2020,40,WA,480,469,11
2020,40,WI,150,153,-3
2020,40,WV,127,138,-11
2020,40,WY,20,19,1
2020,41,AK,20,27,-7
2020,41,AL,669,664,5
2020,41,AR,159,169,-10
2020,41,AZ,470,492,-22
2020,41,CA,3597,3703,-106
2020,41,CO,366,397,-31
2020,41,CT,544,572,-28
2020,41,DC,79,68,11
2020,41,DE,472,470,2
2020,41,FL,27425,28186,-761
2020,41,GA,1646,1682,-36
2020,41,HI,551,572,-21
2020,41,IA,156,133,23
2020,41,ID,80,76,4
2020,41,IL,414,447,-33
2020,41,IN,238,250,-12
2020,41,KS,101,111,-10
2020,41,KY,207,211,-4
2020,41,LA,9141,9086,55
2020,41,MA,1252,1214,38
2020,41,MD,1292,1291,1
2020,41,ME,194,200,-6
2020,41,MI,261,253,8
2020,41,MN,110,115,-5
2020,41,MO,215,221,-6
2020,41,MS,931,902,29
2020,41,MT,44,45,-1
2020,41,NC,2871,2996,-125
2020,41,ND,115,129,-14
2020,41,NE,74,81,-7
2020,41,NH,96,97,-1
2020,41,NJ,2889,2994,-105
2020,41,NM,162,165,-3
2020,41,NV,113,123,-10
2020,41,NY,3431,3574,-143
2020,41,OH,357,367,-10
2020,41,OK,162,178,-16
2020,41,OR,397,370,27
2020,41,PA,972,981,-9
2020,41,PR,30,30,0
2020,41,RI,215,223,-8
2020,41,SC,3429,3509,-80
2020,41,SD,43,55,-12
2020,41,TN,478,464,14
2020,41,TX,16699,17509,-810
2020,41,UT,67,70,-3
2020,41,VA,2814,2959,-145
2020,41,VI,10,12,-2
2020,41,VT,46,50,-4
2020,41,WA,619,589,30
2020,41,WI,151,160,-9
2020,41,WV,143,142,1
2020,41,WY,17,18,-1
2020,42,AK,49,49,0
2020,42,AL,620,633,-13
2020,42,AR,161,167,-6
2020,42,AZ,481,510,-29
2020,42,CA,4037,4121,-84
2020,42,CO,293,318,-25
2020,42,CT,641,662,-21
2020,42,DC,50,38,12
2020,42,DE,398,407,-9
2020,42,FL,27045,27167,-122
2020,42,GA,1740,1768,-28
2020,42,HI,1765,1781,-16
2020,42,IA,187,194,-7
2020,42,ID,84,81,3
2020,42,IL,388,402,-14
2020,42,IN,254,263,-9
2020,42,KS,119,133,-14
2020,42,KY,159,165,-6
2020,42,LA,7984,7954,30
2020,42,MA,1113,1156,-43
2020,42,MD,936,943,-7
2020,42,ME,159,163,-4
2020,42,MI,232,209,23
2020,42,MN,135,144,-9
2020,42,MO,214,229,-15
2020,42,MS,923,904,19
2020,42,MT,54,52,2
2020,42,NC,2566,2694,-128
2020,42,ND,127,134,-7
2020,42,NE,79,86,-7
2020,42,NH,88,86,2
2020,42,NJ,2831,2912,-81
2020,42,NM,105,109,-4
2020,42,NV,144,139,5
2020,42,NY,2714,2825,-111
2020,42,OH,367,383,-16
2020,42,OK,196,215,-19
2020,42,OR,619,388,231
2020,42,PA,908,904,4
2020,42,PR,30,32,-2
2020,42,RI,191,192,-1
2020,42,SC,3576,3712,-136
2020,42,SD,35,34,1
2020,42,TN,410,405,5
2020,42,TX,17808,18587,-779
2020,42,UT,80,80,0
2020,42,VA,2391,2465,-74
2020,42,VI,9,8,1
2020,42,VT,49,53,-4
2020,42,WA,546,537,9
2020,42,WI,151,155,-4
2020,42,WV,145,151,-6
2020,42,WY,21,19,2
2020,43,AK,32,36,-4
2020,43,AL,1028,902,126
2020,43,AR,141,154,-13
2020,43,AZ,391,411,-20
2020,43,CA,3731,3844,-113
2020,43,CO,358,367,-9
2020,43,CT,511,551,-40
2020,43,DC,51,44,7
2020,43,DE,588,594,-6
2020,43,FL,28012,28755,-743
2020,43,GA,1602,1659,-57
2020,43,HI,1436,1453,-17
2020,43,IA,148,156,-8
2020,43,ID,74,76,-2
2020,43,IL,433,465,-32
2020,43,IN,247,275,-28
2020,43,KS,117,129,-12
2020,43,KY,215,227,-12
2020,43,LA,8786,8791,-5
2020,43,MA,1350,1422,-72
2020,43,MD,1060,1079,-19
2020,43,ME,161,160,1
2020,43,MI,253,272,-19
2020,43,MN,112,129,-17
2020,43,MO,229,242,-13
2020,43,MS,944,949,-5
2020,43,MT,47,56,-9
2020,43,NC,2810,2898,-88
2020,43,ND,171,185,-14
2020,43,NE,81,94,-13
2020,43,NH,100,104,-4
2020,43,NJ,2580,2670,-90
2020,43,NM,117,128,-11
2020,43,NV,130,141,-11
2020,43,NY,2783,2911,-128
2020,43,OH,386,405,-19
2020,43,OK,174,181,-7
2020,43,OR,420,411,9
2020,43,PA,1062,1088,-26
2020,43,PR,35,35,0
2020,43,RI,199,208,-9
2020,43,SC,3777,3875,-98
2020,43,SD,32,44,-12
2020,43,TN,433,440,-7
2020,43,TX,15157,16094,-937
2020,43,UT,94,123,-29
2020,43,VA,2033,2132,-99
2020,43,VI,7,6,1
2020,43,VT,60,57,3
2020,43,WA,755,640,115
2020,43,WI,169,175,-6
2020,43,WV,117,123,-6
2020,43,WY,21,24,-3
2020,44,AK,42,41,1
2020,44,AL,907,911,-4
2020,44,AR,119,121,-2
2020,44,AZ,364,386,-22
2020,44,CA,3866,3999,-133
2020,44,CO,365,356,9
2020,44,CT,387,392,-5
2020,44,DC,39,29,10
2020,44,DE,321,309,12
2020,44,FL,24136,24630,-494
2020,44,GA,1362,1421,-59
2020,44,HI,1509,1313,196
2020,44,IA,149,173,-24
2020,44,ID,76,68,8
2020,44,IL,344,361,-17
2020,44,IN,241,249,-8
2020,44,KS,108,115,-7
2020,44,KY,194,212,-18
2020,44,LA,6548,6401,147
2020,44,MA,891,934,-43
2020,44,MD,888,884,4
2020,44,ME,137,144,-7
2020,44,MI,204,200,4
2020,44,MN,102,104,-2
2020,44,MO,191,195,-4
2020,44,MS,830,806,24
2020,44,MT,39,44,-5
2020,44,NC,2472,2586,-114
2020,44,ND,112,134,-22
2020,44,NE,74,83,-9
2020,44,NH,86,84,2
2020,44,NJ,3262,3356,-94
2020,44,NM,96,107,-11
2020,44,NV,106,115,-9
2020,44,NY,2604,2680,-76
2020,44,OH,294,309,-15
2020,44,OK,208,212,-4
2020,44,OR,451,441,10
2020,44,PA,690,730,-40
2020,44,PR,28,21,7
2020,44,RI,147,158,-11
2020,44,SC,3325,3420,-95
2020,44,SD,37,41,-4
2020,44,TN,393,411,-18
2020,44,TX,12165,12450,-285
2020,44,UT,76,96,-20
2020,44,VA,1550,1616,-66
2020,44,VI,3,3,0
2020,44,VT,56,51,5
2020,44,WA,682,683,-1
2020,44,WI,143,155,-12
2020,44,WV,143,152,-9
2020,44,WY,21,22,-1
2020,45,AK,16,17,-1
2020,45,AL,708,725,-17
2020,45,AR,132,151,-19
2020,45,AZ,313,315,-2
2020,45,CA,3729,3854,-125
2020,45,CO,338,342,-4
2020,45,CT,515,531,-16
2020,45,DC,32,33,-1
2020,45,DE,301,315,-14
2020,45,FL,19556,19828,-272
2020,45,GA,1126,1168,-42
2020,45,HI,556,572,-16
2020,45,IA,104,112,-8
2020,45,ID,76,82,-6
2020,45,IL,322,339,-17
2020,45,IN,203,222,-19
2020,45,KS,93,96,-3
2020,45,KY,164,190,-26
2020,45,LA,5972,5909,63
2020,45,MA,814,860,-46
2020,45,MD,849,847,2
2020,45,ME,116,120,-4
2020,45,MI,184,175,9
2020,45,MN,172,181,-9
2020,45,MO,213,230,-17
2020,45,MS,784,804,-20
2020,45,MT,34,38,-4
2020,45,NC,2737,2858,-121
2020,45,ND,87,109,-22
2020,45,NE,54,62,-8
2020,45,NH,96,98,-2
2020,45,NJ,2971,3054,-83
2020,45,NM,88,92,-4
2020,45,NV,94,110,-16
2020,45,NY,2290,2431,-141
2020,45,OH,275,294,-19
2020,45,OK,138,155,-17
2020,45,OR,408,400,8
2020,45,PA,670,670,0
2020,45,PR,29,33,-4
2020,45,RI,122,127,-5
2020,45,SC,2939,3055,-116
2020,45,SD,32,31,1
2020,45,TN,333,328,5
2020,45,TX,9791,10149,-358
2020,45,UT,52,49,3
2020,45,VA,1448,1483,-35
2020,45,VI,1,2,-1
2020,45,VT,47,43,4
2020,45,WA,634,605,29
2020,45,WI,119,127,-8
2020,45,WV,128,130,-2
2020,45,WY,18,19,-1
2020,46,AK,51,52,-1
2020,46,AL,882,883,-1
2020,46,AR,133,135,-2
2020,46,AZ,337,367,-30
2020,46,CA,4040,4369,-329
2020,46,CO,318,297,21
2020,46,CT,406,410,-4
2020,46,DC,21,21,0
2020,46,DE,438,453,-15
2020,46,FL,23097,23555,-458
2020,46,GA,1170,1256,-86
2020,46,HI,495,495,0
2020,46,IA,108,126,-18
2020,46,ID,62,59,3
2020,46,IL,327,331,-4
2020,46,IN,231,239,-8
2020,46,KS,90,100,-10
2020,46,KY,183,192,-9
2020,46,LA,6630,6730,-100
2020,46,MA,771,811,-40
2020,46,MD,995,1013,-18
2020,46,ME,129,142,-13
2020,46,MI,246,248,-2
2020,46,MN,89,108,-19
2020,46,MO,229,236,-7
2020,46,MS,1101,1104,-3
2020,46,MT,43,44,-1
2020,46,NC,2364,2523,-159
2020,46,ND,98,120,-22
2020,46,NE,72,69,3
2020,46,NH,78,75,3
2020,46,NJ,2651,2716,-65
2020,46,NM,122,124,-2
2020,46,NV,123,135,-12
2020,46,NY,2246,2335,-89
2020,46,OH,344,358,-14
2020,46,OK,160,175,-15
2020,46,OR,504,532,-28
2020,46,PA,655,650,5
2020,46,PR,47,38,9
2020,46,RI,136,141,-5
2020,46,SC,3141,3261,-120
2020,46,SD,25,34,-9
2020,46,TN,313,331,-18
2020,46,TX,10465,11015,-550
2020,46,UT,80,78,2
2020,46,VA,1565,1628,-63
2020,46,VI,11,12,-1
2020,46,VT,37,52,-15
2020,46,WA,632,622,10
2020,46,WI,124,125,-1
2020,46,WV,119,124,-5
2020,46,WY,16,17,-1
2020,47,AK,40,40,0
2020,47,AL,546,554,-8
2020,47,AR,94,98,-4
2020,47,AZ,248,266,-18
2020,47,CA,4926,5210,-284
2020,47,CO,193,202,-9
2020,47,CT,370,376,-6
2020,47,DC,59,57,2
2020,47,DE,307,305,2
2020,47,FL,18737,18373,364
2020,47,GA,919,905,14
2020,47,GU,1,1,0
2020,47,HI,1014,1019,-5
2020,47,IA,186,196,-10
2020,47,ID,70,67,3
2020,47,IL,273,291,-18
2020,47,IN,188,192,-4
2020,47,KS,82,80,2
2020,47,KY,144,157,-13
2020,47,LA,5577,5671,-94
2020,47,MA,713,747,-34
2020,47,MD,862,845,17
2020,47,ME,88,93,-5
2020,47,MI,205,210,-5
2020,47,MN,71,87,-16
2020,47,MO,149,168,-19
2020,47,MS,646,655,-9
2020,47,MT,41,38,3
2020,47,NC,1667,1765,-98
2020,47,ND,82,107,-25
2020,47,NE,62,61,1
2020,47,NH,87,84,3
2020,47,NJ,2088,2143,-55
2020,47,NM,92,98,-6
2020,47,NV,97,109,-12
2020,47,NY,2294,2349,-55
2020,47,OH,232,245,-13
2020,47,OK,131,139,-8
2020,47,OR,394,386,8
2020,47,PA,580,605,-25
2020,47,PR,28,29,-1
2020,47,RI,201,147,54
2020,47,SC,2194,2216,-22
2020,47,SD,29,37,-8
2020,47,TN,421,439,-18
2020,47,TX,8471,8822,-351
2020,47,UT,36,46,-10
2020,47,VA,1291,1349,-58
2020,47,VI,9,10,-1
2020,47,VT,45,44,1
2020,47,WA,524,516,8
2020,47,WI,103,105,-2
2020,47,WV,92,98,-6
2020,47,WY,22,25,-3
2020,48,AK,26,30,-4
2020,48,AL,934,957,-23
2020,48,AR,102,114,-12
2020,48,AZ,305,335,-30
2020,48,CA,5183,5527,-344
2020,48,CO,234,245,-11
2020,48,CT,667,672,-5
2020,48,DC,40,36,4
2020,48,DE,341,349,-8
2020,48,FL,25595,26073,-478
2020,48,GA,1091,1106,-15
2020,48,HI,1239,1280,-41
2020,48,IA,96,96,0
2020,48,ID,68,67,1
2020,48,IL,376,408,-32
2020,48,IN,177,196,-19
2020,48,KS,95,105,-10
2020,48,KY,198,196,2
2020,48,LA,6221,6323,-102
2020,48,MA,889,910,-21
2020,48,MD,704,727,-23
2020,48,ME,135,144,-9
2020,48,MI,214,210,4
2020,48,MN,127,137,-10
2020,48,MO,201,201,0
2020,48,MS,971,967,4
2020,48,MT,38,39,-1
2020,48,NC,2072,2127,-55
2020,48,ND,81,102,-21
2020,48,NE,73,73,0
2020,48,NH,193,191,2
2020,48,NJ,3255,3108,147
2020,48,NM,108,112,-4
2020,48,NV,110,115,-5
2020,48,NY,2671,2736,-65
2020,48,OH,290,322,-32
2020,48,OK,142,156,-14
2020,48,OR,456,461,-5
2020,48,PA,713,743,-30
2020,48,PR,37,23,14
2020,48,RI,150,155,-5
2020,48,SC,2987,2996,-9
2020,48,SD,40,42,-2
2020,48,TN,327,336,-9
2020,48,TX,10544,11005,-461
2020,48,UT,110,46,64
2020,48,VA,1454,1505,-51
2020,48,VI,42,42,0
2020,48,VT,49,56,-7
2020,48,WA,614,583,31
2020,48,WI,115,124,-9
2020,48,WV,106,107,-1
2020,48,WY,24,27,-3
2020,49,AK,23,23,0
2020,49,AL,841,862,-21
2020,49,AR,105,110,-5
2020,49,AZ,315,292,23
2020,49,CA,4391,4663,-272
2020,49,CO,176,182,-6
2020,49,CT,326,337,-11
2020,49,DC,25,24,1
2020,49,DE,265,280,-15
2020,49,FL,18877,19092,-215
2020,49,GA,929,949,-20
2020,49,HI,426,430,-4
2020,49,IA,87,82,5
2020,49,ID,61,61,0
2020,49,IL,511,522,-11
2020,49,IN,141,156,-15
2020,49,KS,78,80,-2
2020,49,KY,162,166,-4
2020,49,LA,5484,5517,-33
2020,49,MA,700,732,-32
2020,49,MD,779,809,-30
2020,49,ME,118,119,-1
2020,49,MI,201,208,-7
2020,49,MN,70,78,-8
2020,49,MO,199,208,-9
2020,49,MS,660,675,-15
2020,49,MT,39,34,5
2020,49,NC,1679,1745,-66
2020,49,ND,87,98,-11
2020,49,NE,53,53,0
2020,49,NH,75,79,-4
2020,49,NJ,2373,2491,-118
2020,49,NM,78,89,-11
2020,49,NV,111,118,-7
2020,49,NY,2294,2340,-46
2020,49,OH,268,288,-20
2020,49,OK,134,149,-15
2020,49,OR,370,371,-1
2020,49,PA,584,620,-36
2020,49,PR,33,25,8
2020,49,RI,173,176,-3
2020,49,SC,2280,2312,-32
2020,49,SD,22,26,-4
2020,49,TN,302,294,8
2020,49,TX,8003,8411,-408
2020,49,UT,44,45,-1
2020,49,VA,1135,1154,-19
2020,49,VI,4,6,-2
2020,49,VT,39,40,-1
2020,49,WA,504,490,14
2020,49,WI,107,104,3
2020,49,WV,105,111,-6
2020,49,WY,10,12,-2
2020,50,AK,27,25,2
2020,50,AL,602,618,-16
2020,50,AR,161,165,-4
2020,50,AZ,342,342,0
2020,50,CA,4756,4928,-172
2020,50,CO,217,226,-9
2020,50,CT,452,474,-22
2020,50,DC,28,29,-1
2020,50,DE,334,346,-12
2020,50,FL,22578,22787,-209
2020,50,GA,1057,1047,10
2020,50,HI,1095,1088,7
2020,50,IA,148,153,-5
2020,50,ID,78,76,2
2020,50,IL,270,274,-4
2020,50,IN,181,180,1
2020,50,KS,83,95,-12
2020,50,KY,137,144,-7
2020,50,LA,6360,6423,-63
2020,50,MA,776,814,-38
2020,50,MD,749,762,-13
2020,50,ME,159,163,-4
2020,50,MI,234,249,-15
2020,50,MN,85,88,-3
2020,50,MO,155,168,-13
2020,50,MS,755,784,-29
2020,50,MT,41,40,1
2020,50,NC,1965,2022,-57
2020,50,ND,95,104,-9
2020,50,NE,63,71,-8
2020,50,NH,82,83,-1
2020,50,NJ,2470,2526,-56
2020,50,NM,89,84,5
2020,50,NV,104,115,-11
2020,50,NY,2537,2710,-173
2020,50,OH,374,382,-8
2020,50,OK,142,150,-8
2020,50,OR,431,399,32
2020,50,PA,647,677,-30
2020,50,PR,20,24,-4
2020,50,RI,135,141,-6
2020,50,SC,2799,2875,-76
2020,50,SD,29,33,-4
2020,50,TN,318,340,-22
2020,50,TX,8941,9227,-286
2020,50,UT,75,73,2
2020,50,VA,1395,1419,-24
2020,50,VI,10,9,1
2020,50,VT,50,31,19
2020,50,WA,581,552,29
2020,50,WI,126,127,-1
2020,50,WV,115,124,-9
2020,50,WY,21,23,-2
2020,51,AK,14,14,0
2020,51,AL,430,437,-7
2020,51,AR,95,98,-3
2020,51,AZ,234,266,-32
2020,51,CA,3505,3659,-154
2020,51,CO,210,213,-3
2020,51,CT,218,230,-12
2020,51,DC,21,20,1
2020,51,DE,215,223,-8
2020,51,FL,15371,15490,-119
2020,51,GA,673,685,-12
2020,51,GU,2,3,-1
2020,51,HI,1417,1372,45
2020,51,IA,97,89,8
2020,51,ID,45,43,2
2020,51,IL,232,243,-11
2020,51,IN,123,130,-7
2020,51,KS,52,60,-8
2020,51,KY,159,168,-9
2020,51,LA,4080,4130,-50
2020,51,MA,553,593,-40
2020,51,MD,569,583,-14
2020,51,ME,85,87,-2
2020,51,MI,115,127,-12
2020,51,MN,68,80,-12
2020,51,MO,140,143,-3
2020,51,MS,592,595,-3
2020,51,MT,21,22,-1
2020,51,NC,1273,1311,-38
2020,51,ND,63,85,-22
2020,51,NE,41,44,-3
2020,51,NH,69,65,4
2020,51,NJ,2084,2139,-55
2020,51,NM,62,65,-3
2020,51,NV,67,73,-6
2020,51,NY,2343,2295,48
2020,51,OH,190,198,-8
2020,51,OK,88,113,-25
2020,51,OR,262,275,-13
2020,51,PA,446,450,-4
2020,51,PR,27,20,7
2020,51,RI,98,96,2
2020,51,SC,1857,1892,-35
2020,51,SD,14,17,-3
2020,51,TN,313,314,-1
2020,51,TX,6436,6689,-253
2020,51,UT,38,44,-6
2020,51,VA,759,768,-9
2020,51,VI,2,2,0
2020,51,VT,26,27,-1
2020,51,WA,465,471,-6
2020,51,WI,74,73,1
2020,51,WV,83,100,-17
2020,51,WY,19,21,-2
2020,52,AK,9,11,-2
2020,52,AL,390,379,11
2020,52,AR,73,74,-1
2020,52,AZ,223,240,-17
2020,52,CA,2453,2588,-135
2020,52,CO,182,183,-1
2020,52,CT,282,295,-13
2020,52,DC,15,19,-4
2020,52,DE,189,187,2
2020,52,FL,18733,19289,-556
2020,52,GA,672,710,-38
2020,52,HI,169,172,-3
2020,52,IA,72,71,1
2020,52,ID,46,47,-1
2020,52,IL,174,172,2
2020,52,IN,107,112,-5
2020,52,KS,57,53,4
2020,52,KY,110,102,8
2020,52,LA,4575,4648,-73
2020,52,MA,479,495,-16
2020,52,MD,893,906,-13
2020,52,ME,53,54,-1
2020,52,MI,183,176,7
2020,52,MN,139,138,1
2020,52,MO,123,116,7
2020,52,MS,512,527,-15
2020,52,MT,20,20,0
2020,52,NC,1214,1227,-13
2020,52,ND,73,88,-15
2020,52,NE,54,56,-2
2020,52,NH,38,41,-3
2020,52,NJ,1351,1393,-42
2020,52,NM,71,74,-3
2020,52,NV,75,73,2
2020,52,NY,1880,1905,-25
2020,52,OH,180,203,-23
2020,52,OK,72,78,-6
2020,52,OR,211,219,-8
2020,52,PA,439,425,14
2020,52,PR,38,42,-4
2020,52,RI,80,79,1
2020,52,SC,2292,2307,-15
2020,52,SD,30,26,4
2020,52,TN,188,195,-7
2020,52,TX,7958,8227,-269
2020,52,UT,54,58,-4
2020,52,VA,770,778,-8
2020,52,VI,1,1,0
2020,52,VT,14,13,1
2020,52,WA,357,353,4
2020,52,WI,230,244,-14
2020,52,WV,65,68,-3
2020,52,WY,14,14,0
2021,0,AK,8,5,3
2021,0,AL,108,113,-5
2021,0,AR,62,59,3
2021,0,AZ,67,117,-50
2021,0,CA,1728,1813,-85
2021,0,CO,49,49,0
2021,0,CT,79,80,-1
2021,0,DC,7,8,-1
2021,0,DE,149,144,5
2021,0,FL,13194,13164,30
2021,0,GA,341,347,-6
2021,0,HI,141,142,-1
2021,0,IA,33,33,0
2021,0,ID,18,19,-1
2021,0,IL,139,185,-46
2021,0,IN,59,62,-3
2021,0,KS,20,22,-2
2021,0,KY,38,40,-2
2021,0,LA,2867,2868,-1
2021,0,MA,153,149,4
2021,0,MD,216,214,2
2021,0,ME,22,21,1
2021,0,MI,71,55,16
2021,0,MN,23,24,-1
2021,0,MO,37,39,-2
2021,0,MS,162,151,11
2021,0,MT,8,9,-1
2021,0,NC,528,513,15
2021,0,ND,24,31,-7
2021,0,NE,29,30,-1
2021,0,NH,19,18,1
2021,0,NJ,427,439,-12
2021,0,NM,30,32,-2
2021,0,NV,28,24,4
2021,0,NY,554,560,-6
2021,0,OH,60,63,-3
2021,0,OK,27,33,-6
2021,0,OR,125,106,19
2021,0,PA,309,290,19
2021,0,PR,2,4,-2
2021,0,RI,31,34,-3
2021,0,SC,723,693,30
2021,0,SD,9,13,-4
2021,0,TN,95,95,0
2021,0,TX,3325,3369,-44
2021,0,UT,4,6,-2
2021,0,VA,416,417,-1
2021,0,VT,7,8,-1
2021,0,WA,120,115,5
2021,0,WI,104,105,-1
2021,0,WV,27,26,1
2021,0,WY,2,1,1
2021,1,AK,20,12,8
2021,1,AL,476,496,-20
2021,1,AR,94,82,12
2021,1,AZ,257,270,-13
2021,1,CA,4580,4648,-68
2021,1,CO,226,240,-14
2021,1,CT,386,389,-3
2021,1,DC,22,25,-3
2021,1,DE,295,294,1
2021,1,FL,16942,17376,-434
2021,1,GA,769,806,-37
2021,1,HI,355,356,-1
2021,1,IA,103,109,-6
2021,1,ID,63,68,-5
2021,1,IL,276,277,-1
2021,1,IN,145,151,-6
2021,1,KS,97,108,-11
2021,1,KY,143,151,-8
2021,1,LA,4587,4646,-59
2021,1,MA,564,584,-20
2021,1,MD,640,657,-17
2021,1,ME,87,90,-3
2021,1,MI,155,166,-11
2021,1,MN,71,87,-16
2021,1,MO,136,160,-24
2021,1,MS,630,645,-15
2021,1,MT,31,34,-3
2021,1,NC,1465,1528,-63
2021,1,ND,107,122,-15
2021,1,NE,84,82,2
2021,1,NH,73,71,2
2021,1,NJ,1928,1970,-42
2021,1,NM,91,96,-5
2021,1,NV,94,106,-12
2021,1,NY,2087,2226,-139
2021,1,OH,218,227,-9
2021,1,OK,85,89,-4
2021,1,OR,486,496,-10
2021,1,PA,490,497,-7
2021,1,PR,14,14,0
2021,1,RI,108,118,-10
2021,1,SC,1911,1921,-10
2021,1,SD,27,31,-4
2021,1,TN,256,266,-10
2021,1,TX,6800,7010,-210
2021,1,UT,42,40,2
2021,1,VA,949,984,-35
2021,1,VI,1,1,0
2021,1,VT,28,28,0
2021,1,WA,425,432,-7
2021,1,WI,88,100,-12
2021,1,WV,86,91,-5
2021,1,WY,13,11,2
2021,2,AK,37,34,3
2021,2,AL,482,498,-16
2021,2,AR,93,113,-20
2021,2,AZ,264,275,-11
2021,2,CA,3453,3594,-141
2021,2,CO,159,163,-4
2021,2,CT,373,380,-7
2021,2,DC,33,27,6
2021,2,DE,260,254,6
2021,2,FL,19515,19463,52
2021,2,GA,843,833,10
2021,2,HI,972,979,-7
2021,2,IA,91,101,-10
2021,2,ID,54,55,-1
2021,2,IL,233,238,-5
2021,2,IN,166,187,-21
2021,2,KS,91,94,-3
2021,2,KY,133,145,-12
2021,2,LA,5415,5454,-39
2021,2,MA,503,523,-20
2021,2,MD,659,651,8
2021,2,ME,124,121,3
2021,2,MI,278,287,-9
2021,2,MN,59,68,-9
2021,2,MO,153,156,-3
2021,2,MS,703,725,-22
2021,2,MT,39,40,-1
2021,2,NC,1549,1616,-67
2021,2,ND,183,211,-28
2021,2,NE,49,54,-5
2021,2,NH,81,80,1
2021,2,NJ,1938,1987,-49
2021,2,NM,75,85,-10
2021,2,NV,97,107,-10
2021,2,NY,3131,2997,134
2021,2,OH,318,342,-24
2021,2,OK,119,129,-10
2021,2,OR,325,324,1
2021,2,PA,594,612,-18
2021,2,PR,24,30,-6
2021,2,RI,286,291,-5
2021,2,SC,2608,2640,-32
2021,2,SD,22,28,-6
2021,2,TN,258,249,9
2021,2,TX,7120,7319,-199
2021,2,UT,32,45,-13
2021,2,VA,845,858,-13
2021,2,VI,3,4,-1
2021,2,VT,29,29,0
2021,2,WA,570,588,-18
2021,2,WI,182,191,-9
2021,2,WV,88,91,-3
2021,2,WY,10,10,0
2021,3,AK,28,30,-2
2021,3,AL,436,427,9
2021,3,AR,96,102,-6
2021,3,AZ,228,246,-18
2021,3,CA,3230,3208,22
2021,3,CO,152,153,-1
2021,3,CT,323,334,-11
2021,3,DC,15,14,1
2021,3,DE,592,604,-12
2021,3,FL,17498,17875,-377
2021,3,GA,754,813,-59
2021,3,HI,445,473,-28
2021,3,IA,86,88,-2
2021,3,ID,40,40,0
2021,3,IL,253,261,-8
2021,3,IN,149,159,-10
2021,3,KS,74,73,1
2021,3,KY,126,135,-9
2021,3,LA,4478,4548,-70
2021,3,MA,499,511,-12
2021,3,MD,890,900,-10
2021,3,ME,59,65,-6
2021,3,MI,145,144,1
2021,3,MN,54,57,-3
2021,3,MO,156,163,-7
2021,3,MS,592,606,-14
2021,3,MT,24,26,-2
2021,3,NC,1791,1780,11
2021,3,ND,117,134,-17
2021,3,NE,52,53,-1
2021,3,NH,43,41,2
2021,3,NJ,1622,1650,-28
2021,3,NM,70,77,-7
2021,3,NV,87,95,-8
2021,3,NY,2003,2020,-17
2021,3,OH,198,217,-19
2021,3,OK,89,91,-2
2021,3,OR,313,322,-9
2021,3,PA,447,464,-17
2021,3,PR,21,21,0
2021,3,RI,76,83,-7
2021,3,SC,1939,1942,-3
2021,3,SD,21,30,-9
2021,3,TN,201,217,-16
2021,3,TX,6368,6564,-196
2021,3,UT,26,29,-3
2021,3,VA,771,802,-31
2021,3,VI,10,11,-1
2021,3,VT,26,29,-3
2021,3,WA,429,410,19
2021,3,WI,102,103,-1
2021,3,WV,73,83,-10
2021,3,WY,14,12,2
2021,4,AK,27,25,2
2021,4,AL,409,420,-11
2021,4,AR,123,131,-8
2021,4,AZ,265,284,-19
2021,4,CA,2891,2965,-74
2021,4,CO,169,172,-3
2021,4,CT,240,251,-11
2021,4,DC,35,35,0
2021,4,DE,236,225,11
2021,4,FL,20211,20642,-431
2021,4,GA,825,882,-57
2021,4,HI,641,543,98
2021,4,IA,94,115,-21
2021,4,ID,48,55,-7
2021,4,IL,275,283,-8
2021,4,IN,163,177,-14
2021,4,KS,74,80,-6
2021,4,KY,145,143,2
2021,4,LA,5168,5280,-112
2021,4,MA,450,466,-16
2021,4,MD,574,599,-25
2021,4,ME,78,80,-2
2021,4,MI,161,172,-11
2021,4,MN,68,74,-6
2021,4,MO,147,143,4
2021,4,MS,682,713,-31
2021,4,MT,37,41,-4
2021,4,NC,1362,1448,-86
2021,4,ND,108,130,-22
2021,4,NE,43,47,-4
2021,4,NH,130,129,1
2021,4,NJ,2004,2026,-22
2021,4,NM,85,88,-3
2021,4,NV,111,119,-8
2021,4,NY,1826,1874,-48
2021,4,OH,162,184,-22
2021,4,OK,98,101,-3
2021,4,OR,534,539,-5
2021,4,PA,599,587,12
2021,4,PR,24,24,0
2021,4,RI,91,101,-10
2021,4,SC,11319,11356,-37
2021,4,SD,24,26,-2
2021,4,TN,224,238,-14
2021,4,TX,6478,6568,-90
2021,4,UT,38,36,2
2021,4,VA,900,923,-23
2021,4,VI,5,6,-1
2021,4,VT,40,37,3
2021,4,WA,354,356,-2
2021,4,WI,84,90,-6
2021,4,WV,80,96,-16
2021,4,WY,11,10,1
2021,5,AK,20,15,5
2021,5,AL,913,919,-6
2021,5,AR,116,129,-13
2021,5,AZ,285,303,-18
2021,5,CA,4146,4361,-215
2021,5,CO,188,189,-1
2021,5,CT,276,288,-12
2021,5,DC,18,61,-43
2021,5,DE,237,231,6
2021,5,FL,20250,20202,48
2021,5,GA,802,853,-51
2021,5,HI,1508,1522,-14
2021,5,IA,96,102,-6
2021,5,ID,90,87,3
2021,5,IL,274,301,-27
2021,5,IN,158,172,-14
2021,5,KS,66,74,-8
2021,5,KY,170,168,2
2021,5,LA,6306,6414,-108
2021,5,MA,551,560,-9
2021,5,MD,496,514,-18
2021,5,ME,57,57,0
2021,5,MI,194,193,1
2021,5,MN,94,117,-23
2021,5,MO,152,160,-8
2021,5,MS,975,997,-22
2021,5,MT,53,53,0
2021,5,NC,1517,1560,-43
2021,5,ND,122,176,-54
2021,5,NE,80,86,-6
2021,5,NH,51,46,5
2021,5,NJ,2317,2348,-31
2021,5,NM,81,84,-3
2021,5,NV,96,105,-9
2021,5,NY,1894,1971,-77
2021,5,OH,246,269,-23
2021,5,OK,114,131,-17
2021,5,OR,329,326,3
2021,5,PA,544,551,-7
2021,5,PR,19,22,-3
2021,5,RI,100,101,-1
2021,5,SC,2213,2175,38
2021,5,SD,30,43,-13
2021,5,TN,281,288,-7
2021,5,TX,6744,6930,-186
2021,5,UT,35,39,-4
2021,5,VA,891,907,-16
2021,5,VI,2,1,1
2021,5,VT,44,44,0
2021,5,WA,474,479,-5
2021,5,WI,93,100,-7
2021,5,WV,110,116,-6
2021,5,WY,15,14,1
2021,6,AK,20,21,-1
2021,6,AL,741,759,-18
2021,6,AR,127,126,1
2021,6,AZ,317,335,-18
2021,6,CA,3782,3983,-201
2021,6,CO,401,404,-3
2021,6,CT,243,242,1
2021,6,DC,22,25,-3
2021,6,DE,241,234,7
2021,6,FL,19363,19587,-224
2021,6,GA,842,869,-27
2021,6,HI,364,520,-156
2021,6,IA,107,116,-9
2021,6,ID,116,119,-3
2021,6,IL,341,358,-17
2021,6,IN,236,248,-12
2021,6,KS,100,106,-6
2021,6,KY,152,159,-7
2021,6,LA,5619,5649,-30
2021,6,MA,895,918,-23
2021,6,MD,486,502,-16
2021,6,ME,133,135,-2
2021,6,MI,206,220,-14
2021,6,MN,99,120,-21
2021,6,MO,178,177,1
2021,6,MS,790,798,-8
2021,6,MT,57,57,0
2021,6,NC,1805,1827,-22
2021,6,ND,175,257,-82
2021,6,NE,79,87,-8
2021,6,NH,70,61,9
2021,6,NJ,1830,1879,-49
2021,6,NM,96,95,1
2021,6,NV,119,136,-17
2021,6,NY,2524,2604,-80
2021,6,OH,247,270,-23
2021,6,OK,111,118,-7
2021,6,OR,315,309,6
2021,6,PA,597,617,-20
2021,6,PR,22,29,-7
2021,6,RI,137,143,-6
2021,6,SC,2169,2216,-47
2021,6,SD,29,37,-8
2021,6,TN,286,296,-10
2021,6,TX,7815,7904,-89
2021,6,UT,115,119,-4
2021,6,VA,920,946,-26
2021,6,VI,2,2,0
2021,6,VT,38,38,0
2021,6,WA,467,440,27
2021,6,WI,93,108,-15
2021,6,WV,122,124,-2
2021,6,WY,24,27,-3
2021,7,AK,29,28,1
2021,7,AL,763,753,10
2021,7,AR,147,150,-3
2021,7,AZ,243,265,-22
2021,7,CA,3161,3314,-153
2021,7,CO,177,185,-8
2021,7,CT,256,266,-10
2021,7,DC,98,34,64
2021,7,DE,228,232,-4
2021,7,FL,22334,22731,-397
2021,7,GA,851,884,-33
2021,7,HI,694,621,73
2021,7,IA,118,128,-10
2021,7,ID,99,100,-1
2021,7,IL,599,615,-16
2021,7,IN,183,186,-3
2021,7,KS,72,75,-3
2021,7,KY,163,157,6
2021,7,LA,5766,5891,-125
2021,7,MA,592,608,-16
2021,7,MD,477,497,-20
2021,7,ME,87,85,2
2021,7,MI,216,212,4
2021,7,MN,99,125,-26
2021,7,MO,155,164,-9
2021,7,MS,764,812,-48
2021,7,MT,45,48,-3
2021,7,NC,1644,1703,-59
2021,7,ND,185,278,-93
2021,7,NE,94,105,-11
2021,7,NH,83,80,3
2021,7,NJ,1886,1926,-40
2021,7,NM,82,101,-19
2021,7,NV,114,132,-18
2021,7,NY,2589,2614,-25
2021,7,OH,397,410,-13
2021,7,OK,106,112,-6
2021,7,OR,322,342,-20
2021,7,PA,753,767,-14
2021,7,PR,22,29,-7
2021,7,RI,82,87,-5
2021,7,SC,2297,2384,-87
2021,7,SD,29,44,-15
2021,7,TN,276,284,-8
2021,7,TX,7408,7498,-90
2021,7,UT,53,61,-8
2021,7,VA,1040,1088,-48
2021,7,VI,4,6,-2
2021,7,VT,39,42,-3
2021,7,WA,469,491,-22
2021,7,WI,109,136,-27
2021,7,WV,136,138,-2
2021,7,WY,16,14,2
2021,8,AK,22,24,-2
2021,8,AL,796,802,-6
2021,8,AR,130,140,-10
2021,8,AZ,293,305,-12
2021,8,CA,3050,3131,-81
2021,8,CO,197,208,-11
2021,8,CT,265,273,-8
2021,8,DC,24,28,-4
2021,8,DE,357,352,5
2021,8,FL,20264,20644,-380
2021,8,GA,1000,1064,-64
2021,8,HI,1283,1345,-62
2021,8,IA,154,163,-9
2021,8,ID,79,77,2
2021,8,IL,320,341,-21
2021,8,IN,212,220,-8
2021,8,KS,104,101,3
2021,8,KY,289,284,5
2021,8,LA,6944,6957,-13
2021,8,MA,486,516,-30
2021,8,MD,579,585,-6
2021,8,ME,77,79,-2
2021,8,MI,217,215,2
2021,8,MN,128,224,-96
2021,8,MO,180,192,-12
2021,8,MS,958,970,-12
2021,8,MT,71,75,-4
2021,8,NC,1925,2023,-98
2021,8,ND,216,604,-388
2021,8,NE,84,99,-15
2021,8,NH,89,85,4
2021,8,NJ,2318,2363,-45
2021,8,NM,101,103,-2
2021,8,NV,103,109,-6
2021,8,NY,2702,2823,-121
2021,8,OH,265,283,-18
2021,8,OK,118,133,-15
2021,8,OR,299,318,-19
2021,8,PA,713,740,-27
2021,8,PR,34,39,-5
2021,8,RI,151,156,-5
2021,8,SC,2413,2480,-67
2021,8,SD,38,59,-21
2021,8,TN,501,509,-8
2021,8,TX,9296,9501,-205
2021,8,UT,57,55,2
2021,8,VA,1215,1260,-45
2021,8,VI,8,8,0
2021,8,VT,30,34,-4
2021,8,WA,452,438,14
2021,8,WI,117,129,-12
2021,8,WV,115,124,-9
2021,8,WY,19,21,-2
2021,9,AK,30,30,0
2021,9,AL,521,521,0
2021,9,AR,140,162,-22
2021,9,AZ,288,309,-21
2021,9,CA,3005,3125,-120
2021,9,CO,273,288,-15
2021,9,CT,361,378,-17
2021,9,DC,35,31,4
2021,9,DE,271,280,-9
2021,9,FL,28411,29323,-912
2021,9,GA,1157,1212,-55
2021,9,HI,895,883,12
2021,9,IA,179,187,-8
2021,9,ID,100,101,-1
2021,9,IL,428,440,-12
2021,9,IN,227,239,-12
2021,9,KS,112,112,0
2021,9,KY,202,205,-3
2021,9,LA,8735,8839,-104
2021,9,MA,644,658,-14
2021,9,MD,1244,1246,-2
2021,9,ME,103,103,0
2021,9,MI,245,241,4
2021,9,MN,202,400,-198
2021,9,MO,251,256,-5
2021,9,MS,938,964,-26
2021,9,MT,56,64,-8
2021,9,NC,2301,2411,-110
2021,9,ND,367,1306,-939
2021,9,NE,107,137,-30
2021,9,NH,74,69,5
2021,9,NJ,2560,2605,-45
2021,9,NM,120,125,-5
2021,9,NV,129,132,-3
2021,9,NY,2854,2955,-101
2021,9,OH,302,315,-13
2021,9,OK,133,123,10
2021,9,OR,516,538,-22
2021,9,PA,745,780,-35
2021,9,PR,32,39,-7
2021,9,RI,320,319,1
2021,9,SC,3151,3230,-79
2021,9,SD,42,62,-20
2021,9,TN,436,459,-23
2021,9,TX,9977,10201,-224
2021,9,UT,68,77,-9
2021,9,VA,1164,1247,-83
2021,9,VI,9,10,-1
2021,9,VT,48,47,1
2021,9,WA,528,557,-29
2021,9,WI,209,240,-31
2021,9,WV,126,133,-7
2021,9,WY,20,23,-3
2021,10,AK,19,23,-4
2021,10,AL,492,518,-26
2021,10,AR,144,131,13
2021,10,AZ,231,239,-8
2021,10,CA,2607,2763,-156
2021,10,CO,239,247,-8
2021,10,CT,255,272,-17
2021,10,DC,24,22,2
2021,10,DE,257,259,-2
2021,10,FL,22120,23247,-1127
2021,10,GA,995,1021,-26
2021,10,HI,605,794,-189
2021,10,IA,198,214,-16
2021,10,ID,125,130,-5
2021,10,IL,367,484,-117
2021,10,IN,237,254,-17
2021,10,KS,115,127,-12
2021,10,KY,188,196,-8
2021,10,LA,6591,6629,-38
2021,10,MA,825,840,-15
2021,10,MD,457,467,-10
2021,10,ME,87,88,-1
2021,10,MI,246,220,26
2021,10,MN,226,419,-193
2021,10,MO,217,222,-5
2021,10,MS,899,936,-37
2021,10,MT,90,94,-4
2021,10,NC,1776,1879,-103
2021,10,ND,411,1275,-864
2021,10,NE,94,93,1
2021,10,NH,136,124,12
2021,10,NJ,1753,1808,-55
2021,10,NM,86,89,-3
2021,10,NV,128,139,-11
2021,10,NY,2906,2863,43
2021,10,OH,268,288,-20
2021,10,OK,118,129,-11
2021,10,OR,282,287,-5
2021,10,PA,612,633,-21
2021,10,PR,28,31,-3
2021,10,RI,93,102,-9
2021,10,SC,2625,2723,-98
2021,10,SD,47,74,-27
2021,10,TN,404,430,-26
2021,10,TX,8291,8486,-195
2021,10,UT,54,56,-2
2021,10,VA,1112,1154,-42
2021,10,VI,11,14,-3
2021,10,VT,64,68,-4
2021,10,WA,434,467,-33
2021,10,WI,162,174,-12
2021,10,WV,117,127,-10
2021,10,WY,26,30,-4
2021,11,AK,27,27,0
2021,11,AL,494,532,-38
2021,11,AR,124,130,-6
2021,11,AZ,266,288,-22
2021,11,CA,3071,3329,-258
2021,11,CO,226,214,12
2021,11,CT,273,298,-25
2021,11,DC,18,17,1
2021,11,DE,260,260,0
2021,11,FL,21793,21833,-40
2021,11,GA,988,1037,-49
2021,11,HI,473,463,10
2021,11,IA,176,183,-7
2021,11,ID,95,93,2
2021,11,IL,374,371,3
2021,11,IN,243,251,-8
2021,11,KS,114,115,-1
2021,11,KY,219,221,-2
2021,11,LA,6582,6673,-91
2021,11,MA,652,674,-22
2021,11,MD,1003,1046,-43
2021,11,ME,68,73,-5
2021,11,MI,241,243,-2
2021,11,MN,218,420,-202
2021,11,MO,253,265,-12
2021,11,MP,1,1,0
2021,11,MS,1001,1029,-28
2021,11,MT,107,119,-12
2021,11,NC,1795,1819,-24
2021,11,ND,363,960,-597
2021,11,NE,92,99,-7
2021,11,NH,106,90,16
2021,11,NJ,1967,2021,-54
2021,11,NM,101,111,-10
2021,11,NV,117,130,-13
2021,11,NY,2009,2064,-55
2021,11,OH,320,324,-4
2021,11,OK,136,146,-10
2021,11,OR,274,280,-6
2021,11,PA,613,639,-26
2021,11,PR,22,28,-6
2021,11,RI,70,75,-5
2021,11,SC,3030,3073,-43
2021,11,SD,63,106,-43
2021,11,TN,456,468,-12
2021,11,TX,8410,8898,-488
2021,11,UT,60,65,-5
2021,11,VA,1014,1057,-43
2021,11,VI,29,30,-1
2021,11,VT,43,47,-4
2021,11,WA,390,412,-22
2021,11,WI,169,203,-34
2021,11,WV,132,135,-3
2021,11,WY,31,29,2
2021,12,AK,18,17,1
2021,12,AL,770,798,-28
2021,12,AR,198,208,-10
2021,12,AZ,276,291,-15
2021,12,CA,3245,3394,-149
2021,12,CO,287,292,-5
2021,12,CT,318,332,-14
2021,12,DC,23,26,-3
2021,12,DE,345,346,-1
2021,12,FL,22711,23148,-437
2021,12,GA,1032,1063,-31
2021,12,HI,577,982,-405
2021,12,IA,286,311,-25
2021,12,ID,170,173,-3
2021,12,IL,506,502,4
2021,12,IN,275,288,-13
2021,12,KS,130,146,-16
2021,12,KY,257,272,-15
2021,12,LA,7232,7317,-85
2021,12,MA,641,665,-24
2021,12,MD,922,929,-7
2021,12,ME,86,95,-9
2021,12,MI,281,279,2
2021,12,MN,263,459,-196
2021,12,MO,387,398,-11
2021,12,MS,1127,1153,-26
2021,12,MT,110,116,-6
2021,12,NC,1958,2007,-49
2021,12,ND,430,939,-509
2021,12,NE,111,114,-3
2021,12,NH,85,74,11
2021,12,NJ,1781,1841,-60
2021,12,NM,87,90,-3
2021,12,NV,112,115,-3
2021,12,NY,2305,2356,-51
2021,12,OH,344,364,-20
2021,12,OK,150,153,-3
2021,12,OR,297,300,-3
2021,12,PA,690,707,-17
2021,12,PR,47,51,-4
2021,12,RI,157,171,-14
2021,12,SC,13156,13201,-45
2021,12,SD,85,131,-46
2021,12,TN,475,498,-23
2021,12,TX,9963,9958,5
2021,12,UT,107,113,-6
2021,12,VA,1947,1989,-42
2021,12,VI,9,10,-1
2021,12,VT,30,27,3
2021,12,WA,378,403,-25
2021,12,WI,319,362,-43
2021,12,WV,138,144,-6
2021,12,WY,44,34,10
2021,13,AK,24,25,-1
2021,13,AL,796,819,-23
2021,13,AR,200,215,-15
2021,13,AZ,324,404,-80
2021,13,CA,2802,2917,-115
2021,13,CO,271,297,-26
2021,13,CT,362,375,-13
2021,13,DC,26,29,-3
2021,13,DE,295,300,-5
2021,13,FL,31956,32205,-249
2021,13,GA,1426,1494,-68
2021,13,HI,566,581,-15
2021,13,IA,243,264,-21
2021,13,ID,110,128,-18
2021,13,IL,570,598,-28
2021,13,IN,265,272,-7
2021,13,KS,123,130,-7
2021,13,KY,260,248,12
2021,13,LA,8728,8843,-115
2021,13,MA,600,637,-37
2021,13,MD,789,807,-18
2021,13,ME,114,124,-10
2021,13,MI,267,270,-3
2021,13,MN,511,692,-181
2021,13,MO,353,358,-5
2021,13,MS,1085,1113,-28
2021,13,MT,120,131,-11
2021,13,NC,2332,2402,-70
2021,13,ND,341,619,-278
2021,13,NE,133,145,-12
2021,13,NH,101,96,5
2021,13,NJ,2342,2390,-48
2021,13,NM,160,173,-13
2021,13,NV,116,125,-9
2021,13,NY,3116,2968,148
2021,13,OH,366,383,-17
2021,13,OK,168,167,1
2021,13,OR,332,325,7
2021,13,PA,741,774,-33
2021,13,PR,35,33,2
2021,13,RI,113,115,-2
2021,13,SC,4505,4600,-95
2021,13,SD,83,122,-39
2021,13,TN,512,523,-11
2021,13,TX,12230,12208,22
2021,13,UT,67,74,-7
2021,13,VA,1343,1404,-61
2021,13,VI,3,3,0
2021,13,VT,37,41,-4
2021,13,WA,458,466,-8
2021,13,WI,234,263,-29
2021,13,WV,184,188,-4
2021,13,WY,34,33,1
2021,14,AK,17,18,-1
2021,14,AL,513,535,-22
2021,14,AR,136,146,-10
2021,14,AZ,233,241,-8
2021,14,CA,2516,2613,-97
2021,14,CO,245,261,-16
2021,14,CT,296,309,-13
2021,14,DC,27,24,3
2021,14,DE,274,267,7
2021,14,FL,23331,23712,-381
2021,14,GA,968,958,10
2021,14,HI,633,625,8
2021,14,IA,292,322,-30
2021,14,ID,113,136,-23
2021,14,IL,422,443,-21
2021,14,IN,218,225,-7
2021,14,KS,126,124,2
2021,14,KY,222,197,25
2021,14,LA,7175,7257,-82
2021,14,MA,417,434,-17
2021,14,MD,682,692,-10
2021,14,ME,114,117,-3
2021,14,MI,222,226,-4
2021,14,MN,493,739,-246
2021,14,MO,317,324,-7
2021,14,MS,975,988,-13
2021,14,MT,130,143,-13
2021,14,NC,1840,1913,-73
2021,14,ND,295,549,-254
2021,14,NE,75,88,-13
2021,14,NH,87,83,4
2021,14,NJ,2137,2167,-30
2021,14,NM,83,82,1
2021,14,NV,99,100,-1
2021,14,NY,1832,1927,-95
2021,14,OH,322,328,-6
2021,14,OK,152,157,-5
2021,14,OR,259,278,-19
2021,14,PA,651,660,-9
2021,14,PR,41,42,-1
2021,14,RI,274,285,-11
2021,14,SC,2605,2725,-120
2021,14,SD,97,175,-78
2021,14,TN,370,385,-15
2021,14,TX,9678,9706,-28
2021,14,UT,68,71,-3
2021,14,VA,1024,1031,-7
2021,14,VI,5,5,0
2021,14,VT,41,44,-3
2021,14,WA,382,367,15
2021,14,WI,268,317,-49
2021,14,WV,135,138,-3
2021,14,WY,40,43,-3
2021,15,AK,32,34,-2
2021,15,AL,1015,1036,-21
2021,15,AR,141,141,0
2021,15,AZ,244,255,-11
2021,15,CA,2247,2289,-42
2021,15,CO,285,311,-26
2021,15,CT,318,329,-11
2021,15,DC,22,24,-2
2021,15,DE,300,306,-6
2021,15,FL,27444,28100,-656
2021,15,GA,1060,1121,-61
2021,15,HI,610,582,28
2021,15,IA,301,361,-60
2021,15,ID,109,110,-1
2021,15,IL,456,482,-26
2021,15,IN,227,235,-8
2021,15,KS,146,162,-16
2021,15,KY,233,186,47
2021,15,LA,8674,8716,-42
2021,15,MA,700,719,-19
2021,15,MD,619,647,-28
2021,15,ME,127,127,0
2021,15,MI,246,251,-5
2021,15,MN,350,513,-163
2021,15,MO,324,344,-20
2021,15,MS,1137,1139,-2
2021,15,MT,88,103,-15
2021,15,NC,2107,2145,-38
2021,15,ND,330,623,-293
2021,15,NE,128,135,-7
2021,15,NH,95,74,21
2021,15,NJ,2504,2551,-47
2021,15,NM,96,96,0
2021,15,NV,94,105,-11
2021,15,NY,1990,1978,12
2021,15,OH,283,312,-29
2021,15,OK,173,161,12
2021,15,OR,265,266,-1
2021,15,PA,566,596,-30
2021,15,PR,44,43,1
2021,15,RI,97,98,-1
2021,15,SC,3016,3170,-154
2021,15,SD,79,118,-39
2021,15,TN,403,424,-21
2021,15,TX,10595,10422,173
2021,15,UT,73,80,-7
2021,15,VA,1245,1280,-35
2021,15,VI,53,57,-4
2021,15,VT,51,45,6
2021,15,WA,365,388,-23
2021,15,WI,251,297,-46
2021,15,WV,129,130,-1
2021,15,WY,49,47,2
2021,16,AK,27,23,4
2021,16,AL,599,586,13
2021,16,AR,133,137,-4
2021,16,AZ,304,312,-8
2021,16,CA,2727,2851,-124
2021,16,CO,336,363,-27
2021,16,CT,299,307,-8
2021,16,DC,22,23,-1
2021,16,DE,335,340,-5
2021,16,FL,22986,23932,-946
2021,16,GA,1093,1085,8
2021,16,HI,721,715,6
2021,16,IA,257,281,-24
2021,16,ID,91,93,-2
2021,16,IL,447,487,-40
2021,16,IN,240,251,-11
2021,16,KS,153,162,-9
2021,16,KY,204,189,15
2021,16,LA,8615,8551,64
2021,16,MA,429,452,-23
2021,16,MD,567,578,-11
2021,16,ME,100,103,-3
2021,16,MI,213,207,6
2021,16,MN,159,184,-25
2021,16,MO,348,370,-22
2021,16,MS,1132,1134,-2
2021,16,MT,94,99,-5
2021,16,NC,1987,2046,-59
2021,16,ND,162,219,-57
2021,16,NE,147,150,-3
2021,16,NH,78,75,3
2021,16,NJ,2071,2118,-47
2021,16,NM,95,110,-15
2021,16,NV,108,123,-15
2021,16,NY,2447,2494,-47
2021,16,OH,356,401,-45
2021,16,OK,172,185,-13
2021,16,OR,234,233,1
2021,16,PA,583,613,-30
2021,16,PR,28,28,0
2021,16,RI,105,105,0
2021,16,SC,3015,3095,-80
2021,16,SD,68,89,-21
2021,16,TN,368,361,7
2021,16,TX,10999,10848,151
2021,16,UT,52,65,-13
2021,16,VA,1411,1438,-27
2021,16,VI,7,7,0
2021,16,VT,44,46,-2
2021,16,WA,371,378,-7
2021,16,WI,172,185,-13
2021,16,WV,119,124,-5
2021,16,WY,45,47,-2
2021,17,AK,41,39,2
2021,17,AL,1474,1461,13
2021,17,AR,138,151,-13
2021,17,AZ,374,394,-20
2021,17,CA,2482,2616,-134
2021,17,CO,397,415,-18
2021,17,CT,388,399,-11
2021,17,DC,23,22,1
2021,17,DE,361,363,-2
2021,17,FL,40716,40994,-278
2021,17,GA,1357,1396,-39
2021,17,HI,2436,2436,0
2021,17,IA,223,233,-10
2021,17,ID,369,377,-8
2021,17,IL,561,511,50
2021,17,IN,212,233,-21
2021,17,KS,178,177,1
2021,17,KY,235,212,23
2021,17,LA,11231,11324,-93
2021,17,MA,602,617,-15
2021,17,MD,772,809,-37
2021,17,ME,90,130,-40
2021,17,MI,230,250,-20
2021,17,MN,143,146,-3
2021,17,MO,329,349,-20
2021,17,MS,1296,1320,-24
2021,17,MT,93,102,-9
2021,17,NC,2691,2788,-97
2021,17,ND,109,139,-30
2021,17,NE,144,158,-14
2021,17,NH,86,81,5
2021,17,NJ,2962,3030,-68
2021,17,NM,122,128,-6
2021,17,NV,101,119,-18
2021,17,NY,2230,2317,-87
2021,17,OH,375,408,-33
2021,17,OK,172,186,-14
2021,17,OR,567,582,-15
2021,17,PA,657,674,-17
2021,17,PR,24,34,-10
2021,17,RI,119,127,-8
2021,17,SC,3532,3761,-229
2021,17,SD,57,67,-10
2021,17,TN,520,417,103
2021,17,TX,14488,14691,-203
2021,17,UT,60,64,-4
2021,17,VA,1764,1690,74
2021,17,VI,10,11,-1
2021,17,VT,40,40,0
2021,17,WA,414,423,-9
2021,17,WI,161,172,-11
2021,17,WV,128,141,-13
2021,17,WY,46,42,4
2021,18,AK,29,29,0
2021,18,AL,593,614,-21
2021,18,AR,132,136,-4
2021,18,AZ,274,278,-4
2021,18,CA,1972,2062,-90
2021,18,CO,372,399,-27
2021,18,CT,237,253,-16
2021,18,DC,27,29,-2
2021,18,DE,386,380,6
2021,18,FL,22743,23258,-515
2021,18,GA,1070,1112,-42
2021,18,HI,339,343,-4
2021,18,IA,144,159,-15
2021,18,ID,89,92,-3
2021,18,IL,416,421,-5
2021,18,IN,184,195,-11
2021,18,KS,117,130,-13
2021,18,KY,214,211,3
2021,18,LA,8231,8306,-75
2021,18,MA,476,500,-24
2021,18,MD,628,642,-14
2021,18,ME,71,75,-4
2021,18,MI,167,171,-4
2021,18,MN,111,131,-20
2021,18,MO,193,206,-13
2021,18,MS,1127,1192,-65
2021,18,MT,86,85,1
2021,18,NC,1803,1849,-46
2021,18,ND,86,97,-11
2021,18,NE,103,112,-9
2021,18,NH,76,79,-3
2021,18,NJ,2002,2048,-46
2021,18,NM,106,119,-13
2021,18,NV,86,91,-5
2021,18,NY,2115,2257,-142
2021,18,OH,240,259,-19
2021,18,OK,167,174,-7
2021,18,OR,241,252,-11
2021,18,PA,531,551,-20
2021,18,PR,27,46,-19
2021,18,RI,100,111,-11
2021,18,SC,2735,2830,-95
2021,18,SD,54,61,-7
2021,18,TN,375,341,34
2021,18,TX,12296,12454,-158
2021,18,UT,49,52,-3
2021,18,VA,1078,1139,-61
2021,18,VI,14,10,4
2021,18,VT,39,41,-2
2021,18,WA,333,365,-32
2021,18,WI,128,143,-15
2021,18,WV,93,102,-9
2021,18,WY,27,31,-4
2021,19,AK,39,40,-1
2021,19,AL,1185,1212,-27
2021,19,AR,116,130,-14
2021,19,AZ,290,312,-22
2021,19,CA,2163,2199,-36
2021,19,CO,235,237,-2
2021,19,CT,314,326,-12
2021,19,DC,17,17,0
2021,19,DE,317,307,10
2021,19,FL,27221,27493,-272
2021,19,GA,1170,1207,-37
2021,19,HI,590,569,21
2021,19,IA,147,169,-22
2021,19,ID,98,104,-6
2021,19,IL,451,476,-25
2021,19,IN,175,195,-20
2021,19,KS,122,133,-11
2021,19,KY,229,210,19
2021,19,LA,9156,8982,174
2021,19,MA,729,767,-38
2021,19,MD,566,586,-20
2021,19,ME,62,68,-6
2021,19,MI,195,229,-34
2021,19,MN,96,105,-9
2021,19,MO,223,241,-18
2021,19,MS,1124,1110,14
2021,19,MT,83,87,-4
2021,19,NC,2089,2173,-84
2021,19,ND,67,80,-13
2021,19,NE,108,112,-4
2021,19,NH,80,80,0
2021,19,NJ,2239,2336,-97
2021,19,NM,65,72,-7
2021,19,NV,101,103,-2
2021,19,NY,2975,3070,-95
2021,19,OH,271,290,-19
2021,19,OK,176,200,-24
2021,19,OR,247,257,-10
2021,19,PA,595,625,-30
2021,19,PR,63,63,0
2021,19,RI,120,124,-4
2021,19,SC,3188,3269,-81
2021,19,SD,46,51,-5
2021,19,TN,366,343,23
2021,19,TX,13461,13441,20
2021,19,UT,59,71,-12
2021,19,VA,1334,1384,-50
2021,19,VI,16,16,0
2021,19,VT,27,27,0
2021,19,WA,334,351,-17
2021,19,WI,138,146,-8
2021,19,WV,112,119,-7
2021,19,WY,32,34,-2
2021,20,AK,34,38,-4
2021,20,AL,853,865,-12
2021,20,AR,127,131,-4
2021,20,AZ,288,300,-12
2021,20,CA,1949,2030,-81
2021,20,CO,322,335,-13
2021,20,CT,311,332,-21
2021,20,DC,31,34,-3
2021,20,DE,318,318,0
2021,20,FL,26894,27305,-411
2021,20,GA,1198,1545,-347
2021,20,HI,916,921,-5
2021,20,IA,246,255,-9
2021,20,ID,92,94,-2
2021,20,IL,344,380,-36
2021,20,IN,185,205,-20
2021,20,KS,134,141,-7
2021,20,KY,220,212,8
2021,20,LA,9559,9508,51
2021,20,MA,539,559,-20
2021,20,MD,561,572,-11
2021,20,ME,63,66,-3
2021,20,MI,180,201,-21
2021,20,MN,83,98,-15
2021,20,MO,241,260,-19
2021,20,MS,1262,1249,13
2021,20,MT,76,76,0
2021,20,NC,2302,2426,-124
2021,20,ND,62,71,-9
2021,20,NE,72,74,-2
2021,20,NH,58,70,-12
2021,20,NJ,2340,2408,-68
2021,20,NM,112,111,1
2021,20,NV,168,185,-17
2021,20,NY,2306,2335,-29
2021,20,OH,388,276,112
2021,20,OK,159,182,-23
2021,20,OR,243,259,-16
2021,20,PA,778,805,-27
2021,20,PR,38,42,-4
2021,20,RI,111,118,-7
2021,20,SC,3162,3266,-104
2021,20,SD,36,45,-9
2021,20,TN,367,346,21
2021,20,TX,16095,16053,42
2021,20,UT,58,59,-1
2021,20,VA,1417,1497,-80
2021,20,VI,10,14,-4
2021,20,VT,37,42,-5
2021,20,WA,308,311,-3
2021,20,WI,123,134,-11
2021,20,WV,119,124,-5
2021,20,WY,25,29,-4
2021,21,AK,26,28,-2
2021,21,AL,992,1017,-25
2021,21,AR,150,143,7
2021,21,AZ,286,292,-6
2021,21,CA,2055,2102,-47
2021,21,CO,400,441,-41
2021,21,CT,351,365,-14
2021,21,DC,26,29,-3
2021,21,DE,486,502,-16
2021,21,FL,28965,29637,-672
2021,21,GA,1353,1407,-54
2021,21,GU,1,1,0
2021,21,HI,964,963,1
2021,21,IA,134,149,-15
2021,21,ID,61,63,-2
2021,21,IL,401,432,-31
2021,21,IN,203,214,-11
2021,21,KS,136,137,-1
2021,21,KY,196,191,5
2021,21,LA,10468,10528,-60
2021,21,MA,564,566,-2
2021,21,MD,691,688,3
2021,21,ME,96,91,5
2021,21,MI,194,208,-14
2021,21,MN,107,111,-4
2021,21,MO,238,250,-12
2021,21,MS,1342,1376,-34
2021,21,MT,74,86,-12
2021,21,NC,2444,2500,-56
2021,21,ND,80,85,-5
2021,21,NE,94,103,-9
2021,21,NH,70,76,-6
2021,21,NJ,2225,2287,-62
2021,21,NM,100,107,-7
2021,21,NV,97,89,8
2021,21,NY,2794,2877,-83
2021,21,OH,279,305,-26
2021,21,OK,147,167,-20
2021,21,OR,228,224,4
2021,21,PA,607,653,-46
2021,21,PR,33,28,5
2021,21,RI,134,147,-13
2021,21,SC,3793,3926,-133
2021,21,SD,45,51,-6
2021,21,TN,397,403,-6
2021,21,TX,17222,17361,-139
2021,21,UT,74,73,1
2021,21,VA,1379,1469,-90
2021,21,VI,3,5,-2
2021,21,VT,13,15,-2
2021,21,WA,329,331,-2
2021,21,WI,158,176,-18
2021,21,WV,113,113,0
2021,21,WY,21,27,-6
2021,22,AK,37,35,2
2021,22,AL,726,740,-14
2021,22,AR,220,236,-16
2021,22,AZ,292,315,-23
2021,22,CA,2285,2351,-66
2021,22,CO,354,378,-24
2021,22,CT,346,355,-9
2021,22,DC,26,26,0
2021,22,DE,453,457,-4
2021,22,FL,37497,38761,-1264
2021,22,GA,1757,1789,-32
2021,22,HI,787,1087,-300
2021,22,IA,160,174,-14
2021,22,ID,59,62,-3
2021,22,IL,419,460,-41
2021,22,IN,212,229,-17
2021,22,KS,150,172,-22
2021,22,KY,239,212,27
2021,22,LA,11980,12083,-103
2021,22,MA,661,696,-35
2021,22,MD,739,769,-30
2021,22,ME,72,74,-2
2021,22,MI,202,243,-41
2021,22,MN,97,112,-15
2021,22,MO,235,259,-24
2021,22,MS,1463,1491,-28
2021,22,MT,75,81,-6
2021,22,NC,2738,2905,-167
2021,22,ND,84,90,-6
2021,22,NE,97,104,-7
2021,22,NH,94,94,0
2021,22,NJ,3059,3124,-65
2021,22,NM,85,93,-8
2021,22,NV,90,100,-10
2021,22,NY,2203,2238,-35
2021,22,OH,296,310,-14
2021,22,OK,173,183,-10
2021,22,OR,432,435,-3
2021,22,PA,571,605,-34
2021,22,PR,46,42,4
2021,22,RI,135,143,-8
2021,22,SC,3628,3763,-135
2021,22,SD,56,64,-8
2021,22,TN,558,601,-43
2021,22,TX,20189,22216,-2027
2021,22,UT,52,58,-6
2021,22,VA,1819,1942,-123
2021,22,VI,7,10,-3
2021,22,VT,29,36,-7
2021,22,WA,343,362,-19
2021,22,WI,125,144,-19
2021,22,WV,107,132,-25
2021,22,WY,34,32,2
2021,23,AK,14,16,-2
2021,23,AL,1076,1164,-88
2021,23,AR,171,173,-2
2021,23,AZ,295,304,-9
2021,23,CA,2145,2175,-30
2021,23,CO,324,341,-17
2021,23,CT,296,308,-12
2021,23,DC,261,258,3
2021,23,DE,427,423,4
2021,23,FL,29955,30489,-534
2021,23,GA,1294,1331,-37
2021,23,HI,536,575,-39
2021,23,IA,150,159,-9
2021,23,ID,70,72,-2
2021,23,IL,423,444,-21
2021,23,IN,215,227,-12
2021,23,KS,123,131,-8
2021,23,KY,246,221,25
2021,23,LA,11127,11092,35
2021,23,MA,662,685,-23
2021,23,MD,853,904,-51
2021,23,ME,58,75,-17
2021,23,MI,166,199,-33
2021,23,MN,76,77,-1
2021,23,MO,217,243,-26
2021,23,MS,1251,1291,-40
2021,23,MT,64,60,4
2021,23,NC,2405,2548,-143
2021,23,ND,104,115,-11
2021,23,NE,98,104,-6
2021,23,NH,66,65,1
2021,23,NJ,2153,2207,-54
2021,23,NM,79,90,-11
2021,23,NV,86,89,-3
2021,23,NY,2022,2097,-75
2021,23,OH,274,291,-17
2021,23,OK,200,211,-11
2021,23,OR,235,261,-26
2021,23,PA,565,583,-18
2021,23,PR,46,49,-3
2021,23,RI,117,131,-14
2021,23,SC,3538,3709,-171
2021,23,SD,34,36,-2
2021,23,TN,526,531,-5
2021,23,TX,22317,22846,-529
2021,23,UT,46,48,-2
2021,23,VA,1827,1908,-81
2021,23,VI,16,15,1
2021,23,VT,32,31,1
2021,23,WA,395,412,-17
2021,23,WI,116,130,-14
2021,23,WV,95,100,-5
2021,23,WY,32,35,-3
2021,24,AK,29,28,1
2021,24,AL,697,719,-22
2021,24,AR,167,172,-5
2021,24,AZ,304,310,-6
2021,24,CA,2123,2099,24
2021,24,CO,528,552,-24
2021,24,CT,348,358,-10
2021,24,DC,22,29,-7
2021,24,DE,362,366,-4
2021,24,FL,33020,33139,-119
2021,24,GA,1450,1443,7
2021,24,HI,937,949,-12
2021,24,IA,160,152,8
2021,24,ID,71,85,-14
2021,24,IL,486,561,-75
2021,24,IN,187,214,-27
2021,24,KS,184,213,-29
2021,24,KY,245,239,6
2021,24,LA,13922,11971,1951
2021,24,MA,544,584,-40
2021,24,MD,938,992,-54
2021,24,ME,81,89,-8
2021,24,MI,238,302,-64
2021,24,MN,78,96,-18
2021,24,MO,225,231,-6
2021,24,MS,1534,1552,-18
2021,24,MT,75,75,0
2021,24,NC,2664,2811,-147
2021,24,ND,72,84,-12
2021,24,NE,97,104,-7
2021,24,NH,68,71,-3
2021,24,NJ,2355,2421,-66
2021,24,NM,107,111,-4
2021,24,NV,83,89,-6
2021,24,NY,2516,2641,-125
2021,24,OH,340,399,-59
2021,24,OK,196,209,-13
2021,24,OR,226,235,-9
2021,24,PA,559,607,-48
2021,24,PR,43,42,1
2021,24,RI,352,366,-14
2021,24,SC,4122,4185,-63
2021,24,SD,37,36,1
2021,24,TN,492,501,-9
2021,24,TX,24724,23304,1420
2021,24,UT,68,70,-2
2021,24,VA,1793,1861,-68
2021,24,VI,94,94,0
2021,24,VT,30,32,-2
2021,24,WA,286,320,-34
2021,24,WI,183,183,0
2021,24,WV,115,123,-8
2021,24,WY,24,23,1
2021,25,AK,20,20,0
2021,25,AL,818,830,-12
2021,25,AR,161,163,-2
2021,25,AZ,321,318,3
2021,25,CA,2014,2043,-29
2021,25,CO,259,274,-15
2021,25,CT,365,371,-6
2021,25,DC,27,32,-5
2021,25,DE,319,332,-13
2021,25,FL,33124,33801,-677
2021,25,GA,1464,1479,-15
2021,25,HI,830,829,1
2021,25,IA,126,147,-21
2021,25,ID,129,141,-12
2021,25,IL,796,377,419
2021,25,IN,200,228,-28
2021,25,KS,145,165,-20
2021,25,KY,188,188,0
2021,25,LA,13593,11967,1626
2021,25,MA,481,514,-33
2021,25,MD,772,766,6
2021,25,ME,85,86,-1
2021,25,MI,225,280,-55
2021,25,MN,75,90,-15
2021,25,MO,223,227,-4
2021,25,MS,1348,1356,-8
2021,25,MT,69,84,-15
2021,25,NC,2933,3044,-111
2021,25,ND,129,135,-6
2021,25,NE,83,84,-1
2021,25,NH,81,82,-1
2021,25,NJ,2573,2660,-87
2021,25,NM,86,82,4
2021,25,NV,75,76,-1
2021,25,NY,2455,2527,-72
2021,25,OH,304,321,-17
2021,25,OK,224,259,-35
2021,25,OR,209,218,-9
2021,25,PA,558,582,-24
2021,25,PR,31,31,0
2021,25,RI,131,140,-9
2021,25,SC,3854,3910,-56
2021,25,SD,45,55,-10
2021,25,TN,458,484,-26
2021,25,TX,26352,24994,1358
2021,25,UT,63,65,-2
2021,25,VA,1868,1915,-47
2021,25,VI,7,7,0
2021,25,VT,28,29,-1
2021,25,WA,294,319,-25
2021,25,WI,109,115,-6
2021,25,WV,104,112,-8
2021,25,WY,24,24,0
2021,26,AK,27,27,0
2021,26,AL,997,1036,-39
2021,26,AR,169,177,-8
2021,26,AZ,370,404,-34
2021,26,CA,2098,2218,-120
2021,26,CO,262,320,-58
2021,26,CT,503,520,-17
2021,26,DC,52,63,-11
2021,26,DE,630,641,-11
2021,26,FL,43193,44390,-1197
2021,26,GA,2023,2111,-88
2021,26,HI,1953,1961,-8
2021,26,IA,258,277,-19
2021,26,ID,56,68,-12
2021,26,IL,553,607,-54
2021,26,IN,237,264,-27
2021,26,KS,184,194,-10
2021,26,KY,192,194,-2
2021,26,LA,17259,16782,477
2021,26,MA,1018,1034,-16
2021,26,MD,1743,1794,-51
2021,26,ME,98,106,-8
2021,26,MI,267,329,-62
2021,26,MN,111,125,-14
2021,26,MO,305,299,6
2021,26,MS,1611,1673,-62
2021,26,MT,151,154,-3
2021,26,NC,3738,4004,-266
2021,26,ND,141,152,-11
2021,26,NE,178,189,-11
2021,26,NH,86,95,-9
2021,26,NJ,3309,3419,-110
2021,26,NM,111,120,-9
2021,26,NV,123,132,-9
2021,26,NY,3559,3640,-81
2021,26,OH,391,429,-38
2021,26,OK,274,307,-33
2021,26,OR,265,271,-6
2021,26,PA,726,784,-58
2021,26,PR,50,50,0
2021,26,RI,169,181,-12
2021,26,SC,5237,5515,-278
2021,26,SD,82,89,-7
2021,26,TN,516,464,52
2021,26,TX,36399,38350,-1951
2021,26,UT,49,51,-2
2021,26,VA,2567,2680,-113
2021,26,VI,6,11,-5
2021,26,VT,46,45,1
2021,26,WA,367,386,-19
2021,26,WI,164,188,-24
2021,26,WV,134,144,-10
2021,26,WY,23,26,-3
2021,27,AK,19,16,3
2021,27,AL,839,834,5
2021,27,AR,156,165,-9
2021,27,AZ,324,322,2
2021,27,CA,1741,1767,-26
2021,27,CO,292,304,-12
2021,27,CT,330,342,-12
2021,27,DC,45,45,0
2021,27,DE,332,334,-2
2021,27,FL,33085,33942,-857
2021,27,GA,1683,1739,-56
2021,27,HI,480,408,72
2021,27,IA,154,167,-13
2021,27,ID,57,59,-2
2021,27,IL,348,389,-41
2021,27,IN,196,221,-25
2021,27,KS,124,134,-10
2021,27,KY,172,165,7
2021,27,LA,13402,12731,671
2021,27,MA,518,568,-50
2021,27,MD,725,729,-4
2021,27,ME,94,103,-9
2021,27,MI,245,284,-39
2021,27,MN,61,67,-6
2021,27,MO,224,244,-20
2021,27,MS,1337,1338,-1
2021,27,MT,45,47,-2
2021,27,NC,2693,2783,-90
2021,27,ND,62,65,-3
2021,27,NE,87,93,-6
2021,27,NH,62,65,-3
2021,27,NJ,1990,2037,-47
2021,27,NM,104,105,-1
2021,27,NV,73,79,-6
2021,27,NY,2280,2235,45
2021,27,OH,296,317,-21
2021,27,OK,193,190,3
2021,27,OR,220,232,-12
2021,27,PA,501,534,-33
2021,27,PR,45,48,-3
2021,27,RI,153,156,-3
2021,27,SC,3988,4126,-138
2021,27,SD,33,37,-4
2021,27,TN,402,398,4
2021,27,TX,27658,28042,-384
2021,27,UT,35,38,-3
2021,27,VA,1873,1977,-104
2021,27,VI,10,9,1
2021,27,VT,25,21,4
2021,27,WA,256,289,-33
2021,27,WI,111,128,-17
2021,27,WV,87,97,-10
2021,27,WY,25,26,-1
2021,28,AK,23,28,-5
2021,28,AL,770,770,0
2021,28,AR,155,163,-8
2021,28,AZ,433,449,-16
2021,28,CA,2282,2377,-95
2021,28,CO,274,295,-21
2021,28,CT,418,436,-18
2021,28,DC,25,24,1
2021,28,DE,354,344,10
2021,28,FL,32293,33194,-901
2021,28,GA,1732,1805,-73
2021,28,HI,786,527,259
2021,28,IA,173,185,-12
2021,28,ID,45,53,-8
2021,28,IL,618,649,-31
2021,28,IN,262,269,-7
2021,28,KS,137,149,-12
2021,28,KY,188,196,-8
2021,28,LA,13260,12249,1011
2021,28,MA,700,734,-34
2021,28,MD,1052,1040,12
2021,28,ME,106,110,-4
2021,28,MI,290,314,-24
2021,28,MN,93,107,-14
2021,28,MO,248,260,-12
2021,28,MS,1426,1361,65
2021,28,MT,62,65,-3
2021,28,NC,3300,3375,-75
2021,28,ND,68,74,-6
2021,28,NE,97,109,-12
2021,28,NH,66,67,-1
2021,28,NJ,3279,3347,-68
2021,28,NM,116,121,-5
2021,28,NV,83,82,1
2021,28,NY,2477,2571,-94
2021,28,OH,328,348,-20
2021,28,OK,191,206,-15
2021,28,OR,227,240,-13
2021,28,PA,586,640,-54
2021,28,PR,63,54,9
2021,28,RI,159,163,-4
2021,28,SC,3803,3984,-181
2021,28,SD,23,24,-1
2021,28,TN,441,466,-25
2021,28,TX,26063,26157,-94
2021,28,UT,38,39,-1
2021,28,VA,1968,2033,-65
2021,28,VI,7,6,1
2021,28,VT,36,38,-2
2021,28,WA,315,333,-18
2021,28,WI,123,143,-20
2021,28,WV,120,117,3
2021,28,WY,22,21,1
2021,29,AK,23,27,-4
2021,29,AL,802,785,17
2021,29,AR,158,155,3
2021,29,AZ,408,451,-43
2021,29,CA,1976,1978,-2
2021,29,CO,248,262,-14
2021,29,CT,416,441,-25
2021,29,DC,26,31,-5
2021,29,DE,335,337,-2
2021,29,FL,30463,30825,-362
2021,29,GA,1552,1585,-33
2021,29,HI,1471,728,743
2021,29,IA,204,213,-9
2021,29,ID,58,67,-9
2021,29,IL,647,679,-32
2021,29,IN,277,283,-6
2021,29,KS,122,132,-10
2021,29,KY,197,206,-9
2021,29,LA,11799,11327,472
2021,29,MA,803,893,-90
2021,29,MD,940,973,-33
2021,29,ME,96,92,4
2021,29,MI,224,255,-31
2021,29,MN,110,122,-12
2021,29,MO,199,223,-24
2021,29,MS,1262,1246,16
2021,29,MT,70,76,-6
2021,29,NC,2648,2688,-40
2021,29,ND,56,68,-12
2021,29,NE,78,82,-4
2021,29,NH,110,114,-4
2021,29,NJ,2519,2581,-62
2021,29,NM,108,109,-1
2021,29,NV,101,100,1
2021,29,NY,2287,2341,-54
2021,29,OH,335,371,-36
2021,29,OK,200,219,-19
2021,29,OR,218,225,-7
2021,29,PA,588,605,-17
2021,29,PR,65,41,24
2021,29,RI,154,162,-8
2021,29,SC,3656,3854,-198
2021,29,SD,47,50,-3
2021,29,TN,394,401,-7
2021,29,TX,23201,23874,-673
2021,29,UT,66,60,6
2021,29,VA,1930,1983,-53
2021,29,VI,7,6,1
2021,29,VT,49,47,2
2021,29,WA,362,377,-15
2021,29,WI,157,170,-13
2021,29,WV,115,127,-12
2021,29,WY,19,20,-1
2021,30,AK,33,38,-5
2021,30,AL,1258,1270,-12
2021,30,AR,187,191,-4
2021,30,AZ,479,546,-67
2021,30,CA,2208,2227,-19
2021,30,CO,281,302,-21
2021,30,CT,453,459,-6
2021,30,DC,27,28,-1
2021,30,DE,427,415,12
2021,30,FL,35685,36210,-525
2021,30,GA,2131,1904,227
2021,30,HI,700,767,-67
2021,30,IA,184,191,-7
2021,30,ID,98,105,-7
2021,30,IL,524,510,14
2021,30,IN,273,276,-3
2021,30,KS,147,144,3
2021,30,KY,216,229,-13
2021,30,LA,13013,12670,343
2021,30,MA,676,714,-38
2021,30,MD,1100,1123,-23
2021,30,ME,125,131,-6
2021,30,MI,337,245,92
2021,30,MN,112,123,-11
2021,30,MO,252,257,-5
2021,30,MS,1325,1284,41
2021,30,MT,53,58,-5
2021,30,NC,3267,3197,70
2021,30,ND,91,97,-6
2021,30,NE,101,117,-16
2021,30,NH,84,89,-5
2021,30,NJ,2940,3008,-68
2021,30,NM,126,130,-4
2021,30,NV,105,105,0
2021,30,NY,3003,3032,-29
2021,30,OH,382,419,-37
2021,30,OK,259,259,0
2021,30,OR,233,235,-2
2021,30,PA,711,745,-34
2021,30,PR,51,49,2
2021,30,RI,200,208,-8
2021,30,SC,4105,4290,-185
2021,30,SD,24,28,-4
2021,30,TN,436,425,11
2021,30,TX,23115,23690,-575
2021,30,UT,235,58,177
2021,30,VA,2430,2537,-107
2021,30,VI,5,5,0
2021,30,VT,49,52,-3
2021,30,WA,366,391,-25
2021,30,WI,169,189,-20
2021,30,WV,128,129,-1
2021,30,WY,20,24,-4
2021,31,AK,23,22,1
2021,31,AL,687,688,-1
2021,31,AR,131,140,-9
2021,31,AZ,366,471,-105
2021,31,CA,1973,2045,-72
2021,31,CO,227,234,-7
2021,31,CT,387,394,-7
2021,31,DC,24,28,-4
2021,31,DE,310,314,-4
2021,31,FL,25196,25053,143
2021,31,GA,1487,1489,-2
2021,31,HI,828,835,-7
2021,31,IA,140,154,-14
2021,31,ID,51,55,-4
2021,31,IL,334,352,-18
2021,31,IN,236,242,-6
2021,31,KS,105,110,-5
2021,31,KY,186,188,-2
2021,31,LA,9064,8743,321
2021,31,MA,763,774,-11
2021,31,MD,1096,800,296
2021,31,ME,93,97,-4
2021,31,MI,191,186,5
2021,31,MN,72,85,-13
2021,31,MO,216,221,-5
2021,31,MS,1027,1020,7
2021,31,MT,40,43,-3
2021,31,NC,2390,2387,3
2021,31,ND,55,66,-11
2021,31,NE,77,74,3
2021,31,NH,68,71,-3
2021,31,NJ,2470,2513,-43
2021,31,NM,152,150,2
2021,31,NV,113,115,-2
2021,31,NY,2238,2286,-48
2021,31,OH,318,358,-40
2021,31,OK,143,155,-12
2021,31,OR,184,196,-12
2021,31,PA,678,689,-11
2021,31,PR,46,44,2
2021,31,RI,190,196,-6
2021,31,SC,3480,3508,-28
2021,31,SD,37,39,-2
2021,31,TN,368,378,-10
2021,31,TX,17151,16990,161
2021,31,UT,57,68,-11
2021,31,VA,1783,1800,-17
2021,31,VI,8,15,-7
2021,31,VT,39,35,4
2021,31,WA,295,335,-40
2021,31,WI,112,125,-13
2021,31,WV,103,109,-6
2021,31,WY,22,26,-4
2021,32,AK,23,22,1
2021,32,AL,822,834,-12
2021,32,AR,154,158,-4
2021,32,AZ,477,513,-36
2021,32,CA,2018,2038,-20
2021,32,CO,271,300,-29
2021,32,CT,462,453,9
2021,32,DC,36,42,-6
2021,32,DE,423,411,12
2021,32,FL,31158,31464,-306
2021,32,GA,1734,1773,-39
2021,32,HI,494,492,2
2021,32,IA,145,152,-7
2021,32,ID,61,69,-8
2021,32,IL,368,380,-12
2021,32,IN,246,271,-25
2021,32,KS,109,114,-5
2021,32,KY,189,212,-23
2021,32,LA,11817,11807,10
2021,32,MA,751,753,-2
2021,32,MD,733,762,-29
2021,32,ME,120,121,-1
2021,32,MI,279,252,27
2021,32,MN,93,113,-20
2021,32,MO,222,227,-5
2021,32,MS,1136,1136,0
2021,32,MT,42,43,-1
2021,32,NC,3168,3264,-96
2021,32,ND,93,100,-7
2021,32,NE,98,106,-8
2021,32,NH,60,64,-4
2021,32,NJ,3113,3149,-36
2021,32,NM,151,154,-3
2021,32,NV,101,108,-7
2021,32,NY,2710,2642,68
2021,32,OH,335,337,-2
2021,32,OK,223,231,-8
2021,32,OR,252,249,3
2021,32,PA,706,690,16
2021,32,PR,44,45,-1
2021,32,RI,393,397,-4
2021,32,SC,3872,4080,-208
2021,32,SD,31,36,-5
2021,32,TN,436,426,10
2021,32,TX,19267,19852,-585
2021,32,UT,44,44,0
2021,32,VA,2014,2102,-88
2021,32,VI,11,11,0
2021,32,VT,42,46,-4
2021,32,WA,321,350,-29
2021,32,WI,135,151,-16
2021,32,WV,151,148,3
2021,32,WY,27,22,5
2021,33,AK,30,33,-3
2021,33,AL,708,712,-4
2021,33,AR,165,170,-5
2021,33,AZ,524,632,-108
2021,33,CA,2132,2187,-55
2021,33,CO,303,286,17
2021,33,CT,630,620,10
2021,33,DC,44,42,2
2021,33,DE,377,378,-1
2021,33,FL,28048,28697,-649
2021,33,GA,1669,1699,-30
2021,33,HI,1173,1169,4
2021,33,IA,174,174,0
2021,33,ID,86,92,-6
2021,33,IL,533,542,-9
2021,33,IN,243,242,1
2021,33,KS,103,112,-9
2021,33,KY,200,205,-5
2021,33,LA,10912,10673,239
2021,33,MA,751,736,15
2021,33,MD,830,833,-3
2021,33,ME,121,123,-2
2021,33,MI,265,235,30
2021,33,MN,99,101,-2
2021,33,MO,242,262,-20
2021,33,MS,1069,1068,1
2021,33,MT,69,64,5
2021,33,NC,2884,2980,-96
2021,33,ND,89,102,-13
2021,33,NE,78,76,2
2021,33,NH,74,68,6
2021,33,NJ,2734,2773,-39
2021,33,NM,134,125,9
2021,33,NV,112,126,-14
2021,33,NY,2653,2649,4
2021,33,OH,370,395,-25
2021,33,OK,160,168,-8
2021,33,OR,289,277,12
2021,33,PA,983,985,-2
2021,33,PR,44,50,-6
2021,33,RI,203,204,-1
2021,33,SC,4199,4383,-184
2021,33,SD,45,46,-1
2021,33,TN,426,428,-2
2021,33,TX,17281,17438,-157
2021,33,UT,58,58,0
2021,33,VA,1906,1936,-30
2021,33,VI,12,16,-4
2021,33,VT,35,32,3
2021,33,WA,375,366,9
2021,33,WI,132,127,5
2021,33,WV,126,129,-3
2021,33,WY,23,28,-5
2021,34,AK,25,29,-4
2021,34,AL,1035,1039,-4
2021,34,AR,174,193,-19
2021,34,AZ,661,672,-11
2021,34,CA,2098,2143,-45
2021,34,CO,342,364,-22
2021,34,CT,562,576,-14
2021,34,DC,100,99,1
2021,34,DE,546,536,10
2021,34,FL,35308,36088,-780
2021,34,GA,1613,1674,-61
2021,34,HI,3674,3809,-135
2021,34,IA,156,164,-8
2021,34,ID,108,103,5
2021,34,IL,481,507,-26
2021,34,IN,207,216,-9
2021,34,KS,92,93,-1
2021,34,KY,212,219,-7
2021,34,LA,10998,10759,239
2021,34,MA,989,998,-9
2021,34,MD,956,968,-12
2021,34,ME,113,116,-3
2021,34,MI,256,220,36
2021,34,MN,80,94,-14
2021,34,MO,204,225,-21
2021,34,MS,1220,1209,11
2021,34,MT,41,45,-4
2021,34,NC,2963,3065,-102
2021,34,ND,95,100,-5
2021,34,NE,72,81,-9
2021,34,NH,69,69,0
2021,34,NJ,2548,2653,-105
2021,34,NM,179,172,7
2021,34,NV,127,123,4
2021,34,NY,3142,3143,-1
2021,34,OH,361,372,-11
2021,34,OK,160,164,-4
2021,34,OR,338,335,3
2021,34,PA,700,718,-18
2021,34,PR,44,53,-9
2021,34,RI,263,271,-8
2021,34,SC,4249,4451,-202
2021,34,SD,52,53,-1
2021,34,TN,440,432,8
2021,34,TX,16980,17873,-893
2021,34,UT,62,52,10
2021,34,VA,2335,2435,-100
2021,34,VI,17,15,2
2021,34,VT,43,42,1
2021,34,WA,363,380,-17
2021,34,WI,151,167,-16
2021,34,WV,120,122,-2
2021,34,WY,11,11,0
2021,35,AK,37,35,2
2021,35,AL,911,910,1
2021,35,AR,164,161,3
2021,35,AZ,470,501,-31
2021,35,CA,2299,2361,-62
2021,35,CO,342,355,-13
2021,35,CT,579,590,-11
2021,35,DC,47,50,-3
2021,35,DE,388,390,-2
2021,35,FL,29437,30353,-916
2021,35,GA,1715,1796,-81
2021,35,HI,2565,2584,-19
2021,35,IA,155,168,-13
2021,35,ID,69,67,2
2021,35,IL,442,471,-29
2021,35,IN,238,246,-8
2021,35,KS,124,135,-11
2021,35,KY,233,231,2
2021,35,LA,10523,10455,68
2021,35,MA,976,987,-11
2021,35,MD,1112,1163,-51
2021,35,ME,93,94,-1
2021,35,MI,256,218,38
2021,35,MN,95,114,-19
2021,35,MO,208,223,-15
2021,35,MS,1077,1085,-8
2021,35,MT,49,49,0
2021,35,NC,3279,3386,-107
2021,35,ND,136,143,-7
2021,35,NE,92,94,-2
2021,35,NH,138,138,0
2021,35,NJ,3031,3082,-51
2021,35,NM,144,147,-3
2021,35,NV,117,123,-6
2021,35,NY,3019,3078,-59
2021,35,OH,382,383,-1
2021,35,OK,196,193,3
2021,35,OR,298,307,-9
2021,35,PA,820,827,-7
2021,35,PR,39,49,-10
2021,35,RI,226,229,-3
2021,35,SC,3848,4123,-275
2021,35,SD,50,52,-2
2021,35,TN,431,428,3
2021,35,TX,16372,16736,-364
2021,35,UT,97,67,30
2021,35,VA,2386,2504,-118
2021,35,VI,11,11,0
2021,35,VT,27,27,0
2021,35,WA,397,428,-31
2021,35,WI,167,174,-7
2021,35,WV,170,166,4
2021,35,WY,19,21,-2
2021,36,AK,28,27,1
2021,36,AL,1071,1049,22
2021,36,AR,141,156,-15
2021,36,AZ,373,350,23
2021,36,CA,2082,2124,-42
2021,36,CO,300,295,5
2021,36,CT,423,420,3
2021,36,DC,31,33,-2
2021,36,DE,485,480,5
2021,36,FL,24010,24360,-350
2021,36,GA,1450,1483,-33
2021,36,HI,1761,1761,0
2021,36,IA,118,122,-4
2021,36,ID,50,55,-5
2021,36,IL,308,301,7
2021,36,IN,172,191,-19
2021,36,KS,111,113,-2
2021,36,KY,162,171,-9
2021,36,LA,8572,8391,181
2021,36,MA,741,761,-20
2021,36,MD,653,687,-34
2021,36,ME,110,112,-2
2021,36,MI,234,203,31
2021,36,MN,70,74,-4
2021,36,MO,216,243,-27
2021,36,MS,941,930,11
2021,36,MT,41,50,-9
2021,36,NC,2545,2597,-52
2021,36,ND,130,153,-23
2021,36,NE,72,69,3
2021,36,NH,74,73,1
2021,36,NJ,2666,2688,-22
2021,36,NM,128,128,0
2021,36,NV,93,96,-3
2021,36,NY,2640,2572,68
2021,36,OH,280,284,-4
2021,36,OK,131,132,-1
2021,36,OR,433,427,6
2021,36,PA,705,717,-12
2021,36,PR,47,57,-10
2021,36,RI,243,250,-7
2021,36,SC,3124,3231,-107
2021,36,SD,33,33,0
2021,36,TN,329,355,-26
2021,36,TX,13400,13358,42
2021,36,UT,62,47,15
2021,36,VA,1889,1973,-84
2021,36,VI,13,12,1
2021,36,VT,44,38,6
2021,36,WA,335,343,-8
2021,36,WI,137,136,1
2021,36,WV,135,144,-9
2021,36,WY,22,21,1
2021,37,AK,31,30,1
2021,37,AL,1004,1010,-6
2021,37,AR,168,173,-5
2021,37,AZ,441,417,24
2021,37,CA,2513,2552,-39
2021,37,CO,326,337,-11
2021,37,CT,535,546,-11
2021,37,DC,46,43,3
2021,37,DE,433,432,1
2021,37,FL,25607,26155,-548
2021,37,GA,1432,1469,-37
2021,37,HI,1729,1735,-6
2021,37,IA,135,156,-21
2021,37,ID,64,61,3
2021,37,IL,354,380,-26
2021,37,IN,208,230,-22
2021,37,KS,97,103,-6
2021,37,KY,209,205,4
2021,37,LA,12095,12260,-165
2021,37,MA,875,842,33
2021,37,MD,991,990,1
2021,37,ME,130,132,-2
2021,37,MI,257,250,7
2021,37,MN,79,94,-15
2021,37,MO,200,205,-5
2021,37,MS,1086,1124,-38
2021,37,MT,55,56,-1
2021,37,NC,2668,2673,-5
2021,37,ND,134,149,-15
2021,37,NE,80,77,3
2021,37,NH,98,107,-9
2021,37,NJ,2933,2993,-60
2021,37,NM,149,149,0
2021,37,NV,106,108,-2
2021,37,NY,3346,3396,-50
2021,37,OH,315,321,-6
2021,37,OK,137,152,-15
2021,37,OR,257,263,-6
2021,37,PA,759,764,-5
2021,37,PR,53,56,-3
2021,37,RI,181,194,-13
2021,37,SC,3449,3578,-129
2021,37,SD,27,31,-4
2021,37,TN,425,402,23
2021,37,TX,15045,14929,116
2021,37,UT,79,55,24
2021,37,VA,1854,1900,-46
2021,37,VI,22,23,-1
2021,37,VT,49,45,4
2021,37,WA,421,439,-18
2021,37,WI,139,139,0
2021,37,WV,133,128,5
2021,37,WY,13,10,3
2021,38,AK,34,36,-2
2021,38,AL,774,765,9
2021,38,AR,162,162,0
2021,38,AZ,475,476,-1
2021,38,CA,2529,2644,-115
2021,38,CO,297,286,11
2021,38,CT,514,475,39
2021,38,DC,42,44,-2
2021,38,DE,444,435,9
2021,38,FL,25348,26201,-853
2021,38,GA,1541,1603,-62
2021,38,HI,2040,2049,-9
2021,38,IA,132,150,-18
2021,38,ID,72,75,-3
2021,38,IL,380,383,-3
2021,38,IN,192,208,-16
2021,38,KS,138,155,-17
2021,38,KY,228,221,7
2021,38,LA,14020,14125,-105
2021,38,MA,1098,1010,88
2021,38,MD,943,954,-11
2021,38,ME,130,127,3
2021,38,MI,307,292,15
2021,38,MN,184,181,3
2021,38,MO,208,225,-17
2021,38,MS,1146,1152,-6
2021,38,MT,54,56,-2
2021,38,NC,2756,2762,-6
2021,38,ND,128,141,-13
2021,38,NE,84,86,-2
2021,38,NH,112,123,-11
2021,38,NJ,3343,3329,14
2021,38,NM,126,113,13
2021,38,NV,123,132,-9
2021,38,NY,3693,3612,81
2021,38,OH,356,360,-4
2021,38,OK,171,179,-8
2021,38,OR,273,292,-19
2021,38,PA,879,871,8
2021,38,PR,47,59,-12
2021,38,RI,300,280,20
2021,38,SC,3875,4045,-170
2021,38,SD,28,30,-2
2021,38,TN,607,513,94
2021,38,TX,17709,18699,-990
2021,38,UT,61,64,-3
2021,38,VA,1994,2059,-65
2021,38,VI,9,11,-2
2021,38,VT,43,38,5
2021,38,WA,424,432,-8
2021,38,WI,173,188,-15
2021,38,WV,135,134,1
2021,38,WY,16,13,3
2021,39,AK,40,42,-2
2021,39,AL,1249,1267,-18
2021,39,AR,218,247,-29
2021,39,AZ,458,462,-4
2021,39,CA,2873,3029,-156
2021,39,CO,275,302,-27
2021,39,CT,599,602,-3
2021,39,DC,48,44,4
2021,39,DE,549,563,-14
2021,39,FL,41328,43418,-2090
2021,39,GA,2080,2219,-139
2021,39,HI,1887,1897,-10
2021,39,IA,289,298,-9
2021,39,ID,71,83,-12
2021,39,IL,434,454,-20
2021,39,IN,277,296,-19
2021,39,KS,109,126,-17
2021,39,KY,251,251,0
2021,39,LA,13744,13977,-233
2021,39,MA,1152,1182,-30
2021,39,MD,1485,1544,-59
2021,39,ME,152,158,-6
2021,39,MI,231,245,-14
2021,39,MN,130,142,-12
2021,39,MO,237,265,-28
2021,39,MS,1182,1192,-10
2021,39,MT,42,43,-1
2021,39,NC,3476,3549,-73
2021,39,ND,147,138,9
2021,39,NE,116,112,4
2021,39,NH,114,118,-4
2021,39,NJ,3592,3626,-34
2021,39,NM,121,126,-5
2021,39,NV,106,109,-3
2021,39,NY,3701,3761,-60
2021,39,OH,430,437,-7
2021,39,OK,196,218,-22
2021,39,OR,331,345,-14
2021,39,PA,1106,1092,14
2021,39,PR,51,60,-9
2021,39,RI,219,226,-7
2021,39,SC,5820,6046,-226
2021,39,SD,53,56,-3
2021,39,TN,689,564,125
2021,39,TX,21167,22260,-1093
2021,39,UT,68,63,5
2021,39,VA,3249,3634,-385
2021,39,VI,6,6,0
2021,39,VT,46,47,-1
2021,39,WA,598,668,-70
2021,39,WI,203,218,-15
2021,39,WV,144,146,-2
2021,39,WY,19,23,-4
2021,40,AK,24,28,-4
2021,40,AL,896,979,-83
2021,40,AR,106,127,-21
2021,40,AZ,307,361,-54
2021,40,CA,2443,2753,-310
2021,40,CO,269,301,-32
2021,40,CT,539,573,-34
2021,40,DC,38,46,-8
2021,40,DE,508,549,-41
2021,40,FL,25852,29495,-3643
2021,40,GA,1668,1874,-206
2021,40,HI,2492,2506,-14
2021,40,IA,91,111,-20
2021,40,ID,53,64,-11
2021,40,IL,335,394,-59
2021,40,IN,194,224,-30
2021,40,KS,101,126,-25
2021,40,KY,160,179,-19
2021,40,LA,8386,9175,-789
2021,40,MA,1043,1108,-65
2021,40,MD,960,1049,-89
2021,40,ME,126,139,-13
2021,40,MI,167,210,-43
2021,40,MN,93,107,-14
2021,40,MO,177,201,-24
2021,40,MS,844,931,-87
2021,40,MT,42,49,-7
2021,40,NC,2851,3190,-339
2021,40,ND,64,77,-13
2021,40,NE,59,70,-11
2021,40,NH,79,90,-11
2021,40,NJ,2361,2518,-157
2021,40,NM,116,127,-11
2021,40,NV,81,96,-15
2021,40,NY,3044,3254,-210
2021,40,OH,274,310,-36
2021,40,OK,170,198,-28
2021,40,OR,295,318,-23
2021,40,PA,826,908,-82
2021,40,PR,23,33,-10
2021,40,RI,190,213,-23
2021,40,SC,3370,3871,-501
2021,40,SD,29,30,-1
2021,40,TN,357,396,-39
2021,40,TX,16948,19317,-2369
2021,40,UT,52,63,-11
2021,40,VA,2357,2671,-314
2021,40,VI,5,6,-1
2021,40,VT,41,45,-4
2021,40,WA,450,483,-33
2021,40,WI,119,137,-18
2021,40,WV,124,132,-8
2021,40,WY,18,22,-4
2021,41,AK,21,22,-1
2021,41,AL,556,642,-86
2021,41,AR,139,158,-19
2021,41,AZ,414,487,-73
2021,41,CA,3150,3533,-383
2021,41,CO,272,299,-27
2021,41,CT,498,531,-33
2021,41,DC,64,79,-15
2021,41,DE,465,486,-21
2021,41,FL,24615,26887,-2272
2021,41,GA,1442,1621,-179
2021,41,HI,719,741,-22
2021,41,IA,136,155,-19
2021,41,ID,65,76,-11
2021,41,IL,352,398,-46
2021,41,IN,227,244,-17
2021,41,KS,88,99,-11
2021,41,KY,172,202,-30
2021,41,LA,8467,9223,-756
2021,41,MA,1010,1154,-144
2021,41,MD,1170,1293,-123
2021,41,ME,140,153,-13
2021,41,MI,222,254,-32
2021,41,MN,87,102,-15
2021,41,MO,206,231,-25
2021,41,MS,856,939,-83
2021,41,MT,42,49,-7
2021,41,NC,2560,2886,-326
2021,41,ND,100,114,-14
2021,41,NE,69,74,-5
2021,41,NH,107,118,-11
2021,41,NJ,2714,2890,-176
2021,41,NM,132,152,-20
2021,41,NV,103,117,-14
2021,41,NY,3511,3735,-224
2021,41,OH,326,364,-38
2021,41,OK,138,161,-23
2021,41,OR,322,366,-44
2021,41,PA,825,919,-94
2021,41,PR,18,22,-4
2021,41,RI,185,206,-21
2021,41,SC,2738,3200,-462
2021,41,SD,29,31,-2
2021,41,TN,409,472,-63
2021,41,TX,14964,16816,-1852
2021,41,UT,63,78,-15
2021,41,VA,2474,2776,-302
2021,41,VI,12,13,-1
2021,41,VT,43,45,-2
2021,41,WA,544,605,-61
2021,41,WI,135,155,-20
2021,41,WV,119,134,-15
2021,41,WY,16,16,0
2021,42,AK,39,44,-5
2021,42,AL,575,637,-62
2021,42,AR,139,160,-21
2021,42,AZ,370,421,-51
2021,42,CA,3543,3957,-414
2021,42,CO,258,291,-33
2021,42,CT,368,407,-39
2021,42,DC,47,54,-7
2021,42,DE,371,395,-24
2021,42,FL,24397,26898,-2501
2021,42,GA,1533,1689,-156
2021,42,HI,3266,3297,-31
2021,42,IA,184,199,-15
2021,42,ID,60,68,-8
2021,42,IL,320,371,-51
2021,42,IN,219,244,-25
2021,42,KS,93,110,-17
2021,42,KY,144,164,-20
2021,42,LA,7499,8243,-744
2021,42,MA,1042,1103,-61
2021,42,MD,849,931,-82
2021,42,ME,187,194,-7
2021,42,MI,170,214,-44
2021,42,MN,104,124,-20
2021,42,MO,186,212,-26
2021,42,MS,841,934,-93
2021,42,MT,46,50,-4
2021,42,NC,2170,2464,-294
2021,42,ND,111,125,-14
2021,42,NE,62,68,-6
2021,42,NH,71,88,-17
2021,42,NJ,2822,2978,-156
2021,42,NM,94,110,-16
2021,42,NV,113,126,-13
2021,42,NY,2580,2760,-180
2021,42,OH,291,332,-41
2021,42,OK,167,188,-21
2021,42,OR,596,641,-45
2021,42,PA,820,902,-82
2021,42,PR,26,33,-7
2021,42,RI,185,192,-7
2021,42,SC,3062,3482,-420
2021,42,SD,42,46,-4
2021,42,TN,353,388,-35
2021,42,TX,14973,17116,-2143
2021,42,UT,61,72,-11
2021,42,VA,2177,2421,-244
2021,42,VI,9,10,-1
2021,42,VT,45,50,-5
2021,42,WA,468,538,-70
2021,42,WI,130,143,-13
2021,42,WV,134,145,-11
2021,42,WY,16,18,-2
2021,43,AK,29,37,-8
2021,43,AL,1149,1242,-93
2021,43,AR,129,143,-14
2021,43,AZ,359,417,-58
2021,43,CA,3261,3658,-397
2021,43,CO,316,353,-37
2021,43,CT,693,729,-36
2021,43,DC,43,48,-5
2021,43,DE,567,604,-37
2021,43,FL,23477,26291,-2814
2021,43,GA,1416,1573,-157
2021,43,HI,1124,1143,-19
2021,43,IA,127,150,-23
2021,43,ID,63,73,-10
2021,43,IL,357,403,-46
2021,43,IN,218,258,-40
2021,43,KS,95,112,-17
2021,43,KY,172,196,-24
2021,43,LA,7637,8381,-744
2021,43,MA,1214,1277,-63
2021,43,MD,944,1027,-83
2021,43,ME,155,166,-11
2021,43,MI,200,242,-42
2021,43,MN,100,113,-13
2021,43,MO,184,209,-25
2021,43,MS,887,981,-94
2021,43,MT,43,45,-2
2021,43,NC,2362,2658,-296
2021,43,ND,149,168,-19
2021,43,NE,72,80,-8
2021,43,NH,89,101,-12
2021,43,NJ,2424,2535,-111
2021,43,NM,88,100,-12
2021,43,NV,127,135,-8
2021,43,NY,2544,2747,-203
2021,43,OH,359,409,-50
2021,43,OK,163,179,-16
2021,43,OR,344,387,-43
2021,43,PA,990,1068,-78
2021,43,PR,24,35,-11
2021,43,RI,183,203,-20
2021,43,SC,3069,3491,-422
2021,43,SD,28,34,-6
2021,43,TN,493,557,-64
2021,43,TX,13507,15396,-1889
2021,43,UT,44,58,-14
2021,43,VA,1760,1944,-184
2021,43,VI,4,6,-2
2021,43,VT,42,51,-9
2021,43,WA,557,639,-82
2021,43,WI,149,170,-21
2021,43,WV,104,118,-14
2021,43,WY,18,23,-5
2021,44,AK,29,33,-4
2021,44,AL,826,912,-86
2021,44,AR,114,130,-16
2021,44,AZ,283,344,-61
2021,44,CA,3316,3680,-364
2021,44,CO,319,344,-25
2021,44,CT,358,405,-47
2021,44,DC,37,43,-6
2021,44,DE,322,341,-19
2021,44,FL,23900,26267,-2367
2021,44,GA,1223,1356,-133
2021,44,HI,2128,2152,-24
2021,44,IA,134,153,-19
2021,44,ID,56,69,-13
2021,44,IL,304,354,-50
2021,44,IN,185,217,-32
2021,44,KS,100,109,-9
2021,44,KY,181,205,-24
2021,44,LA,6464,7192,-728
2021,44,MA,835,891,-56
2021,44,MD,845,926,-81
2021,44,ME,118,123,-5
2021,44,MI,192,233,-41
2021,44,MN,83,102,-19
2021,44,MO,187,218,-31
2021,44,MS,753,823,-70
2021,44,MT,31,34,-3
2021,44,NC,2236,2423,-187
2021,44,ND,96,108,-12
2021,44,NE,69,76,-7
2021,44,NH,81,94,-13
2021,44,NJ,2600,2756,-156
2021,44,NM,90,98,-8
2021,44,NV,90,101,-11
2021,44,NY,2396,2566,-170
2021,44,OH,270,301,-31
2021,44,OK,167,194,-27
2021,44,OR,401,447,-46
2021,44,PA,623,688,-65
2021,44,PR,26,29,-3
2021,44,RI,127,146,-19
2021,44,SC,2875,3300,-425
2021,44,SD,27,32,-5
2021,44,TN,343,393,-50
2021,44,TX,10716,12259,-1543
2021,44,UT,84,103,-19
2021,44,VA,1454,1621,-167
2021,44,VI,3,4,-1
2021,44,VT,48,57,-9
2021,44,WA,563,693,-130
2021,44,WI,129,154,-25
2021,44,WV,132,141,-9
2021,44,WY,19,20,-1
2021,45,AK,14,19,-5
2021,45,AL,639,691,-52
2021,45,AR,109,139,-30
2021,45,AZ,264,312,-48
2021,45,CA,3395,3779,-384
2021,45,CO,213,237,-24
2021,45,CT,479,516,-37
2021,45,DC,26,32,-6
2021,45,DE,250,278,-28
2021,45,FL,16760,18778,-2018
2021,45,GA,1025,1124,-99
2021,45,HI,1021,1038,-17
2021,45,IA,92,103,-11
2021,45,ID,75,85,-10
2021,45,IL,287,320,-33
2021,45,IN,192,209,-17
2021,45,KS,97,106,-9
2021,45,KY,132,152,-20
2021,45,LA,5480,6028,-548
2021,45,MA,701,748,-47
2021,45,MD,601,667,-66
2021,45,ME,102,116,-14
2021,45,MI,152,186,-34
2021,45,MN,152,170,-18
2021,45,MO,194,218,-24
2021,45,MS,713,780,-67
2021,45,MT,30,34,-4
2021,45,NC,2108,2318,-210
2021,45,ND,66,78,-12
2021,45,NE,52,57,-5
2021,45,NH,82,85,-3
2021,45,NJ,2560,2705,-145
2021,45,NM,87,98,-11
2021,45,NV,79,93,-14
2021,45,NY,2254,2428,-174
2021,45,OH,234,267,-33
2021,45,OK,129,142,-13
2021,45,OR,359,405,-46
2021,45,PA,580,645,-65
2021,45,PR,24,33,-9
2021,45,RI,102,117,-15
2021,45,SC,2546,2863,-317
2021,45,SD,26,30,-4
2021,45,TN,395,376,19
2021,45,TX,8635,9918,-1283
2021,45,UT,48,54,-6
2021,45,VA,1365,1489,-124
2021,45,VI,1,1,0
2021,45,VT,42,47,-5
2021,45,WA,605,659,-54
2021,45,WI,101,114,-13
2021,45,WV,100,115,-15
2021,45,WY,20,23,-3
2021,46,AK,19,48,-29
2021,46,AL,716,781,-65
2021,46,AR,112,132,-20
2021,46,AZ,297,368,-71
2021,46,CA,3651,4066,-415
2021,46,CO,259,285,-26
2021,46,CT,355,403,-48
2021,46,DC,19,22,-3
2021,46,DE,412,350,62
2021,46,FL,20564,22953,-2389
2021,46,GA,1036,1182,-146
2021,46,HI,519,542,-23
2021,46,IA,92,115,-23
2021,46,ID,46,51,-5
2021,46,IL,263,328,-65
2021,46,IN,172,209,-37
2021,46,KS,84,92,-8
2021,46,KY,176,196,-20
2021,46,LA,6165,6731,-566
2021,46,MA,747,861,-114
2021,46,MD,994,1061,-67
2021,46,ME,107,118,-11
2021,46,MI,161,209,-48
2021,46,MN,69,90,-21
2021,46,MO,186,207,-21
2021,46,MS,1039,1109,-70
2021,46,MT,46,48,-2
2021,46,NC,2049,2499,-450
2021,46,ND,71,82,-11
2021,46,NE,63,76,-13
2021,46,NH,62,69,-7
2021,46,NJ,2538,2705,-167
2021,46,NM,117,122,-5
2021,46,NV,106,118,-12
2021,46,NY,2223,2428,-205
2021,46,OH,289,336,-47
2021,46,OK,137,160,-23
2021,46,OR,453,494,-41
2021,46,PA,624,692,-68
2021,46,PR,26,42,-16
2021,46,RI,118,130,-12
2021,46,SC,2752,3126,-374
2021,46,SD,19,24,-5
2021,46,TN,278,316,-38
2021,46,TX,9163,10528,-1365
2021,46,UT,66,78,-12
2021,46,VA,1419,1567,-148
2021,46,VI,8,8,0
2021,46,VT,33,37,-4
2021,46,WA,587,669,-82
2021,46,WI,102,126,-24
2021,46,WV,119,129,-10
2021,46,WY,10,13,-3
2021,47,AK,26,31,-5
2021,47,AL,410,467,-57
2021,47,AR,80,97,-17
2021,47,AZ,221,259,-38
2021,47,CA,4122,4622,-500
2021,47,CO,155,181,-26
2021,47,CT,301,360,-59
2021,47,DC,51,55,-4
2021,47,DE,303,329,-26
2021,47,FL,17284,18935,-1651
2021,47,GA,821,931,-110
2021,47,HI,960,970,-10
2021,47,IA,103,104,-1
2021,47,ID,57,68,-11
2021,47,IL,241,278,-37
2021,47,IN,177,195,-18
2021,47,KS,80,87,-7
2021,47,KY,146,161,-15
2021,47,LA,5271,5790,-519
2021,47,MA,603,674,-71
2021,47,MD,1206,1315,-109
2021,47,ME,93,95,-2
2021,47,MI,126,158,-32
2021,47,MN,53,75,-22
2021,47,MO,121,151,-30
2021,47,MS,608,650,-42
2021,47,MT,29,32,-3
2021,47,NC,1431,1599,-168
2021,47,ND,63,75,-12
2021,47,NE,53,58,-5
2021,47,NH,63,73,-10
2021,47,NJ,1767,1985,-218
2021,47,NM,79,87,-8
2021,47,NV,87,102,-15
2021,47,NY,2230,2388,-158
2021,47,OH,221,255,-34
2021,47,OK,109,130,-21
2021,47,OR,357,389,-32
2021,47,PA,514,577,-63
2021,47,PR,23,28,-5
2021,47,RI,198,204,-6
2021,47,SC,2139,2409,-270
2021,47,SD,23,33,-10
2021,47,TN,245,284,-39
2021,47,TX,7617,8718,-1101
2021,47,UT,32,38,-6
2021,47,VA,1149,1290,-141
2021,47,VI,11,11,0
2021,47,VT,40,47,-7
2021,47,WA,439,488,-49
2021,47,WI,89,101,-12
2021,47,WV,80,87,-7
2021,47,WY,17,21,-4
2021,48,AK,28,30,-2
2021,48,AL,716,779,-63
2021,48,AR,95,104,-9
2021,48,AZ,234,291,-57
2021,48,CA,4396,5063,-667
2021,48,CO,152,187,-35
2021,48,CT,553,650,-97
2021,48,DC,21,33,-12
2021,48,DE,287,318,-31
2021,48,FL,21117,24029,-2912
2021,48,GA,914,1047,-133
2021,48,HI,932,953,-21
2021,48,IA,77,103,-26
2021,48,ID,63,73,-10
2021,48,IL,315,366,-51
2021,48,IN,152,184,-32
2021,48,KS,83,108,-25
2021,48,KY,139,165,-26
2021,48,LA,5620,6213,-593
2021,48,MA,706,864,-158
2021,48,MD,643,728,-85
2021,48,ME,87,104,-17
2021,48,MI,197,248,-51
2021,48,MN,86,110,-24
2021,48,MO,176,199,-23
2021,48,MS,924,1018,-94
2021,48,MT,37,43,-6
2021,48,NC,1750,1983,-233
2021,48,ND,78,88,-10
2021,48,NE,73,80,-7
2021,48,NH,188,199,-11
2021,48,NJ,2958,3152,-194
2021,48,NM,95,107,-12
2021,48,NV,94,105,-11
2021,48,NY,2388,2587,-199
2021,48,OH,227,267,-40
2021,48,OK,121,137,-16
2021,48,OR,391,434,-43
2021,48,PA,581,656,-75
2021,48,PR,23,23,0
2021,48,RI,127,139,-12
2021,48,SC,2935,3334,-399
2021,48,SD,32,41,-9
2021,48,TN,405,446,-41
2021,48,TX,8119,9758,-1639
2021,48,UT,43,51,-8
2021,48,VA,1278,1431,-153
2021,48,VI,5,42,-37
2021,48,VT,41,46,-5
2021,48,WA,499,588,-89
2021,48,WI,184,205,-21
2021,48,WV,98,108,-10
2021,48,WY,23,24,-1
2021,49,AK,21,26,-5
2021,49,AL,701,766,-65
2021,49,AR,84,98,-14
2021,49,AZ,226,290,-64
2021,49,CA,3849,4385,-536
2021,49,CO,139,167,-28
2021,49,CT,340,373,-33
2021,49,DC,16,21,-5
2021,49,DE,245,274,-29
2021,49,FL,16479,18798,-2319
2021,49,GA,776,891,-115
2021,49,HI,1106,1151,-45
2021,49,IA,71,99,-28
2021,49,ID,46,54,-8
2021,49,IL,211,251,-40
2021,49,IN,109,134,-25
2021,49,KS,69,83,-14
2021,49,KY,118,171,-53
2021,49,LA,4821,5412,-591
2021,49,MA,619,677,-58
2021,49,MD,720,782,-62
2021,49,ME,107,114,-7
2021,49,MI,153,190,-37
2021,49,MN,48,60,-12
2021,49,MO,153,186,-33
2021,49,MS,600,673,-73
2021,49,MT,48,51,-3
2021,49,NC,1411,1617,-206
2021,49,ND,66,74,-8
2021,49,NE,44,52,-8
2021,49,NH,57,67,-10
2021,49,NJ,1863,2030,-167
2021,49,NM,69,77,-8
2021,49,NV,90,109,-19
2021,49,NY,2039,2265,-226
2021,49,OH,225,261,-36
2021,49,OK,119,134,-15
2021,49,OR,333,381,-48
2021,49,PA,528,594,-66
2021,49,PR,37,49,-12
2021,49,RI,101,177,-76
2021,49,SC,1818,2169,-351
2021,49,SD,13,21,-8
2021,49,TN,253,300,-47
2021,49,TX,6513,7811,-1298
2021,49,UT,34,99,-65
2021,49,VA,957,1088,-131
2021,49,VI,5,5,0
2021,49,VT,33,36,-3
2021,49,WA,429,478,-49
2021,49,WI,87,109,-22
2021,49,WV,88,103,-15
2021,49,WY,7,10,-3
2021,50,AK,16,25,-9
2021,50,AL,404,484,-80
2021,50,AR,127,150,-23
2021,50,AZ,247,335,-88
2021,50,CA,3999,4804,-805
2021,50,CO,173,227,-54
2021,50,CT,394,435,-41
2021,50,DC,25,31,-6
2021,50,DE,290,334,-44
2021,50,FL,18268,21823,-3555
2021,50,GA,884,1035,-151
2021,50,HI,957,1084,-127
2021,50,IA,114,137,-23
2021,50,ID,49,64,-15
2021,50,IL,196,254,-58
2021,50,IN,138,172,-34
2021,50,KS,65,75,-10
2021,50,KY,120,146,-26
2021,50,LA,5588,6393,-805
2021,50,MA,637,705,-68
2021,50,MD,633,727,-94
2021,50,ME,100,114,-14
2021,50,MI,183,220,-37
2021,50,MN,65,81,-16
2021,50,MO,125,155,-30
2021,50,MS,630,728,-98
2021,50,MT,27,34,-7
2021,50,NC,1672,1977,-305
2021,50,ND,74,87,-13
2021,50,NE,57,66,-9
2021,50,NH,60,77,-17
2021,50,NJ,2597,2871,-274
2021,50,NM,57,86,-29
2021,50,NV,88,113,-25
2021,50,NY,2396,2673,-277
2021,50,OH,342,387,-45
2021,50,OK,106,133,-27
2021,50,OR,333,410,-77
2021,50,PA,533,617,-84
2021,50,PR,14,21,-7
2021,50,RI,132,145,-13
2021,50,SC,2850,3355,-505
2021,50,SD,24,27,-3
2021,50,TN,278,323,-45
2021,50,TX,7294,8923,-1629
2021,50,UT,38,70,-32
2021,50,VA,1215,1385,-170
2021,50,VI,8,10,-2
2021,50,VT,34,51,-17
2021,50,WA,488,568,-80
2021,50,WI,87,108,-21
2021,50,WV,95,106,-11
2021,50,WY,17,20,-3
2021,51,AK,14,17,-3
2021,51,AL,275,393,-118
2021,51,AR,85,112,-27
2021,51,AZ,187,248,-61
2021,51,CA,2738,3677,-939
2021,51,CO,131,208,-77
2021,51,CT,192,230,-38
2021,51,DC,17,19,-2
2021,51,DE,206,230,-24
2021,51,FL,11648,15993,-4345
2021,51,GA,603,772,-169
2021,51,GU,2,2,0
2021,51,HI,1151,1258,-107
2021,51,IA,79,99,-20
2021,51,ID,47,56,-9
2021,51,IL,218,261,-43
2021,51,IN,98,129,-31
2021,51,KS,51,61,-10
2021,51,KY,142,170,-28
2021,51,LA,3588,4453,-865
2021,51,MA,503,585,-82
2021,51,MD,558,641,-83
2021,51,ME,68,85,-17
2021,51,MI,95,132,-37
2021,51,MN,56,67,-11
2021,51,MO,118,142,-24
2021,51,MS,538,641,-103
2021,51,MT,24,26,-2
2021,51,NC,1088,1328,-240
2021,51,ND,57,70,-13
2021,51,NE,23,31,-8
2021,51,NH,54,72,-18
2021,51,NJ,1452,2013,-561
2021,51,NM,53,59,-6
2021,51,NV,60,72,-12
2021,51,NY,2009,2318,-309
2021,51,OH,135,183,-48
2021,51,OK,72,88,-16
2021,51,OR,224,275,-51
2021,51,PA,402,492,-90
2021,51,PR,17,28,-11
2021,51,RI,93,104,-11
2021,51,SC,1840,2201,-361
2021,51,SD,8,10,-2
2021,51,TN,267,340,-73
2021,51,TX,4903,6592,-1689
2021,51,UT,35,48,-13
2021,51,VA,641,804,-163
2021,51,VI,1,1,0
2021,51,VT,17,25,-8
2021,51,WA,380,477,-97
2021,51,WI,73,92,-19
2021,51,WV,77,100,-23
2021,51,WY,12,20,-8
2021,52,AK,7,9,-2
2021,52,AL,307,489,-182
2021,52,AR,57,79,-22
2021,52,AZ,166,232,-66
2021,52,CA,1992,2731,-739
2021,52,CO,136,203,-67
2021,52,CT,246,295,-49
2021,52,DC,15,18,-3
2021,52,DE,168,209,-41
2021,52,FL,14412,21338,-6926
2021,52,GA,520,675,-155
2021,52,HI,446,609,-163
2021,52,IA,59,76,-17
2021,52,ID,37,45,-8
2021,52,IL,130,184,-54
2021,52,IN,80,116,-36
2021,52,KS,46,66,-20
2021,52,KY,69,116,-47
2021,52,LA,3364,4889,-1525
2021,52,MA,347,510,-163
2021,52,MD,450,927,-477
2021,52,ME,47,57,-10
2021,52,MI,92,128,-36
2021,52,MN,59,149,-90
2021,52,MO,88,136,-48
2021,52,MS,431,570,-139
2021,52,MT,19,21,-2
2021,52,NC,880,1264,-384
2021,52,ND,75,91,-16
2021,52,NE,51,67,-16
2021,52,NH,32,42,-10
2021,52,NJ,1128,1473,-345
2021,52,NM,63,74,-11
2021,52,NV,57,79,-22
2021,52,NY,1749,2356,-607
2021,52,OH,154,200,-46
2021,52,OK,64,84,-20
2021,52,OR,193,245,-52
2021,52,PA,370,470,-100
2021,52,PR,34,41,-7
2021,52,RI,62,83,-21
2021,52,SC,1606,2386,-780
2021,52,SD,17,24,-7
2021,52,TN,170,224,-54
2021,52,TX,4834,7069,-2235
2021,52,UT,47,54,-7
2021,52,VA,629,809,-180
2021,52,VI,1,2,-1
2021,52,VT,16,22,-6
2021,52,WA,290,384,-94
2021,52,WI,208,241,-33
2021,52,WV,52,73,-21
2021,52,WY,13,14,-1
2022,0,AK,1,2,-1
2022,0,AL,28,42,-14
2022,0,AR,10,16,-6
2022,0,AZ,24,33,-9
2022,0,CA,526,689,-163
2022,0,CO,16,23,-7
2022,0,CT,17,25,-8
2022,0,DE,118,122,-4
2022,0,FL,7853,11364,-3511
2022,0,GA,62,78,-16
2022,0,HI,93,99,-6
2022,0,IA,18,21,-3
2022,0,ID,2,3,-1
2022,0,IL,165,173,-8
2022,0,IN,18,20,-2
2022,0,KS,5,10,-5
2022,0,KY,16,23,-7
2022,0,LA,352,491,-139
2022,0,MA,64,83,-19
2022,0,MD,108,131,-23
2022,0,ME,11,12,-1
2022,0,MI,17,29,-12
2022,0,MN,9,15,-6
2022,0,MO,13,22,-9
2022,0,MS,65,82,-17
2022,0,MT,1,2,-1
2022,0,NC,170,235,-65
2022,0,ND,9,11,-2
2022,0,NE,12,14,-2
2022,0,NH,11,12,-1
2022,0,NJ,139,219,-80
2022,0,NM,13,19,-6
2022,0,NV,9,10,-1
2022,0,NY,185,234,-49
2022,0,OH,24,29,-5
2022,0,OK,9,12,-3
2022,0,OR,54,64,-10
2022,0,PA,88,110,-22
2022,0,PR,2,1,1
2022,0,RI,11,13,-2
2022,0,SC,396,443,-47
2022,0,SD,1,4,-3
2022,0,TN,30,39,-9
2022,0,TX,513,749,-236
2022,0,UT,2,2,0
2022,0,VA,198,225,-27
2022,0,VT,4,4,0
2022,0,WA,38,63,-25
2022,0,WI,89,93,-4
2022,0,WV,10,15,-5
2022,0,WY,1,1,0
2022,1,AK,13,21,-8
2022,1,AL,250,351,-101
2022,1,AR,63,92,-29
2022,1,AZ,167,253,-86
2022,1,CA,2792,4453,-1661
2022,1,CO,116,170,-54
2022,1,CT,289,391,-102
2022,1,DC,14,21,-7
2022,1,DE,278,371,-93
2022,1,FL,11953,15887,-3934
2022,1,GA,644,894,-250
2022,1,HI,373,472,-99
2022,1,IA,76,101,-25
2022,1,ID,41,62,-21
2022,1,IL,189,262,-73
2022,1,IN,103,152,-49
2022,1,KS,54,88,-34
2022,1,KY,104,137,-33
2022,1,LA,2957,4270,-1313
2022,1,MA,379,536,-157
2022,1,MD,489,606,-117
2022,1,ME,60,83,-23
2022,1,MI,111,157,-46
2022,1,MN,39,59,-20
2022,1,MO,95,134,-39
2022,1,MS,429,599,-170
2022,1,MT,19,30,-11
2022,1,NC,1045,1454,-409
2022,1,ND,63,108,-45
2022,1,NE,64,88,-24
2022,1,NH,40,58,-18
2022,1,NJ,1387,1696,-309
2022,1,NM,64,89,-25
2022,1,NV,71,95,-24
2022,1,NY,1391,1889,-498
2022,1,OH,137,196,-59
2022,1,OK,56,90,-34
2022,1,OR,280,368,-88
2022,1,PA,353,481,-128
2022,1,PR,13,16,-3
2022,1,RI,68,104,-36
2022,1,SC,1294,1806,-512
2022,1,SD,15,31,-16
2022,1,TN,175,254,-79
2022,1,TX,4183,6341,-2158
2022,1,UT,25,38,-13
2022,1,VA,630,872,-242
2022,1,VI,1,1,0
2022,1,VT,19,22,-3
2022,1,WA,299,413,-114
2022,1,WI,49,81,-32
2022,1,WV,66,87,-21
2022,1,WY,7,10,-3
2022,2,AK,26,36,-10
2022,2,AL,652,841,-189
2022,2,AR,68,97,-29
2022,2,AZ,162,252,-90
2022,2,CA,2371,3335,-964
2022,2,CO,153,194,-41
2022,2,CT,276,392,-116
2022,2,DC,29,36,-7
2022,2,DE,180,249,-69
2022,2,FL,14759,20494,-5735
2022,2,GA,599,855,-256
2022,2,HI,643,763,-120
2022,2,IA,68,90,-22
2022,2,ID,37,48,-11
2022,2,IL,177,248,-71
2022,2,IN,118,169,-51
2022,2,KS,61,91,-30
2022,2,KY,94,139,-45
2022,2,LA,4135,5534,-1399
2022,2,MA,418,531,-113
2022,2,MD,483,592,-109
2022,2,ME,94,115,-21
2022,2,MI,142,212,-70
2022,2,MN,38,62,-24
2022,2,MO,90,136,-46
2022,2,MS,546,765,-219
2022,2,MT,28,35,-7
2022,2,NC,1182,1591,-409
2022,2,ND,97,171,-74
2022,2,NE,41,68,-27
2022,2,NH,73,89,-16
2022,2,NJ,1671,2106,-435
2022,2,NM,56,75,-19
2022,2,NV,66,95,-29
2022,2,NY,2112,3150,-1038
2022,2,OH,264,329,-65
2022,2,OK,79,111,-32
2022,2,OR,226,312,-86
2022,2,PA,432,585,-153
2022,2,PR,8,19,-11
2022,2,RI,75,289,-214
2022,2,SC,1536,2476,-940
2022,2,SD,16,18,-2
2022,2,TN,202,284,-82
2022,2,TX,5242,7248,-2006
2022,2,UT,19,31,-12
2022,2,VA,613,839,-226
2022,2,VI,2,2,0
2022,2,VT,20,30,-10
2022,2,WA,294,498,-204
2022,2,WI,148,185,-37
2022,2,WV,64,90,-26
2022,2,WY,9,12,-3
2022,3,AK,26,32,-6
2022,3,AL,322,430,-108
2022,3,AR,63,84,-21
2022,3,AZ,171,249,-78
2022,3,CA,2381,3155,-774
2022,3,CO,99,142,-43
2022,3,CT,207,333,-126
2022,3,DC,11,17,-6
2022,3,DE,330,374,-44
2022,3,FL,13925,18163,-4238
2022,3,GA,582,792,-210
2022,3,HI,579,620,-41
2022,3,IA,53,74,-21
2022,3,ID,38,50,-12
2022,3,IL,170,239,-69
2022,3,IN,104,145,-41
2022,3,KS,51,73,-22
2022,3,KY,95,119,-24
2022,3,LA,3574,4676,-1102
2022,3,MA,428,536,-108
2022,3,MD,737,961,-224
2022,3,ME,47,66,-19
2022,3,MI,116,167,-51
2022,3,MN,43,52,-9
2022,3,MO,116,174,-58
2022,3,MS,450,591,-141
2022,3,MT,17,28,-11
2022,3,NC,1369,1738,-369
2022,3,ND,75,122,-47
2022,3,NE,22,44,-22
2022,3,NH,46,53,-7
2022,3,NJ,1313,1626,-313
2022,3,NM,43,64,-21
2022,3,NV,65,96,-31
2022,3,NY,1723,2149,-426
2022,3,OH,146,201,-55
2022,3,OK,66,92,-26
2022,3,OR,244,325,-81
2022,3,PA,338,465,-127
2022,3,PR,15,24,-9
2022,3,RI,67,85,-18
2022,3,SC,1576,2063,-487
2022,3,SD,18,23,-5
2022,3,TN,160,213,-53
2022,3,TX,4986,6654,-1668
2022,3,UT,23,28,-5
2022,3,VA,590,770,-180
2022,3,VI,2,4,-2
2022,3,VT,20,25,-5
2022,3,WA,316,496,-180
2022,3,WI,80,113,-33
2022,3,WV,58,77,-19
2022,3,WY,11,16,-5
2022,4,AK,18,24,-6
2022,4,AL,306,395,-89
2022,4,AR,78,104,-26
2022,4,AZ,173,241,-68
2022,4,CA,2011,2680,-669
2022,4,CO,140,169,-29
2022,4,CT,168,225,-57
2022,4,DC,11,27,-16
2022,4,DE,153,199,-46
2022,4,FL,13576,17947,-4371
2022,4,GA,564,765,-201
2022,4,HI,362,503,-141
2022,4,IA,58,71,-13
2022,4,ID,30,41,-11
2022,4,IL,619,674,-55
2022,4,IN,106,138,-32
2022,4,KS,45,64,-19
2022,4,KY,99,132,-33
2022,4,LA,3826,4779,-953
2022,4,MA,296,379,-83
2022,4,MD,515,574,-59
2022,4,ME,50,65,-15
2022,4,MI,94,147,-53
2022,4,MN,48,72,-24
2022,4,MO,99,133,-34
2022,4,MS,516,631,-115
2022,4,MT,24,31,-7
2022,4,NC,999,1258,-259
2022,4,ND,70,91,-21
2022,4,NE,33,43,-10
2022,4,NH,32,39,-7
2022,4,NJ,1502,1896,-394
2022,4,NM,54,78,-24
2022,4,NV,51,107,-56
2022,4,NY,1345,1664,-319
2022,4,OH,122,159,-37
2022,4,OK,73,100,-27
2022,4,OR,247,507,-260
2022,4,PA,376,488,-112
2022,4,PR,19,25,-6
2022,4,RI,49,76,-27
2022,4,SC,1488,2102,-614
2022,4,SD,13,18,-5
2022,4,TN,158,217,-59
2022,4,TX,4363,5951,-1588
2022,4,UT,22,29,-7
2022,4,VA,641,823,-182
2022,4,VI,7,7,0
2022,4,VT,30,40,-10
2022,4,WA,253,332,-79
2022,4,WI,52,70,-18
2022,4,WV,58,65,-7
2022,4,WY,8,9,-1
2022,5,AK,17,20,-3
2022,5,AL,576,911,-335
2022,5,AR,94,122,-28
2022,5,AZ,189,248,-59
2022,5,CA,2545,3214,-669
2022,5,CO,147,194,-47
2022,5,CT,190,235,-45
2022,5,DC,16,25,-9
2022,5,DE,197,230,-33
2022,5,FL,16812,21059,-4247
2022,5,GA,603,832,-229
2022,5,HI,1952,2057,-105
2022,5,IA,74,96,-22
2022,5,ID,62,77,-15
2022,5,IL,253,319,-66
2022,5,IN,107,139,-32
2022,5,KS,53,69,-16
2022,5,KY,125,156,-31
2022,5,LA,4581,5741,-1160
2022,5,MA,351,504,-153
2022,5,MD,392,503,-111
2022,5,ME,50,63,-13
2022,5,MI,143,185,-42
2022,5,MN,73,88,-15
2022,5,MO,112,151,-39
2022,5,MS,796,941,-145
2022,5,MT,35,48,-13
2022,5,NC,1186,1524,-338
2022,5,ND,87,118,-31
2022,5,NE,51,70,-19
2022,5,NH,40,51,-11
2022,5,NJ,2038,2336,-298
2022,5,NM,57,102,-45
2022,5,NV,68,89,-21
2022,5,NY,1408,1779,-371
2022,5,OH,166,215,-49
2022,5,OK,85,112,-27
2022,5,OR,251,308,-57
2022,5,PA,438,566,-128
2022,5,PR,17,20,-3
2022,5,RI,81,102,-21
2022,5,SC,1640,2165,-525
2022,5,SD,15,24,-9
2022,5,TN,189,255,-66
2022,5,TX,5120,6823,-1703
2022,5,UT,27,36,-9
2022,5,VA,701,904,-203
2022,5,VI,2,3,-1
2022,5,VT,32,39,-7
2022,5,WA,370,430,-60
2022,5,WI,69,104,-35
2022,5,WV,89,106,-17
2022,5,WY,12,17,-5
2022,6,AK,19,20,-1
2022,6,AL,417,495,-78
2022,6,AR,93,129,-36
2022,6,AZ,250,311,-61
2022,6,CA,3043,3838,-795
2022,6,CO,179,414,-235
2022,6,CT,180,218,-38
2022,6,DC,16,23,-7
2022,6,DE,184,217,-33
2022,6,FL,17045,20338,-3293
2022,6,GA,672,824,-152
2022,6,HI,408,346,62
2022,6,IA,88,104,-16
2022,6,ID,77,90,-13
2022,6,IL,265,332,-67
2022,6,IN,183,233,-50
2022,6,KS,67,80,-13
2022,6,KY,122,150,-28
2022,6,LA,4745,5585,-840
2022,6,MA,533,725,-192
2022,6,MD,364,454,-90
2022,6,ME,95,115,-20
2022,6,MI,145,200,-55
2022,6,MN,62,83,-21
2022,6,MO,135,176,-41
2022,6,MS,663,789,-126
2022,6,MT,36,49,-13
2022,6,NC,1303,1597,-294
2022,6,ND,108,149,-41
2022,6,NE,66,79,-13
2022,6,NH,77,89,-12
2022,6,NJ,1449,1701,-252
2022,6,NM,65,82,-17
2022,6,NV,100,127,-27
2022,6,NY,1651,1963,-312
2022,6,OH,213,271,-58
2022,6,OK,77,103,-26
2022,6,OR,243,311,-68
2022,6,PA,484,586,-102
2022,6,PR,15,18,-3
2022,6,RI,77,99,-22
2022,6,SC,2163,2531,-368
2022,6,SD,22,27,-5
2022,6,TN,219,267,-48
2022,6,TX,6080,7678,-1598
2022,6,UT,26,111,-85
2022,6,VA,723,894,-171
2022,6,VI,2,3,-1
2022,6,VT,26,34,-8
2022,6,WA,344,448,-104
2022,6,WI,64,84,-20
2022,6,WV,91,121,-30
2022,6,WY,13,17,-4
2022,7,AK,25,27,-2
2022,7,AL,873,958,-85
2022,7,AR,92,110,-18
2022,7,AZ,179,246,-67
2022,7,CA,2643,3134,-491
2022,7,CO,152,190,-38
2022,7,CT,215,257,-42
2022,7,DC,24,31,-7
2022,7,DE,194,220,-26
2022,7,FL,19071,21517,-2446
2022,7,GA,676,812,-136
2022,7,HI,693,718,-25
2022,7,IA,100,118,-18
2022,7,ID,73,90,-17
2022,7,IL,554,598,-44
2022,7,IN,156,195,-39
2022,7,KS,62,76,-14
2022,7,KY,132,154,-22
2022,7,LA,5036,5692,-656
2022,7,MA,518,809,-291
2022,7,MD,383,492,-109
2022,7,ME,70,87,-17
2022,7,MI,160,214,-54
2022,7,MN,70,88,-18
2022,7,MO,137,164,-27
2022,7,MS,684,767,-83
2022,7,MT,40,50,-10
2022,7,NC,1360,1618,-258
2022,7,ND,153,185,-32
2022,7,NE,72,95,-23
2022,7,NH,63,71,-8
2022,7,NJ,1670,2008,-338
2022,7,NM,68,86,-18
2022,7,NV,84,106,-22
2022,7,NY,1622,1930,-308
2022,7,OH,231,396,-165
2022,7,OK,88,119,-31
2022,7,OR,225,306,-81
2022,7,PA,862,956,-94
2022,7,PR,27,28,-1
2022,7,RI,72,88,-16
2022,7,SC,1822,2198,-376
2022,7,SD,22,29,-7
2022,7,TN,231,282,-51
2022,7,TX,6047,7393,-1346
2022,7,UT,25,49,-24
2022,7,VA,891,1037,-146
2022,7,VI,4,3,1
2022,7,VT,33,33,0
2022,7,WA,381,461,-80
2022,7,WI,83,101,-18
2022,7,WV,114,130,-16
2022,7,WY,13,19,-6
2022,8,AK,15,16,-1
2022,8,AL,438,513,-75
2022,8,AR,138,154,-16
2022,8,AZ,191,258,-67
2022,8,CA,2534,2972,-438
2022,8,CO,144,191,-47
2022,8,CT,216,256,-40
2022,8,DC,87,91,-4
2022,8,DE,215,247,-32
2022,8,FL,17585,19538,-1953
2022,8,GA,778,891,-113
2022,8,HI,1238,1262,-24
2022,8,IA,111,143,-32
2022,8,ID,74,89,-15
2022,8,IL,261,310,-49
2022,8,IN,170,196,-26
2022,8,KS,92,106,-14
2022,8,KY,143,170,-27
2022,8,LA,5960,6642,-682
2022,8,MA,390,444,-54
2022,8,MD,424,510,-86
2022,8,ME,69,72,-3
2022,8,MI,172,209,-37
2022,8,MN,105,118,-13
2022,8,MO,131,157,-26
2022,8,MS,836,924,-88
2022,8,MT,50,58,-8
2022,8,NC,1571,1774,-203
2022,8,ND,160,187,-27
2022,8,NE,73,88,-15
2022,8,NH,94,103,-9
2022,8,NJ,1747,1958,-211
2022,8,NM,76,91,-15
2022,8,NV,87,98,-11
2022,8,NY,2375,2596,-221
2022,8,OH,202,239,-37
2022,8,OK,96,111,-15
2022,8,OR,255,290,-35
2022,8,PA,599,711,-112
2022,8,PR,27,33,-6
2022,8,RI,88,99,-11
2022,8,SC,1951,2292,-341
2022,8,SD,24,28,-4
2022,8,TN,314,358,-44
2022,8,TX,7493,8810,-1317
2022,8,UT,50,62,-12
2022,8,VA,858,984,-126
2022,8,VI,8,9,-1
2022,8,VT,29,36,-7
2022,8,WA,379,424,-45
2022,8,WI,79,106,-27
2022,8,WV,100,119,-19
2022,8,WY,13,17,-4
2022,9,AK,28,31,-3
2022,9,AL,476,547,-71
2022,9,AR,117,141,-24
2022,9,AZ,235,285,-50
2022,9,CA,2497,2915,-418
2022,9,CO,224,253,-29
2022,9,CT,321,360,-39
2022,9,DC,23,35,-12
2022,9,DE,255,273,-18
2022,9,FL,25075,28722,-3647
2022,9,GA,1007,1135,-128
2022,9,HI,876,922,-46
2022,9,IA,150,189,-39
2022,9,ID,85,94,-9
2022,9,IL,339,386,-47
2022,9,IN,188,228,-40
2022,9,KS,100,108,-8
2022,9,KY,153,174,-21
2022,9,LA,6813,7487,-674
2022,9,MA,705,783,-78
2022,9,MD,726,1024,-298
2022,9,ME,93,99,-6
2022,9,MI,181,221,-40
2022,9,MN,206,235,-29
2022,9,MO,199,236,-37
2022,9,MS,853,946,-93
2022,9,MT,67,72,-5
2022,9,NC,2082,2281,-199
2022,9,ND,306,354,-48
2022,9,NE,77,83,-6
2022,9,NH,67,76,-9
2022,9,NJ,2213,2391,-178
2022,9,NM,103,116,-13
2022,9,NV,104,127,-23
2022,9,NY,2403,2640,-237
2022,9,OH,257,296,-39
2022,9,OK,114,134,-20
2022,9,OR,294,323,-29
2022,9,PA,660,739,-79
2022,9,PR,30,34,-4
2022,9,RI,224,319,-95
2022,9,SC,2621,2995,-374
2022,9,SD,29,40,-11
2022,9,TN,365,419,-54
2022,9,TX,8412,9845,-1433
2022,9,UT,54,66,-12
2022,9,VA,1113,1251,-138
2022,9,VI,6,6,0
2022,9,VT,40,42,-2
2022,9,WA,435,499,-64
2022,9,WI,166,193,-27
2022,9,WV,102,114,-12
2022,9,WY,14,19,-5
2022,10,AK,12,14,-2
2022,10,AL,410,462,-52
2022,10,AR,110,127,-17
2022,10,AZ,184,216,-32
2022,10,CA,2247,2565,-318
2022,10,CO,192,218,-26
2022,10,CT,225,244,-19
2022,10,DC,18,21,-3
2022,10,DE,212,228,-16
2022,10,FL,19214,21154,-1940
2022,10,GA,821,945,-124
2022,10,HI,503,548,-45
2022,10,IA,164,181,-17
2022,10,ID,114,119,-5
2022,10,IL,743,794,-51
2022,10,IN,177,198,-21
2022,10,KS,96,106,-10
2022,10,KY,147,175,-28
2022,10,LA,5814,6532,-718
2022,10,MA,743,787,-44
2022,10,MD,400,462,-62
2022,10,ME,76,80,-4
2022,10,MI,206,242,-36
2022,10,MN,140,162,-22
2022,10,MO,183,209,-26
2022,10,MS,793,880,-87
2022,10,MT,63,69,-6
2022,10,NC,1596,1738,-142
2022,10,ND,324,365,-41
2022,10,NE,88,107,-19
2022,10,NH,121,127,-6
2022,10,NJ,1688,1805,-117
2022,10,NM,77,87,-10
2022,10,NV,89,117,-28
2022,10,NY,2227,2759,-532
2022,10,OH,210,246,-36
2022,10,OK,99,116,-17
2022,10,OR,281,302,-21
2022,10,PA,532,585,-53
2022,10,PR,16,28,-12
2022,10,RI,102,104,-2
2022,10,SC,2133,2440,-307
2022,10,SD,36,44,-8
2022,10,TN,333,387,-54
2022,10,TX,6995,8275,-1280
2022,10,UT,44,49,-5
2022,10,VA,973,1066,-93
2022,10,VI,14,14,0
2022,10,VT,65,68,-3
2022,10,WA,365,424,-59
2022,10,WI,143,163,-20
2022,10,WV,107,116,-9
2022,10,WY,24,26,-2
2022,11,AK,27,25,2
2022,11,AL,430,485,-55
2022,11,AR,130,141,-11
2022,11,AZ,212,252,-40
2022,11,CA,2463,2869,-406
2022,11,CO,220,251,-31
2022,11,CT,246,267,-21
2022,11,DC,14,21,-7
2022,11,DE,310,332,-22
2022,11,FL,17070,19744,-2674
2022,11,GA,820,923,-103
2022,11,HI,445,455,-10
2022,11,IA,158,184,-26
2022,11,ID,77,90,-13
2022,11,IL,296,345,-49
2022,11,IN,221,247,-26
2022,11,KS,104,112,-8
2022,11,KY,195,214,-19
2022,11,LA,5810,6374,-564
2022,11,MA,533,635,-102
2022,11,MD,522,975,-453
2022,11,ME,67,74,-7
2022,11,MI,189,216,-27
2022,11,MN,188,212,-24
2022,11,MO,212,234,-22
2022,11,MP,1,1,0
2022,11,MS,856,942,-86
2022,11,MT,84,96,-12
2022,11,NC,1521,1695,-174
2022,11,ND,312,353,-41
2022,11,NE,72,86,-14
2022,11,NH,65,72,-7
2022,11,NJ,2153,2248,-95
2022,11,NM,78,87,-9
2022,11,NV,93,115,-22
2022,11,NY,1914,2089,-175
2022,11,OH,264,310,-46
2022,11,OK,110,137,-27
2022,11,OR,230,248,-18
2022,11,PA,513,585,-72
2022,11,PR,21,26,-5
2022,11,RI,75,83,-8
2022,11,SC,2864,3149,-285
2022,11,SD,45,52,-7
2022,11,TN,408,460,-52
2022,11,TX,6758,7994,-1236
2022,11,UT,48,59,-11
2022,11,VA,883,1016,-133
2022,11,VI,28,29,-1
2022,11,VT,35,41,-6
2022,11,WA,346,392,-46
2022,11,WI,140,162,-22
2022,11,WV,113,124,-11
2022,11,WY,23,28,-5
2022,12,AK,10,11,-1
2022,12,AL,617,663,-46
2022,12,AR,138,165,-27
2022,12,AZ,220,259,-39
2022,12,CA,2710,3087,-377
2022,12,CO,200,239,-39
2022,12,CT,269,305,-36
2022,12,DC,15,20,-5
2022,12,DE,290,308,-18
2022,12,FL,19627,22228,-2601
2022,12,GA,858,968,-110
2022,12,HI,1043,1062,-19
2022,12,IA,181,253,-72
2022,12,ID,146,161,-15
2022,12,IL,404,483,-79
2022,12,IN,251,286,-35
2022,12,KS,104,123,-19
2022,12,KY,195,217,-22
2022,12,LA,6353,6997,-644
2022,12,MA,561,607,-46
2022,12,MD,726,868,-142
2022,12,ME,78,82,-4
2022,12,MI,243,277,-34
2022,12,MN,198,239,-41
2022,12,MO,264,316,-52
2022,12,MS,973,1081,-108
2022,12,MT,98,116,-18
2022,12,NC,1595,1830,-235
2022,12,ND,373,428,-55
2022,12,NE,89,109,-20
2022,12,NH,95,102,-7
2022,12,NJ,1612,1697,-85
2022,12,NM,70,88,-18
2022,12,NV,90,111,-21
2022,12,NY,2030,2187,-157
2022,12,OH,287,336,-49
2022,12,OK,124,139,-15
2022,12,OR,255,297,-42
2022,12,PA,572,637,-65
2022,12,PR,29,40,-11
2022,12,RI,128,135,-7
2022,12,SC,2151,2450,-299
2022,12,SD,72,82,-10
2022,12,TN,392,448,-56
2022,12,TX,8078,9530,-1452
2022,12,UT,41,49,-8
2022,12,VA,1454,1594,-140
2022,12,VI,7,7,0
2022,12,VT,22,27,-5
2022,12,WA,313,355,-42
2022,12,WI,265,313,-48
2022,12,WV,128,143,-15
2022,12,WY,37,46,-9
2022,13,AK,23,29,-6
2022,13,AL,817,903,-86
2022,13,AR,186,229,-43
2022,13,AZ,238,365,-127
2022,13,CA,2268,2723,-455
2022,13,CO,211,266,-55
2022,13,CT,294,366,-72
2022,13,DC,17,18,-1
2022,13,DE,256,294,-38
2022,13,FL,25886,30634,-4748
2022,13,GA,1152,1340,-188
2022,13,HI,566,590,-24
2022,13,IA,189,234,-45
2022,13,ID,92,111,-19
2022,13,IL,960,1017,-57
2022,13,IN,213,256,-43
2022,13,KS,98,123,-25
2022,13,KY,208,257,-49
2022,13,LA,7729,8846,-1117
2022,13,MA,507,561,-54
2022,13,MD,611,672,-61
2022,13,ME,74,85,-11
2022,13,MI,212,265,-53
2022,13,MN,407,467,-60
2022,13,MO,341,405,-64
2022,13,MS,924,1090,-166
2022,13,MT,82,116,-34
2022,13,NC,1996,2249,-253
2022,13,ND,297,361,-64
2022,13,NE,110,128,-18
2022,13,NH,115,124,-9
2022,13,NJ,2165,2404,-239
2022,13,NM,110,123,-13
2022,13,NV,90,114,-24
2022,13,NY,2812,3069,-257
2022,13,OH,304,370,-66
2022,13,OK,125,148,-23
2022,13,OR,260,318,-58
2022,13,PA,645,763,-118
2022,13,PR,23,39,-16
2022,13,RI,104,121,-17
2022,13,SC,3855,4463,-608
2022,13,SD,65,76,-11
2022,13,TN,408,484,-76
2022,13,TX,9175,11489,-2314
2022,13,UT,44,64,-20
2022,13,VA,1140,1591,-451
2022,13,VI,4,5,-1
2022,13,VT,32,40,-8
2022,13,WA,355,447,-92
2022,13,WI,183,230,-47
2022,13,WV,149,186,-37
2022,13,WY,19,28,-9
2022,14,AK,15,16,-1
2022,14,AL,393,490,-97
2022,14,AR,91,120,-29
2022,14,AZ,163,223,-60
2022,14,CA,1749,2377,-628
2022,14,CO,197,243,-46
2022,14,CT,214,276,-62
2022,14,DC,14,24,-10
2022,14,DE,232,264,-32
2022,14,FL,14798,19870,-5072
2022,14,GA,724,922,-198
2022,14,HI,698,733,-35
2022,14,IA,197,251,-54
2022,14,ID,77,106,-29
2022,14,IL,313,395,-82
2022,14,IN,166,208,-42
2022,14,KS,78,106,-28
2022,14,KY,148,205,-57
2022,14,LA,5463,6915,-1452
2022,14,MA,357,426,-69
2022,14,MD,607,720,-113
2022,14,ME,80,107,-27
2022,14,MI,156,209,-53
2022,14,MN,404,494,-90
2022,14,MO,225,303,-78
2022,14,MS,700,909,-209
2022,14,MT,96,119,-23
2022,14,NC,1556,1853,-297
2022,14,ND,216,276,-60
2022,14,NE,66,78,-12
2022,14,NH,71,86,-15
2022,14,NJ,1720,2041,-321
2022,14,NM,69,84,-15
2022,14,NV,66,95,-29
2022,14,NY,1494,1892,-398
2022,14,OH,242,318,-76
2022,14,OK,98,136,-38
2022,14,OR,180,248,-68
2022,14,PA,410,556,-146
2022,14,PR,22,39,-17
2022,14,RI,130,157,-27
2022,14,SC,1766,2331,-565
2022,14,SD,70,101,-31
2022,14,TN,259,360,-101
2022,14,TX,6809,9393,-2584
2022,14,UT,56,63,-7
2022,14,VA,788,978,-190
2022,14,VI,2,3,-1
2022,14,VT,23,32,-9
2022,14,WA,235,308,-73
2022,14,WI,168,236,-68
2022,14,WV,93,122,-29
2022,14,WY,28,38,-10
2022,15,AK,22,27,-5
2022,15,AL,675,916,-241
2022,15,AR,91,136,-45
2022,15,AZ,150,227,-77
2022,15,CA,1556,2182,-626
2022,15,CO,179,262,-83
2022,15,CT,236,300,-64
2022,15,DC,14,20,-6
2022,15,DE,232,283,-51
2022,15,FL,17694,27549,-9855
2022,15,GA,705,961,-256
2022,15,HI,268,400,-132
2022,15,IA,216,293,-77
2022,15,ID,66,101,-35
2022,15,IL,366,502,-136
2022,15,IN,160,220,-60
2022,15,KS,114,150,-36
2022,15,KY,192,248,-56
2022,15,LA,6150,8303,-2153
2022,15,MA,378,656,-278
2022,15,MD,390,563,-173
2022,15,ME,99,127,-28
2022,15,MI,187,250,-63
2022,15,MN,267,384,-117
2022,15,MO,205,314,-109
2022,15,MS,822,1110,-288
2022,15,MT,63,88,-25
2022,15,NC,1435,1900,-465
2022,15,ND,248,335,-87
2022,15,NE,102,130,-28
2022,15,NH,65,93,-28
2022,15,NJ,1345,1875,-530
2022,15,NM,71,98,-27
2022,15,NV,64,86,-22
2022,15,NY,1458,1869,-411
2022,15,OH,214,284,-70
2022,15,OK,129,166,-37
2022,15,OR,182,251,-69
2022,15,PA,461,604,-143
2022,15,PR,27,45,-18
2022,15,RI,74,96,-22
2022,15,SC,1740,2521,-781
2022,15,SD,56,81,-25
2022,15,TN,420,514,-94
2022,15,TX,6696,9929,-3233
2022,15,UT,47,64,-17
2022,15,VA,880,1145,-265
2022,15,VI,49,54,-5
2022,15,VT,26,48,-22
2022,15,WA,263,355,-92
2022,15,WI,207,280,-73
2022,15,WV,92,139,-47
2022,15,WY,34,42,-8
2022,16,AK,14,19,-5
2022,16,AL,575,768,-193
2022,16,AR,69,130,-61
2022,16,AZ,147,253,-106
2022,16,CA,1507,2302,-795
2022,16,CO,199,309,-110
2022,16,CT,173,289,-116
2022,16,DC,12,21,-9
2022,16,DE,183,276,-93
2022,16,FL,11993,21415,-9422
2022,16,GA,631,1012,-381
2022,16,HI,598,716,-118
2022,16,IA,163,249,-86
2022,16,ID,48,83,-35
2022,16,IL,282,443,-161
2022,16,IN,145,206,-61
2022,16,KS,78,141,-63
2022,16,KY,111,196,-85
2022,16,LA,5015,8124,-3109
2022,16,MA,289,418,-129
2022,16,MD,319,491,-172
2022,16,ME,51,78,-27
2022,16,MI,110,184,-74
2022,16,MN,94,142,-48
2022,16,MO,184,324,-140
2022,16,MS,620,1101,-481
2022,16,MT,61,88,-27
2022,16,NC,1124,1737,-613
2022,16,ND,101,170,-69
2022,16,NE,67,136,-69
2022,16,NH,45,58,-13
2022,16,NJ,1250,1862,-612
2022,16,NM,62,87,-25
2022,16,NV,67,99,-32
2022,16,NY,1179,2293,-1114
2022,16,OH,217,335,-118
2022,16,OK,106,177,-71
2022,16,OR,132,216,-84
2022,16,PA,322,519,-197
2022,16,PR,10,29,-19
2022,16,RI,67,93,-26
2022,16,SC,1737,2587,-850
2022,16,SD,38,60,-22
2022,16,TN,225,336,-111
2022,16,TX,5451,10322,-4871
2022,16,UT,40,60,-20
2022,16,VA,750,1063,-313
2022,16,VI,2,7,-5
2022,16,VT,29,45,-16
2022,16,WA,196,316,-120
2022,16,WI,113,160,-47
2022,16,WV,68,108,-40
2022,16,WY,32,44,-12
2022,17,AK,27,40,-13
2022,17,AL,886,1360,-474
2022,17,AR,65,125,-60
2022,17,AZ,118,271,-153
2022,17,CA,1072,2355,-1283
2022,17,CO,213,361,-148
2022,17,CT,173,333,-160
2022,17,DC,13,21,-8
2022,17,DE,185,316,-131
2022,17,FL,13120,33217,-20097
2022,17,GA,628,1188,-560
2022,17,HI,1080,1748,-668
2022,17,IA,87,186,-99
2022,17,ID,43,66,-23
2022,17,IL,338,541,-203
2022,17,IN,127,217,-90
2022,17,KS,93,166,-73
2022,17,KY,114,213,-99
2022,17,LA,5072,10476,-5404
2022,17,MA,272,535,-263
2022,17,MD,365,691,-326
2022,17,ME,44,92,-48
2022,17,MI,112,217,-105
2022,17,MN,65,147,-82
2022,17,MO,151,313,-162
2022,17,MS,581,1110,-529
2022,17,MT,48,85,-37
2022,17,NC,1257,2112,-855
2022,17,ND,48,100,-52
2022,17,NE,62,113,-51
2022,17,NH,41,76,-35
2022,17,NJ,1305,2315,-1010
2022,17,NM,40,88,-48
2022,17,NV,44,89,-45
2022,17,NY,1123,2016,-893
2022,17,OH,174,341,-167
2022,17,OK,68,138,-70
2022,17,OR,128,541,-413
2022,17,PA,309,619,-310
2022,17,PR,6,23,-17
2022,17,RI,73,114,-41
2022,17,SC,1504,2855,-1351
2022,17,SD,26,56,-30
2022,17,TN,283,536,-253
2022,17,TX,5437,12560,-7123
2022,17,UT,28,51,-23
2022,17,VA,768,1385,-617
2022,17,VT,13,32,-19
2022,17,WA,213,377,-164
2022,17,WI,91,155,-64
2022,17,WV,62,130,-68
2022,17,WY,23,46,-23
2022,18,AK,15,34,-19
2022,18,AL,282,586,-304
2022,18,AR,52,131,-79
2022,18,AZ,104,264,-160
2022,18,CA,657,1865,-1208
2022,18,CO,125,346,-221
2022,18,CT,91,235,-144
2022,18,DC,10,21,-11
2022,18,DE,132,253,-121
2022,18,FL,7083,26543,-19460
2022,18,GA,369,1042,-673
2022,18,HI,459,880,-421
2022,18,IA,69,164,-95
2022,18,ID,43,379,-336
2022,18,IL,211,407,-196
2022,18,IN,69,185,-116
2022,18,KS,31,101,-70
2022,18,KY,64,193,-129
2022,18,LA,2891,7972,-5081
2022,18,MA,173,416,-243
2022,18,MD,172,480,-308
2022,18,ME,37,72,-35
2022,18,MI,81,167,-86
2022,18,MN,44,109,-65
2022,18,MO,62,184,-122
2022,18,MS,411,1086,-675
2022,18,MT,38,86,-48
2022,18,NC,839,1917,-1078
2022,18,ND,33,87,-54
2022,18,NE,56,117,-61
2022,18,NH,25,65,-40
2022,18,NJ,833,2001,-1168
2022,18,NM,34,96,-62
2022,18,NV,27,85,-58
2022,18,NY,929,2046,-1117
2022,18,OH,85,233,-148
2022,18,OK,55,166,-111
2022,18,OR,86,224,-138
2022,18,PA,192,529,-337
2022,18,PR,4,24,-20
2022,18,RI,36,95,-59
2022,18,SC,956,2797,-1841
2022,18,SD,22,59,-37
2022,18,TN,138,342,-204
2022,18,TX,3615,12677,-9062
2022,18,UT,25,45,-20
2022,18,VA,439,1068,-629
2022,18,VI,4,13,-9
2022,18,VT,12,40,-28
2022,18,WA,126,310,-184
2022,18,WI,55,126,-71
2022,18,WV,25,87,-62
2022,18,WY,10,29,-19
2022,19,AK,11,29,-18
2022,19,AL,145,491,-346
2022,19,AR,33,108,-75
2022,19,AZ,64,217,-153
2022,19,CA,439,1985,-1546
2022,19,CO,54,214,-160
2022,19,CT,92,270,-178
2022,19,DC,5,16,-11
2022,19,DE,90,285,-195
2022,19,FL,5427,24031,-18604
2022,19,GA,266,1035,-769
2022,19,HI,150,365,-215
2022,19,IA,39,125,-86
2022,19,ID,44,91,-47
2022,19,IL,94,310,-216
2022,19,IN,44,161,-117
2022,19,KS,37,106,-69
2022,19,KY,45,187,-142
2022,19,LA,2063,8069,-6006
2022,19,MA,239,674,-435
2022,19,MD,166,531,-365
2022,19,ME,23,53,-30
2022,19,MI,48,157,-109
2022,19,MN,32,78,-46
2022,19,MO,72,208,-136
2022,19,MS,276,1020,-744
2022,19,MT,26,75,-49
2022,19,NC,481,1704,-1223
2022,19,ND,20,58,-38
2022,19,NE,23,93,-70
2022,19,NH,18,56,-38
2022,19,NJ,442,1689,-1247
2022,19,NM,13,61,-48
2022,19,NV,28,86,-58
2022,19,NY,519,2423,-1904
2022,19,OH,68,241,-173
2022,19,OK,47,155,-108
2022,19,OR,73,220,-147
2022,19,PA,136,540,-404
2022,19,PR,3,61,-58
2022,19,RI,39,106,-67
2022,19,SC,670,2279,-1609
2022,19,SD,17,39,-22
2022,19,TN,110,343,-233
2022,19,TX,3026,12050,-9024
2022,19,UT,21,55,-34
2022,19,VA,363,1133,-770
2022,19,VI,6,17,-11
2022,19,VT,11,26,-15
2022,19,WA,77,294,-217
2022,19,WI,39,124,-85
2022,19,WV,24,101,-77
2022,19,WY,17,32,-15
2022,20,AK,9,34,-25
2022,20,AL,119,914,-795
2022,20,AR,25,115,-90
2022,20,AZ,61,271,-210
2022,20,CA,260,1818,-1558
2022,20,CO,62,310,-248
2022,20,CT,62,298,-236
2022,20,DC,8,25,-17
2022,20,DE,86,305,-219
2022,20,FL,4554,25069,-20515
2022,20,GA,238,1145,-907
2022,20,HI,60,698,-638
2022,20,IA,34,243,-209
2022,20,ID,25,97,-72
2022,20,IL,99,470,-371
2022,20,IN,50,171,-121
2022,20,KS,22,126,-104
2022,20,KY,41,216,-175
2022,20,LA,1866,9342,-7476
2022,20,MA,125,504,-379
2022,20,MD,138,528,-390
2022,20,ME,15,53,-38
2022,20,MI,48,181,-133
2022,20,MN,21,90,-69
2022,20,MO,48,206,-158
2022,20,MS,230,1240,-1010
2022,20,MT,18,63,-45
2022,20,NC,474,2133,-1659
2022,20,ND,7,56,-49
2022,20,NE,13,80,-67
2022,20,NH,14,61,-47
2022,20,NJ,496,2080,-1584
2022,20,NM,26,104,-78
2022,20,NV,17,79,-62
2022,20,NY,403,2382,-1979
2022,20,OH,55,385,-330
2022,20,OK,31,159,-128
2022,20,OR,45,224,-179
2022,20,PA,122,525,-403
2022,20,PR,4,34,-30
2022,20,RI,32,97,-65
2022,20,SC,555,3240,-2685
2022,20,SD,7,33,-26
2022,20,TN,82,342,-260
2022,20,TX,2749,15359,-12610
2022,20,UT,11,54,-43
2022,20,VA,335,1306,-971
2022,20,VT,5,34,-29
2022,20,WA,62,289,-227
2022,20,WI,33,121,-88
2022,20,WV,18,115,-97
2022,20,WY,7,19,-12
2022,21,AK,4,24,-20
2022,21,AL,84,865,-781
2022,21,AR,13,121,-108
2022,21,AZ,42,250,-208
2022,21,CA,214,1841,-1627
2022,21,CO,56,393,-337
2022,21,CT,51,316,-265
2022,21,DC,3,22,-19
2022,21,DE,52,411,-359
2022,21,FL,3156,26281,-23125
2022,21,GA,155,1200,-1045
2022,21,HI,264,911,-647
2022,21,IA,12,118,-106
2022,21,ID,7,56,-49
2022,21,IL,44,309,-265
2022,21,IN,28,175,-147
2022,21,KS,13,126,-113
2022,21,KY,25,173,-148
2022,21,LA,1047,9591,-8544
2022,21,MA,70,481,-411
2022,21,MD,107,607,-500
2022,21,ME,19,86,-67
2022,21,MI,23,171,-148
2022,21,MN,18,88,-70
2022,21,MO,21,217,-196
2022,21,MS,133,1223,-1090
2022,21,MT,6,73,-67
2022,21,NC,344,2152,-1808
2022,21,ND,12,65,-53
2022,21,NE,13,75,-62
2022,21,NH,6,53,-47
2022,21,NJ,287,2250,-1963
2022,21,NM,7,89,-82
2022,21,NV,9,176,-167
2022,21,NY,320,2554,-2234
2022,21,OH,27,243,-216
2022,21,OK,14,120,-106
2022,21,OR,23,214,-191
2022,21,PA,92,721,-629
2022,21,PR,1,32,-31
2022,21,RI,16,136,-120
2022,21,SC,372,3477,-3105
2022,21,SD,9,42,-33
2022,21,TN,57,384,-327
2022,21,TX,1845,15824,-13979
2022,21,UT,12,54,-42
2022,21,VA,183,1216,-1033
2022,21,WA,25,284,-259
2022,21,WI,29,146,-117
2022,21,WV,2,103,-101
2022,21,WY,3,25,-22
2022,22,AL,38,772,-734
2022,22,AR,9,219,-210
2022,22,AZ,14,275,-261
2022,22,CA,86,2008,-1922
2022,22,CO,11,326,-315
2022,22,CT,24,313,-289
2022,22,DC,3,24,-21
2022,22,DE,24,400,-376
2022,22,FL,1268,34837,-33569
2022,22,GA,75,1652,-1577
2022,22,HI,9,569,-560
2022,22,IA,9,151,-142
2022,22,ID,4,48,-44
2022,22,IL,15,406,-391
2022,22,IN,9,195,-186
2022,22,KS,10,149,-139
2022,22,KY,10,236,-226
2022,22,LA,519,11515,-10996
2022,22,MA,45,621,-576
2022,22,MD,74,706,-632
2022,22,ME,7,64,-57
2022,22,MI,16,187,-171
2022,22,MN,7,98,-91
2022,22,MO,15,219,-204
2022,22,MS,87,1321,-1234
2022,22,MT,3,74,-71
2022,22,NC,188,2389,-2201
2022,22,ND,6,84,-78
2022,22,NE,2,107,-105
2022,22,NH,8,83,-75
2022,22,NJ,123,2701,-2578
2022,22,NM,1,79,-78
2022,22,NV,4,86,-82
2022,22,NY,350,2178,-1828
2022,22,OH,16,278,-262
2022,22,OK,4,172,-168
2022,22,OR,12,329,-317
2022,22,PA,42,591,-549
2022,22,PR,2,35,-33
2022,22,RI,7,128,-121
2022,22,SC,181,3344,-3163
2022,22,SD,3,53,-50
2022,22,TN,32,466,-434
2022,22,TX,831,19476,-18645
2022,22,UT,2,44,-42
2022,22,VA,80,1607,-1527
2022,22,VT,1,25,-24
2022,22,WA,14,333,-319
2022,22,WI,8,119,-111
2022,22,WV,6,103,-97
2022,22,WY,2,32,-30
2022,23,AL,10,927,-917
2022,23,AR,9,162,-153
2022,23,AZ,3,268,-265
2022,23,CA,12,1897,-1885
2022,23,CO,2,288,-286
2022,23,CT,10,267,-257
2022,23,DC,1,260,-259
2022,23,DE,11,327,-316
2022,23,FL,277,25534,-25257
2022,23,GA,20,1204,-1184
2022,23,HI,1,541,-540
2022,23,ID,1,60,-59
2022,23,IL,12,415,-403
2022,23,IN,4,192,-188
2022,23,KS,3,109,-106
2022,23,KY,3,234,-231
2022,23,LA,92,10205,-10113
2022,23,MA,16,600,-584
2022,23,MD,19,745,-726
2022,23,ME,1,51,-50
2022,23,MI,9,152,-143
2022,23,MO,5,202,-197
2022,23,MS,19,1233,-1214
2022,23,MT,1,55,-54
2022,23,NC,51,2136,-2085
2022,23,NE,1,76,-75
2022,23,NH,3,67,-64
2022,23,NJ,42,1925,-1883
2022,23,NV,1,76,-75
2022,23,NY,46,1878,-1832
2022,23,OH,6,244,-238
2022,23,OK,1,166,-165
2022,23,OR,2,282,-280
2022,23,PA,8,527,-519
2022,23,RI,5,107,-102
2022,23,SC,61,2981,-2920
2022,23,SD,1,35,-34
2022,23,TN,9,514,-505
2022,23,TX,218,20574,-20356
2022,23,VA,29,1270,-1241
2022,23,VI,1,16,-15
2022,23,WA,4,382,-378
2022,23,WI,2,103,-101
2022,23,WV,6,96,-90
2022,24,AL,2,710,-708
2022,24,AR,1,152,-151
2022,24,CA,3,2017,-2014
2022,24,CT,5,321,-316
2022,24,DE,2,315,-313
2022,24,FL,38,30497,-30459
2022,24,GA,6,1315,-1309
2022,24,HI,1,871,-870
2022,24,IA,1,147,-146
2022,24,IL,1,452,-451
2022,24,IN,1,176,-175
2022,24,KY,1,217,-216
2022,24,LA,22,12881,-12859
2022,24,MA,1,510,-509
2022,24,MD,4,680,-676
2022,24,MS,5,1386,-1381
2022,24,NC,9,2228,-2219
2022,24,NJ,9,2039,-2030
2022,24,NY,9,2430,-2421
2022,24,OH,1,330,-329
2022,24,OR,2,219,-217
2022,24,PA,2,544,-542
2022,24,SC,10,3542,-3532
2022,24,TN,3,461,-458
2022,24,TX,55,23533,-23478
2022,24,VA,2,1667,-1665
2022,24,VT,1,27,-26
2022,25,FL,9,30248,-30239
2022,25,LA,7,13145,-13138
2022,25,MA,1,441,-440
2022,25,MS,2,1302,-1300
2022,25,NC,1,2832,-2831
2022,25,ND,1,97,-96
2022,25,NJ,1,2397,-2396
2022,25,PA,1,515,-514
2022,25,SC,2,3634,-3632
2022,25,TX,8,25027,-25019
2022,25,VA,2,1695,-1693
2022,26,FL,8,41240,-41232
2022,26,HI,1,1770,-1769
2022,26,LA,4,16420,-16416
2022,26,NC,2,3304,-3302
2022,26,PA,1,679,-678
2022,26,SC,1,4767,-4766
2022,26,TX,8,33938,-33930
2022,26,VA,2,2333,-2331
2022,27,FL,5,30715,-30710
2022,27,LA,3,13114,-13111
2022,27,TX,5,28642,-28637
2022,28,CO,1,252,-251
2022,28,FL,2,30384,-30382
2022,28,TX,1,25649,-25648
2022,29,FL,2,26701,-26699
2022,30,NC,1,2758,-2757
2022,31,FL,1,25046,-25045
2022,31,GA,1,1464,-1463
2022,31,TX,2,16920,-16918
2022,32,TX,1,18725,-18724
2022,33,FL,2,26147,-26145
2022,33,MD,1,783,-782
2022,33,VA,1,1774,-1773
2022,34,LA,1,10272,-10271
2022,34,TX,1,16204,-16203
2022,35,MS,1,1047,-1046
2022,35,NC,1,3007,-3006
2022,35,NM,1,136,-135
2022,35,TX,1,16134,-16133
2022,36,NC,1,2313,-2312
2022,37,FL,1,23203,-23202
2022,38,HI,1,810,-809
2022,38,VA,3,1841,-1838
2022,39,FL,1,39793,-39792
2022,39,LA,1,14528,-14527
2022,39,TX,1,21589,-21588
2022,40,LA,1,7708,-7707
2022,42,FL,1,22181,-22180
2022,45,GA,1,921,-920
2022,45,NM,1,76,-75
2022,45,SC,1,2250,-2249
2022,46,FL,1,18146,-18145
2022,47,LA,1,5071,-5070
2022,51,FL,1,12880,-12879
2023,4,MS,1,433,-432
2023,12,NC,1,1423,-1422