year,month,propertyState,num_policies_bought,num_policies_term,num_policies_net
2009,1,AK,102,2,100
2009,1,AL,1886,23,1863
2009,1,AR,539,13,526
2009,1,AZ,1065,15,1050
2009,1,CA,19296,178,19118
2009,1,CO,858,10,848
2009,1,CT,1663,50,1613
2009,1,DC,49,1,48
2009,1,DE,1434,12,1422
2009,1,FL,113178,1498,111680
2009,1,GA,3631,54,3577
2009,1,GU,6,0,6
2009,1,HI,3849,102,3747
2009,1,IA,403,4,399
2009,1,ID,251,2,249
2009,1,IL,1716,18,1698
2009,1,IN,787,13,774
2009,1,KS,320,5,315
2009,1,KY,848,9,839
2009,1,LA,20856,358,20498
2009,1,MA,1877,17,1860
2009,1,MD,3125,125,3000
2009,1,ME,361,3,358
2009,1,MI,670,23,647
2009,1,MN,304,5,299
2009,1,MO,749,19,730
2009,1,MS,3536,36,3500
2009,1,MT,128,1,127
2009,1,NC,6415,64,6351
2009,1,ND,133,1,132
2009,1,NE,295,4,291
2009,1,NH,298,4,294
2009,1,NJ,9278,146,9132
2009,1,NM,333,7,326
2009,1,NV,647,6,641
2009,1,NY,8436,144,8292
2009,1,OH,1282,23,1259
2009,1,OK,432,7,425
2009,1,OR,1895,24,1871
2009,1,PA,3137,27,3110
2009,1,PR,996,0,996
2009,1,RI,682,9,673
2009,1,SC,8690,184,8506
2009,1,SD,145,0,145
2009,1,TN,952,14,938
2009,1,TX,25423,291,25132
2009,1,UT,184,11,173
2009,1,VA,4027,66,3961
2009,1,VI,56,0,56
2009,1,VT,126,2,124
2009,1,WA,2590,51,2539
2009,1,WI,408,8,400
2009,1,WV,701,2,699
2009,1,WY,72,0,72
2009,2,AK,84,2,82
2009,2,AL,3076,148,2928
2009,2,AR,606,21,585
2009,2,AZ,1113,28,1085
2009,2,CA,15750,298,15452
2009,2,CO,625,26,599
2009,2,CT,1174,40,1134
2009,2,DC,56,2,54
2009,2,DE,906,38,868
2009,2,FL,102381,4192,98189
2009,2,GA,3909,171,3738
2009,2,GU,3,0,3
2009,2,HI,4982,356,4626
2009,2,IA,641,27,614
2009,2,ID,449,11,438
2009,2,IL,1994,58,1936
2009,2,IN,1011,30,981
2009,2,KS,365,10,355
2009,2,KY,852,22,830
2009,2,LA,24287,792,23495
2009,2,MA,1753,37,1716
2009,2,MD,2420,53,2367
2009,2,ME,393,14,379
2009,2,MI,864,29,835
2009,2,MN,493,12,481
2009,2,MO,819,24,795
2009,2,MS,4166,90,4076
2009,2,MT,204,2,202
2009,2,NC,6220,235,5985
2009,2,ND,798,12,786
2009,2,NE,297,17,280
2009,2,NH,320,5,315
2009,2,NJ,8429,340,8089
2009,2,NM,411,11,400
2009,2,NV,899,17,882
2009,2,NY,5999,165,5834
2009,2,OH,1586,45,1541
2009,2,OK,495,17,478
2009,2,OR,1711,54,1657
2009,2,PA,4456,109,4347
2009,2,PR,538,1,537
2009,2,RI,707,18,689
2009,2,SC,8098,221,7877
2009,2,SD,160,4,156
2009,2,TN,1132,33,1099
2009,2,TX,26291,659,25632
2009,2,UN,1,0,1
2009,2,UT,344,10,334
2009,2,VA,4149,183,3966
2009,2,VI,83,0,83
2009,2,VT,133,4,129
2009,2,WA,2364,82,2282
2009,2,WI,459,10,449
2009,2,WV,1021,30,991
2009,2,WY,89,2,87
2009,3,AK,111,6,105
2009,3,AL,2730,347,2383
2009,3,AR,636,36,600
2009,3,AZ,1213,99,1114
2009,3,CA,11955,568,11387
2009,3,CO,1035,39,996
2009,3,CT,1387,67,1320
2009,3,DC,60,4,56
2009,3,DE,1180,91,1089
2009,3,FL,129554,8938,120616
2009,3,GA,4701,285,4416
2009,3,GU,7,1,6
2009,3,HI,2688,642,2046
2009,3,IA,911,49,862
2009,3,ID,677,17,660
2009,3,IL,2330,117,2213
2009,3,IN,1262,65,1197
2009,3,KS,544,39,505
2009,3,KY,973,46,927
2009,3,LA,31330,1467,29863
2009,3,MA,2295,243,2052
2009,3,MD,3342,131,3211
2009,3,ME,502,16,486
2009,3,MI,913,41,872
2009,3,MN,1430,35,1395
2009,3,MO,1097,50,1047
2009,3,MS,5564,129,5435
2009,3,MT,250,7,243
2009,3,NC,7924,359,7565
2009,3,ND,3952,44,3908
2009,3,NE,378,23,355
2009,3,NH,418,12,406
2009,3,NJ,9505,665,8840
2009,3,NM,554,36,518
2009,3,NV,946,46,900
2009,3,NY,7079,448,6631
2009,3,OH,1735,69,1666
2009,3,OK,676,30,646
2009,3,OR,1573,93,1480
2009,3,PA,4254,130,4124
2009,3,PR,925,6,919
2009,3,RI,695,186,509
2009,3,SC,11562,594,10968
2009,3,SD,268,12,256
2009,3,TN,2251,61,2190
2009,3,TX,32576,1164,31412
2009,3,UT,363,28,335
2009,3,VA,5700,306,5394
2009,3,VI,448,1,447
2009,3,VT,202,12,190
2009,3,WA,2550,147,2403
2009,3,WI,800,79,721
2009,3,WV,1067,37,1030
2009,3,WY,127,1,126
2009,4,AK,144,9,135
2009,4,AL,3718,145,3573
2009,4,AR,750,46,704
2009,4,AZ,1182,86,1096
2009,4,CA,10523,516,10007
2009,4,CO,1259,44,1215
2009,4,CT,1498,104,1394
2009,4,DC,47,3,44
2009,4,DE,1202,97,1105
2009,4,FL,156089,9277,146812
2009,4,GA,5193,348,4845
2009,4,GU,8,0,8
2009,4,HI,3991,360,3631
2009,4,IA,914,61,853
2009,4,ID,451,25,426
2009,4,IL,2608,122,2486
2009,4,IN,1239,86,1153
2009,4,KS,727,32,695
2009,4,KY,999,91,908
2009,4,LA,38298,1899,36399
2009,4,MA,2104,88,2016
2009,4,MD,3289,431,2858
2009,4,ME,707,22,685
2009,4,MI,782,53,729
2009,4,MN,1785,50,1735
2009,4,MO,1425,70,1355
2009,4,MS,6608,243,6365
2009,4,MT,261,10,251
2009,4,NC,8491,467,8024
2009,4,ND,5003,113,4890
2009,4,NE,375,28,347
2009,4,NH,492,21,471
2009,4,NJ,10174,747,9427
2009,4,NM,465,36,429
2009,4,NV,614,33,581
2009,4,NY,7677,348,7329
2009,4,OH,1731,103,1628
2009,4,OK,825,45,780
2009,4,OR,1280,88,1192
2009,4,PA,3578,197,3381
2009,4,PR,2156,24,2132
2009,4,RI,683,90,593
2009,4,SC,12343,628,11715
2009,4,SD,251,13,238
2009,4,TN,1435,82,1353
2009,4,TX,40391,1708,38683
2009,4,UN,1,0,1
2009,4,UT,397,94,303
2009,4,VA,5528,379,5149
2009,4,VI,104,60,44
2009,4,VT,161,6,155
2009,4,WA,2035,153,1882
2009,4,WI,1091,43,1048
2009,4,WV,1028,47,981
2009,4,WY,225,9,216
2009,5,AK,138,8,130
2009,5,AL,3919,401,3518
2009,5,AR,747,41,706
2009,5,AZ,1086,107,979
2009,5,CA,9976,644,9332
2009,5,CO,1314,79,1235
2009,5,CT,1504,86,1418
2009,5,DC,52,4,48
2009,5,DE,1375,123,1252
2009,5,FL,159964,11482,148482
2009,5,GA,5999,472,5527
2009,5,GU,6,0,6
2009,5,HI,4863,1290,3573
2009,5,IA,709,49,660
2009,5,ID,528,31,497
2009,5,IL,2224,177,2047
2009,5,IN,1050,93,957
2009,5,KS,712,61,651
2009,5,KY,1007,75,932
2009,5,LA,42585,2389,40196
2009,5,MA,2090,286,1804
2009,5,MD,3210,235,2975
2009,5,ME,448,23,425
2009,5,MI,717,58,659
2009,5,MN,488,40,448
2009,5,MO,1208,101,1107
2009,5,MS,7414,288,7126
2009,5,MT,313,17,296
2009,5,NC,9530,752,8778
2009,5,ND,315,80,235
2009,5,NE,351,37,314
2009,5,NH,369,40,329
2009,5,NJ,11249,1115,10134
2009,5,NM,476,32,444
2009,5,NV,599,36,563
2009,5,NY,8389,459,7930
2009,5,OH,1483,97,1386
2009,5,OK,823,34,789
2009,5,OR,1498,115,1383
2009,5,PA,3473,186,3287
2009,5,PR,1291,12,1279
2009,5,RI,619,42,577
2009,5,SC,13650,844,12806
2009,5,SD,264,13,251
2009,5,TN,1254,110,1144
2009,5,TX,53484,2255,51229
2009,5,UN,4,0,4
2009,5,UT,395,20,375
2009,5,VA,6569,537,6032
2009,5,VI,48,4,44
2009,5,VT,133,15,118
2009,5,WA,1907,200,1707
2009,5,WI,656,50,606
2009,5,WV,884,63,821
2009,5,WY,187,19,168
2009,6,AK,123,11,112
2009,6,AL,4150,341,3809
2009,6,AR,655,86,569
2009,6,AZ,1298,102,1196
2009,6,CA,9801,678,9123
2009,6,CO,1168,76,1092
2009,6,CT,1701,137,1564
2009,6,DC,323,4,319
2009,6,DE,1384,108,1276
2009,6,FL,186913,15156,171757
2009,6,GA,7316,512,6804
2009,6,GU,3,1,2
2009,6,HI,3555,520,3035
2009,6,IA,589,61,528
2009,6,ID,288,34,254
2009,6,IL,1856,159,1697
2009,6,IN,928,91,837
2009,6,KS,740,61,679
2009,6,KY,924,121,803
2009,6,LA,52126,3812,48314
2009,6,MA,2420,202,2218
2009,6,MD,3643,287,3356
2009,6,ME,474,42,432
2009,6,MI,659,71,588
2009,6,MN,439,40,399
2009,6,MO,1137,69,1068
2009,6,MS,8148,432,7716
2009,6,MT,304,16,288
2009,6,NC,11390,785,10605
2009,6,ND,247,76,171
2009,6,NE,346,40,306
2009,6,NH,352,23,329
2009,6,NJ,13026,1404,11622
2009,6,NM,511,52,459
2009,6,NV,539,43,496
2009,6,NY,10568,472,10096
2009,6,OH,1362,122,1240
2009,6,OK,873,66,807
2009,6,OR,1184,112,1072
2009,6,PA,3322,272,3050
2009,6,PR,1186,26,1160
2009,6,RI,887,61,826
2009,6,SC,16319,1292,15027
2009,6,SD,196,19,177
2009,6,TN,1180,95,1085
2009,6,TX,79025,2971,76054
2009,6,UN,1,0,1
2009,6,UT,234,21,213
2009,6,VA,8870,718,8152
2009,6,VI,152,2,150
2009,6,VT,130,9,121
2009,6,WA,1606,221,1385
2009,6,WI,541,54,487
2009,6,WV,854,73,781
2009,6,WY,131,13,118
2009,7,AK,128,15,113
2009,7,AL,4852,535,4317
2009,7,AR,677,73,604
2009,7,AZ,1456,133,1323
2009,7,CA,9958,770,9188
2009,7,CO,1096,111,985
2009,7,CT,2097,180,1917
2009,7,DC,92,9,83
2009,7,DE,1696,192,1504
2009,7,FL,196816,17747,179069
2009,7,GA,8944,731,8213
2009,7,GU,1,0,1
2009,7,HI,4212,1467,2745
2009,7,IA,888,91,797
2009,7,ID,232,32,200
2009,7,IL,2115,190,1925
2009,7,IN,1622,108,1514
2009,7,KS,802,61,741
2009,7,KY,1066,114,952
2009,7,LA,55113,4195,50918
2009,7,MA,3016,347,2669
2009,7,MD,4938,735,4203
2009,7,ME,519,53,466
2009,7,MI,760,65,695
2009,7,MN,492,53,439
2009,7,MO,1276,115,1161
2009,7,MS,6553,438,6115
2009,7,MT,166,13,153
2009,7,NC,13002,1154,11848
2009,7,ND,233,88,145
2009,7,NE,423,53,370
2009,7,NH,525,31,494
2009,7,NJ,12613,1469,11144
2009,7,NM,652,77,575
2009,7,NV,635,50,585
2009,7,NY,11317,669,10648
2009,7,OH,1721,147,1574
2009,7,OK,886,69,817
2009,7,OR,1350,126,1224
2009,7,PA,3847,378,3469
2009,7,PR,1973,14,1959
2009,7,RI,1110,62,1048
2009,7,SC,18389,1712,16677
2009,7,SD,200,20,180
2009,7,TN,1269,112,1157
2009,7,TX,113153,4974,108179
2009,7,UN,2,0,2
2009,7,UT,238,17,221
2009,7,VA,11469,1051,10418
2009,7,VI,88,5,83
2009,7,VT,157,12,145
2009,7,WA,1764,234,1530
2009,7,WI,843,63,780
2009,7,WV,1137,95,1042
2009,7,WY,160,14,146
2009,8,AK,150,25,125
2009,8,AL,3736,312,3424
2009,8,AR,711,88,623
2009,8,AZ,1793,182,1611
2009,8,CA,9281,868,8413
2009,8,CO,959,108,851
2009,8,CT,2177,200,1977
2009,8,DC,392,7,385
2009,8,DE,1634,167,1467
2009,8,FL,167864,16763,151101
2009,8,GA,8810,856,7954
2009,8,GU,6,1,5
2009,8,HI,7248,2056,5192
2009,8,IA,818,91,727
2009,8,ID,221,33,188
2009,8,IL,2065,242,1823
2009,8,IN,1355,151,1204
2009,8,KS,658,72,586
2009,8,KY,930,135,795
2009,8,LA,44406,4017,40389
2009,8,MA,3421,270,3151
2009,8,MD,3981,378,3603
2009,8,ME,534,51,483
2009,8,MI,689,81,608
2009,8,MN,426,44,382
2009,8,MO,1055,127,928
2009,8,MS,5704,446,5258
2009,8,MT,138,16,122
2009,8,NC,12822,1124,11698
2009,8,ND,238,73,165
2009,8,NE,379,42,337
2009,8,NH,347,38,309
2009,8,NJ,13764,2103,11661
2009,8,NM,712,87,625
2009,8,NV,750,78,672
2009,8,NY,12748,1452,11296
2009,8,OH,1737,131,1606
2009,8,OK,891,83,808
2009,8,OR,1421,142,1279
2009,8,PA,4412,333,4079
2009,8,PR,11183,22,11161
2009,8,RI,1368,109,1259
2009,8,SC,16849,1736,15113
2009,8,SD,473,29,444
2009,8,TN,1281,153,1128
2009,8,TX,81811,5222,76589
2009,8,UT,165,22,143
2009,8,VA,11310,1114,10196
2009,8,VI,158,35,123
2009,8,VT,138,8,130
2009,8,WA,2120,276,1844
2009,8,WI,751,91,660
2009,8,WV,996,66,930
2009,8,WY,116,13,103
2009,9,AK,150,28,122
2009,9,AL,3638,410,3228
2009,9,AR,650,75,575
2009,9,AZ,1574,184,1390
2009,9,CA,10474,1223,9251
2009,9,CO,1073,126,947
2009,9,CT,2138,175,1963
2009,9,DC,102,8,94
2009,9,DE,1723,187,1536
2009,9,FL,153996,20946,133050
2009,9,GA,7613,974,6639
2009,9,GU,9,1,8
2009,9,HI,5779,2453,3326
2009,9,IA,816,101,715
2009,9,ID,228,48,180
2009,9,IL,1642,179,1463
2009,9,IN,1248,146,1102
2009,9,KS,617,65,552
2009,9,KY,999,134,865
2009,9,LA,36391,4296,32095
2009,9,MA,3284,372,2912
2009,9,MD,3772,628,3144
2009,9,ME,530,58,472
2009,9,MI,856,101,755
2009,9,MN,437,58,379
2009,9,MO,1013,131,882
2009,9,MS,5137,447,4690
2009,9,MT,146,16,130
2009,9,NC,11062,1142,9920
2009,9,ND,203,61,142
2009,9,NE,334,56,278
2009,9,NH,591,39,552
2009,9,NJ,13879,2092,11787
2009,9,NM,735,91,644
2009,9,NV,679,69,610
2009,9,NY,14793,1359,13434
2009,9,OH,1846,166,1680
2009,9,OK,795,68,727
2009,9,OR,1768,182,1586
2009,9,PA,4009,416,3593
2009,9,PR,1356,81,1275
2009,9,RI,1251,140,1111
2009,9,SC,14683,1650,13033
2009,9,SD,312,37,275
2009,9,TN,1459,151,1308
2009,9,TX,61132,4863,56269
2009,9,UN,4,4,0
2009,9,UT,380,150,230
2009,9,VA,9383,998,8385
2009,9,VI,77,5,72
2009,9,VT,139,15,124
2009,9,WA,3183,298,2885
2009,9,WI,595,54,541
2009,9,WV,1073,106,967
2009,9,WY,99,10,89
2009,10,AK,130,20,110
2009,10,AL,3368,310,3058
2009,10,AR,728,110,618
2009,10,AZ,2014,301,1713
2009,10,CA,16927,1473,15454
2009,10,CO,815,116,699
2009,10,CT,2072,177,1895
2009,10,DC,94,5,89
2009,10,DE,1809,163,1646
2009,10,FL,147380,21346,126034
2009,10,GA,9049,987,8062
2009,10,GU,6,2,4
2009,10,HI,3879,1945,1934
2009,10,IA,647,107,540
2009,10,ID,294,33,261
2009,10,IL,1969,228,1741
2009,10,IN,1282,135,1147
2009,10,KS,566,83,483
2009,10,KY,1004,142,862
2009,10,LA,30884,4649,26235
2009,10,MA,3474,546,2928
2009,10,MD,4109,414,3695
2009,10,ME,663,73,590
2009,10,MI,799,98,701
2009,10,MN,473,74,399
2009,10,MO,1057,173,884
2009,10,MS,4880,956,3924
2009,10,MT,133,16,117
2009,10,NC,9906,1323,8583
2009,10,ND,224,103,121
2009,10,NE,330,50,280
2009,10,NH,347,38,309
2009,10,NJ,12709,2055,10654
2009,10,NM,615,101,514
2009,10,NV,1007,68,939
2009,10,NY,12804,947,11857
2009,10,OH,1781,188,1593
2009,10,OK,983,99,884
2009,10,OR,1842,189,1653
2009,10,PA,4139,520,3619
2009,10,PR,1658,27,1631
2009,10,RI,955,88,867
2009,10,SC,13977,2117,11860
2009,10,SD,198,36,162
2009,10,TN,1457,174,1283
2009,10,TX,52495,4907,47588
2009,10,UN,1,0,1
2009,10,UT,218,21,197
2009,10,VA,9566,1136,8430
2009,10,VI,62,4,58
2009,10,VT,146,16,130
2009,10,WA,9074,498,8576
2009,10,WI,812,104,708
2009,10,WV,989,94,895
2009,10,WY,113,15,98
2009,11,AK,111,27,84
2009,11,AL,2635,308,2327
2009,11,AR,724,102,622
2009,11,AZ,1313,214,1099
2009,11,CA,21886,1896,19990
2009,11,CO,774,106,668
2009,11,CT,2083,329,1754
2009,11,DC,75,4,71
2009,11,DE,1283,189,1094
2009,11,FL,112166,18866,93300
2009,11,GA,6965,1278,5687
2009,11,GU,2,0,2
2009,11,HI,4505,1460,3045
2009,11,IA,446,78,368
2009,11,ID,271,60,211
2009,11,IL,1675,240,1435
2009,11,IN,1155,158,997
2009,11,KS,474,71,403
2009,11,KY,939,151,788
2009,11,LA,25081,4112,20969
2009,11,MA,2672,423,2249
2009,11,MD,3511,656,2855
2009,11,ME,519,64,455
2009,11,MI,689,170,519
2009,11,MN,376,67,309
2009,11,MO,1034,162,872
2009,11,MS,4267,444,3823
2009,11,MT,133,25,108
2009,11,NC,7789,1411,6378
2009,11,ND,211,74,137
2009,11,NE,268,48,220
2009,11,NH,489,48,441
2009,11,NJ,12782,3214,9568
2009,11,NM,579,207,372
2009,11,NV,701,78,623
2009,11,NY,9704,1075,8629
2009,11,OH,1748,187,1561
2009,11,OK,747,95,652
2009,11,OR,2141,261,1880
2009,11,PA,3667,642,3025
2009,11,PR,1753,98,1655
2009,11,RI,771,101,670
2009,11,SC,10048,1466,8582
2009,11,SD,160,41,119
2009,11,TN,1162,144,1018
2009,11,TX,36591,3866,32725
2009,11,UT,210,32,178
2009,11,VA,6763,1359,5404
2009,11,VI,51,3,48
2009,11,VT,164,20,144
2009,11,WA,8713,561,8152
2009,11,WI,510,87,423
2009,11,WV,912,107,805
2009,11,WY,90,16,74
2009,12,AK,122,30,92
2009,12,AL,3908,622,3286
2009,12,AR,573,159,414
2009,12,AZ,1121,210,911
2009,12,CA,22336,2955,19381
2009,12,CO,796,147,649
2009,12,CT,1842,209,1633
2009,12,DC,79,25,54
2009,12,DE,1205,271,934
2009,12,FL,115007,24005,91002
2009,12,GA,4967,1043,3924
2009,12,GU,4,0,4
2009,12,HI,3263,743,2520
2009,12,IA,395,100,295
2009,12,ID,246,43,203
2009,12,IL,1486,278,1208
2009,12,IN,926,180,746
2009,12,KS,380,95,285
2009,12,KY,909,204,705
2009,12,LA,24284,6315,17969
2009,12,MA,2365,411,1954
2009,12,MD,3285,624,2661
2009,12,ME,444,57,387
2009,12,MI,849,157,692
2009,12,MN,303,65,238
2009,12,MO,831,156,675
2009,12,MS,3891,613,3278
2009,12,MT,119,22,97
2009,12,NC,6579,1353,5226
2009,12,ND,214,72,142
2009,12,NE,381,69,312
2009,12,NH,394,108,286
2009,12,NJ,11009,3188,7821
2009,12,NM,436,134,302
2009,12,NV,607,91,516
2009,12,NY,8310,1353,6957
2009,12,OH,1535,243,1292
2009,12,OK,533,111,422
2009,12,OR,1982,250,1732
2009,12,PA,3138,499,2639
2009,12,PR,859,38,821
2009,12,RI,724,200,524
2009,12,SC,10250,2470,7780
2009,12,SD,204,49,155
2009,12,TN,1204,276,928
2009,12,TX,28151,4123,24028
2009,12,UN,1,0,1
2009,12,UT,172,25,147
2009,12,VA,5761,1546,4215
2009,12,VI,146,41,105
2009,12,VT,123,24,99
2009,12,WA,4329,649,3680
2009,12,WI,411,85,326
2009,12,WV,766,122,644
2009,12,WY,86,14,72
2010,1,AK,120,111,9
2010,1,AL,1847,1741,106
2010,1,AR,575,521,54
2010,1,AZ,1039,1059,-20
2010,1,CA,18875,19356,-481
2010,1,CO,808,844,-36
2010,1,CT,1695,1694,1
2010,1,DC,55,49,6
2010,1,DE,1595,1517,78
2010,1,FL,112239,112041,198
2010,1,GA,4224,3769,455
2010,1,GU,5,6,-1
2010,1,HI,3406,3397,9
2010,1,IA,386,384,2
2010,1,ID,243,254,-11
2010,1,IL,1806,1722,84
2010,1,IN,821,768,53
2010,1,KS,351,338,13
2010,1,KY,713,895,-182
2010,1,LA,23024,23303,-279
2010,1,MA,1989,1881,108
2010,1,MD,3049,2797,252
2010,1,ME,400,373,27
2010,1,MI,730,641,89
2010,1,MN,313,298,15
2010,1,MO,831,744,87
2010,1,MS,3779,3780,-1
2010,1,MT,132,133,-1
2010,1,NC,6634,6610,24
2010,1,ND,162,146,16
2010,1,NE,279,285,-6
2010,1,NH,299,293,6
2010,1,NJ,9401,9478,-77
2010,1,NM,346,344,2
2010,1,NV,646,628,18
2010,1,NY,7777,8684,-907
2010,1,OH,1300,1295,5
2010,1,OK,453,441,12
2010,1,OR,1870,1913,-43
2010,1,PA,3052,3108,-56
2010,1,PR,931,988,-57
2010,1,RI,710,680,30
2010,1,SC,8628,8525,103
2010,1,SD,206,178,28
2010,1,TN,1001,950,51
2010,1,TX,24281,24535,-254
2010,1,UT,173,185,-12
2010,1,VA,4832,4378,454
2010,1,VI,55,54,1
2010,1,VT,127,128,-1
2010,1,WA,2963,2636,327
2010,1,WI,486,403,83
2010,1,WV,735,741,-6
2010,1,WY,67,78,-11
2010,2,AK,96,91,5
2010,2,AL,3105,3073,32
2010,2,AR,661,587,74
2010,2,AZ,1118,1061,57
2010,2,CA,16992,16340,652
2010,2,CO,619,612,7
2010,2,CT,1374,1374,0
2010,2,DC,45,52,-7
2010,2,DE,883,867,16
2010,2,FL,101977,102578,-601
2010,2,GA,4246,3904,342
2010,2,GU,2,3,-1
2010,2,HI,4723,4769,-46
2010,2,IA,680,604,76
2010,2,ID,406,420,-14
2010,2,IL,2042,1984,58
2010,2,IN,1034,1018,16
2010,2,KS,418,385,33
2010,2,KY,891,881,10
2010,2,LA,23748,23553,195
2010,2,MA,1999,1931,68
2010,2,MD,2659,2547,112
2010,2,ME,383,384,-1
2010,2,MI,792,842,-50
2010,2,MN,557,505,52
2010,2,MO,826,816,10
2010,2,MS,4236,4256,-20
2010,2,MT,242,196,46
2010,2,NC,6596,6553,43
2010,2,ND,724,790,-66
2010,2,NE,486,305,181
2010,2,NH,311,314,-3
2010,2,NJ,8932,8850,82
2010,2,NM,431,426,5
2010,2,NV,867,901,-34
2010,2,NY,6691,6303,388
2010,2,OH,1572,1616,-44
2010,2,OK,540,512,28
2010,2,OR,1638,1674,-36
2010,2,PA,4314,4408,-94
2010,2,PR,452,470,-18
2010,2,RI,669,684,-15
2010,2,SC,8309,8203,106
2010,2,SD,266,157,109
2010,2,TN,1151,1148,3
2010,2,TX,25818,26130,-312
2010,2,UN,1,1,0
2010,2,UT,281,293,-12
2010,2,VA,4429,4151,278
2010,2,VI,76,82,-6
2010,2,VT,129,137,-8
2010,2,WA,2402,2434,-32
2010,2,WI,442,457,-15
2010,2,WV,1034,1010,24
2010,2,WY,89,88,1
2010,3,AK,119,112,7
2010,3,AL,2712,2735,-23
2010,3,AR,689,643,46
2010,3,AZ,1226,1212,14
2010,3,CA,12364,12108,256
2010,3,CO,994,1040,-46
2010,3,CT,1382,1382,0
2010,3,DC,64,56,8
2010,3,DE,1100,1107,-7
2010,3,FL,128679,133157,-4478
2010,3,GA,5038,4723,315
2010,3,GU,3,4,-1
2010,3,HI,3286,3277,9
2010,3,IA,1761,905,856
2010,3,ID,598,661,-63
2010,3,IL,2341,2342,-1
2010,3,IN,1298,1233,65
2010,3,KS,544,513,31
2010,3,KY,1030,990,40
2010,3,LA,31317,30604,713
2010,3,MA,2276,2242,34
2010,3,MD,3518,3389,129
2010,3,ME,508,506,2
2010,3,MI,810,879,-69
2010,3,MN,3075,1521,1554
2010,3,MO,1189,1128,61
2010,3,MS,5602,5609,-7
2010,3,MT,408,256,152
2010,3,NC,7917,7878,39
2010,3,ND,5725,3970,1755
2010,3,NE,481,367,114
2010,3,NH,427,416,11
2010,3,NJ,10078,9984,94
2010,3,NM,478,493,-15
2010,3,NV,843,912,-69
2010,3,NY,7603,7324,279
2010,3,OH,1739,1746,-7
2010,3,OK,735,679,56
2010,3,OR,1514,1760,-246
2010,3,PA,4466,4273,193
2010,3,PR,774,1200,-426
2010,3,RI,524,561,-37
2010,3,SC,11429,11544,-115
2010,3,SD,1138,343,795
2010,3,TN,2129,2279,-150
2010,3,TX,32762,33605,-843
2010,3,UT,320,362,-42
2010,3,VA,5780,5617,163
2010,3,VI,384,389,-5
2010,3,VT,193,204,-11
2010,3,WA,2586,2631,-45
2010,3,WI,872,753,119
2010,3,WV,1178,1092,86
2010,3,WY,122,123,-1
2010,4,AK,157,146,11
2010,4,AL,4695,4667,28
2010,4,AR,780,752,28
2010,4,AZ,1103,1120,-17
2010,4,CA,10413,10681,-268
2010,4,CO,1191,1266,-75
2010,4,CT,1559,1521,38
2010,4,DC,68,53,15
2010,4,DE,1168,1142,26
2010,4,FL,153921,157087,-3166
2010,4,GA,5450,5297,153
2010,4,GU,6,8,-2
2010,4,HI,4785,4708,77
2010,4,IA,1670,940,730
2010,4,ID,415,440,-25
2010,4,IL,2807,2573,234
2010,4,IN,1249,1239,10
2010,4,KS,797,733,64
2010,4,KY,1045,1001,44
2010,4,LA,38585,38222,363
2010,4,MA,2354,2141,213
2010,4,MD,3385,3257,128
2010,4,ME,659,710,-51
2010,4,MI,766,795,-29
2010,4,MN,1485,1761,-276
2010,4,MO,1799,1459,340
2010,4,MS,6449,6560,-111
2010,4,MT,412,263,149
2010,4,NC,8460,8513,-53
2010,4,ND,2764,4789,-2025
2010,4,NE,450,380,70
2010,4,NH,535,513,22
2010,4,NJ,10456,10211,245
2010,4,NM,474,463,11
2010,4,NV,618,626,-8
2010,4,NY,9035,8170,865
2010,4,OH,1752,1714,38
2010,4,OK,846,836,10
2010,4,OR,1275,1252,23
2010,4,PA,3766,3660,106
2010,4,PR,1491,2094,-603
2010,4,RI,882,857,25
2010,4,SC,12328,12593,-265
2010,4,SD,719,311,408
2010,4,TN,1451,1436,15
2010,4,TX,39418,40703,-1285
2010,4,UN,1,1,0
2010,4,UT,338,374,-36
2010,4,VA,5487,5478,9
2010,4,VI,105,107,-2
2010,4,VT,172,158,14
2010,4,WA,2116,2082,34
2010,4,WI,1060,1080,-20
2010,4,WV,1050,1029,21
2010,4,WY,230,231,-1
2010,5,AK,130,137,-7
2010,5,AL,3892,3828,64
2010,5,AR,826,785,41
2010,5,AZ,1118,1145,-27
2010,5,CA,10311,10292,19
2010,5,CO,1300,1317,-17
2010,5,CT,1921,1889,32
2010,5,DC,70,72,-2
2010,5,DE,1364,1351,13
2010,5,FL,164901,165135,-234
2010,5,GA,6095,5959,136
2010,5,GU,6,6,0
2010,5,HI,3610,3595,15
2010,5,IA,715,709,6
2010,5,ID,464,520,-56
2010,5,IL,2202,2219,-17
2010,5,IN,1079,1102,-23
2010,5,KS,690,708,-18
2010,5,KY,1034,1041,-7
2010,5,LA,42253,42738,-485
2010,5,MA,2221,2026,195
2010,5,MD,2970,2910,60
2010,5,ME,449,449,0
2010,5,MI,716,759,-43
2010,5,MN,464,508,-44
2010,5,MO,1212,1220,-8
2010,5,MS,7152,7405,-253
2010,5,MT,355,313,42
2010,5,NC,9679,9700,-21
2010,5,ND,293,320,-27
2010,5,NE,433,355,78
2010,5,NH,393,377,16
2010,5,NJ,11578,11549,29
2010,5,NM,487,497,-10
2010,5,NV,562,598,-36
2010,5,NY,8640,8384,256
2010,5,OH,1537,1519,18
2010,5,OK,843,853,-10
2010,5,OR,1256,1250,6
2010,5,PA,3498,3495,3
2010,5,PR,1124,1303,-179
2010,5,RI,768,645,123
2010,5,SC,13871,13832,39
2010,5,SD,269,269,0
2010,5,TN,1627,1567,60
2010,5,TX,52244,54120,-1876
2010,5,UN,5,4,1
2010,5,UT,366,387,-21
2010,5,VA,6751,6757,-6
2010,5,VI,42,45,-3
2010,5,VT,132,130,2
2010,5,WA,1924,1974,-50
2010,5,WI,686,650,36
2010,5,WV,873,867,6
2010,5,WY,179,178,1
2010,6,AK,128,133,-5
2010,6,AL,4287,4145,142
2010,6,AR,780,652,128
2010,6,AZ,1311,1327,-16
2010,6,CA,9193,9640,-447
2010,6,CO,1120,1158,-38
2010,6,CT,1726,1741,-15
2010,6,DC,330,328,2
2010,6,DE,1442,1392,50
2010,6,FL,182966,184788,-1822
2010,6,GA,7680,7375,305
2010,6,GU,4,3,1
2010,6,HI,3666,3648,18
2010,6,IA,606,601,5
2010,6,ID,352,350,2
2010,6,IL,2030,1877,153
2010,6,IN,1049,946,103
2010,6,KS,786,716,70
2010,6,KY,1228,1020,208
2010,6,LA,50789,50706,83
2010,6,MA,2595,2502,93
2010,6,MD,3921,3793,128
2010,6,ME,455,451,4
2010,6,MI,687,677,10
2010,6,MN,429,453,-24
2010,6,MO,1218,1193,25
2010,6,MS,7963,8018,-55
2010,6,MT,481,303,178
2010,6,NC,11500,11313,187
2010,6,ND,277,323,-46
2010,6,NE,366,338,28
2010,6,NH,381,370,11
2010,6,NJ,12351,12371,-20
2010,6,NM,510,515,-5
2010,6,NV,534,587,-53
2010,6,NY,10769,10922,-153
2010,6,OH,1455,1420,35
2010,6,OK,871,850,21
2010,6,OR,1162,1184,-22
2010,6,PA,3045,3248,-203
2010,6,PR,667,1180,-513
2010,6,RI,908,888,20
2010,6,SC,16019,16140,-121
2010,6,SD,203,203,0
2010,6,TN,3818,1334,2484
2010,6,TX,78905,79931,-1026
2010,6,UN,1,1,0
2010,6,UT,256,243,13
2010,6,VA,9173,8931,242
2010,6,VI,159,166,-7
2010,6,VT,121,126,-5
2010,6,WA,1662,1639,23
2010,6,WI,556,535,21
2010,6,WV,887,884,3
2010,6,WY,128,126,2
2010,7,AK,134,127,7
2010,7,AL,4706,4684,22
2010,7,AR,727,670,57
2010,7,AZ,1385,1485,-100
2010,7,CA,9340,10091,-751
2010,7,CO,1078,1072,6
2010,7,CT,2057,2093,-36
2010,7,DC,87,89,-2
2010,7,DE,1622,1638,-16
2010,7,FL,189539,192595,-3056
2010,7,GA,9009,8862,147
2010,7,GU,1,1,0
2010,7,HI,2850,2856,-6
2010,7,IA,903,892,11
2010,7,ID,244,249,-5
2010,7,IL,2166,2164,2
2010,7,IN,1584,1612,-28
2010,7,KS,839,791,48
2010,7,KY,1201,1141,60
2010,7,LA,54435,53982,453
2010,7,MA,2952,2873,79
2010,7,MD,4954,4973,-19
2010,7,ME,490,501,-11
2010,7,MI,821,778,43
2010,7,MN,455,496,-41
2010,7,MO,1244,1286,-42
2010,7,MS,6461,6556,-95
2010,7,MT,434,167,267
2010,7,NC,13252,13119,133
2010,7,ND,246,264,-18
2010,7,NE,472,417,55
2010,7,NH,503,522,-19
2010,7,NJ,12789,12816,-27
2010,7,NM,624,648,-24
2010,7,NV,588,649,-61
2010,7,NY,11280,11670,-390
2010,7,OH,1704,1756,-52
2010,7,OK,1028,875,153
2010,7,OR,1384,1344,40
2010,7,PA,3553,3710,-157
2010,7,PR,1695,1763,-68
2010,7,RI,1105,1107,-2
2010,7,SC,18053,17782,271
2010,7,SD,210,214,-4
2010,7,TN,2146,1398,748
2010,7,TX,110108,110700,-592
2010,7,UN,2,2,0
2010,7,UT,252,254,-2
2010,7,VA,11299,11412,-113
2010,7,VI,84,90,-6
2010,7,VT,149,161,-12
2010,7,WA,1882,1950,-68
2010,7,WI,869,855,14
2010,7,WV,1073,1114,-41
2010,7,WY,146,156,-10
2010,8,AK,145,144,1
2010,8,AL,3916,3857,59
2010,8,AR,800,715,85
2010,8,AZ,2301,1762,539
2010,8,CA,9300,9491,-191
2010,8,CO,1033,950,83
2010,8,CT,2457,2286,171
2010,8,DC,405,400,5
2010,8,DE,1644,1590,54
2010,8,FL,165026,167288,-2262
2010,8,GA,9038,8748,290
2010,8,GU,7,6,1
2010,8,HI,7013,7049,-36
2010,8,IA,877,841,36
2010,8,ID,227,219,8
2010,8,IL,2173,2019,154
2010,8,IN,1368,1329,39
2010,8,KS,690,657,33
2010,8,KY,1089,963,126
2010,8,LA,45459,44770,689
2010,8,MA,3469,3407,62
2010,8,MD,4062,3964,98
2010,8,ME,548,536,12
2010,8,MI,744,707,37
2010,8,MN,442,444,-2
2010,8,MO,1263,1079,184
2010,8,MS,6345,6201,144
2010,8,MT,275,160,115
2010,8,NC,13566,13286,280
2010,8,ND,254,259,-5
2010,8,NE,436,400,36
2010,8,NH,370,372,-2
2010,8,NJ,13772,13696,76
2010,8,NM,700,705,-5
2010,8,NV,713,740,-27
2010,8,NY,12157,12386,-229
2010,8,OH,1774,1777,-3
2010,8,OK,1200,905,295
2010,8,OR,1625,1449,176
2010,8,PA,4401,4472,-71
2010,8,PR,11267,11182,85
2010,8,RI,1415,1370,45
2010,8,SC,17065,16869,196
2010,8,SD,480,489,-9
2010,8,TN,2211,1400,811
2010,8,TX,82691,80568,2123
2010,8,UT,178,169,9
2010,8,VA,11299,11241,58
2010,8,VI,115,131,-16
2010,8,VT,141,142,-1
2010,8,WA,2064,2118,-54
2010,8,WI,862,753,109
2010,8,WV,1018,1016,2
2010,8,WY,146,114,32
2010,9,AK,157,156,1
2010,9,AL,3666,3577,89
2010,9,AR,726,671,55
2010,9,AZ,1666,1563,103
2010,9,CA,10264,10486,-222
2010,9,CO,1079,1059,20
2010,9,CT,2349,2112,237
2010,9,DC,390,100,290
2010,9,DE,1740,1724,16
2010,9,FL,148825,152258,-3433
2010,9,GA,7710,7538,172
2010,9,GU,9,9,0
2010,9,HI,5181,5192,-11
2010,9,IA,897,818,79
2010,9,ID,240,234,6
2010,9,IL,1949,1693,256
2010,9,IN,1278,1289,-11
2010,9,KS,584,610,-26
2010,9,KY,1221,1029,192
2010,9,LA,36144,36128,16
2010,9,MA,3443,3320,123
2010,9,MD,4054,3866,188
2010,9,ME,542,524,18
2010,9,MI,788,878,-90
2010,9,MN,451,434,17
2010,9,MO,1010,1023,-13
2010,9,MS,4883,5118,-235
2010,9,MT,241,218,23
2010,9,NC,11430,11197,233
2010,9,ND,212,223,-11
2010,9,NE,362,335,27
2010,9,NH,617,604,13
2010,9,NJ,14226,14244,-18
2010,9,NM,733,727,6
2010,9,NV,648,663,-15
2010,9,NY,14294,14561,-267
2010,9,OH,1864,1887,-23
2010,9,OK,944,818,126
2010,9,OR,2384,1740,644
2010,9,PA,3932,3984,-52
2010,9,PR,1147,1362,-215
2010,9,RI,1352,1226,126
2010,9,SC,15888,15578,310
2010,9,SD,341,331,10
2010,9,TN,2335,1505,830
2010,9,TX,59415,60481,-1066
2010,9,UT,258,251,7
2010,9,VA,10035,9392,643
2010,9,VI,80,75,5
2010,9,VT,132,136,-4
2010,9,WA,2721,3165,-444
2010,9,WI,861,634,227
2010,9,WV,1044,1060,-16
2010,9,WY,112,104,8
2010,10,AK,131,124,7
2010,10,AL,3212,3266,-54
2010,10,AR,747,718,29
2010,10,AZ,1928,2003,-75
2010,10,CA,15976,16882,-906
2010,10,CO,789,817,-28
2010,10,CT,2163,2059,104
2010,10,DC,132,111,21
2010,10,DE,1816,1857,-41
2010,10,FL,141570,146809,-5239
2010,10,GA,8228,8995,-767
2010,10,GU,4,6,-2
2010,10,HI,3791,3367,424
2010,10,IA,637,628,9
2010,10,ID,289,304,-15
2010,10,IL,1941,2013,-72
2010,10,IN,1266,1303,-37
2010,10,KS,557,559,-2
2010,10,KY,1052,1013,39
2010,10,LA,29883,30562,-679
2010,10,MA,3568,3386,182
2010,10,MD,4211,4188,23
2010,10,ME,704,663,41
2010,10,MI,777,832,-55
2010,10,MN,547,474,73
2010,10,MO,1050,1038,12
2010,10,MS,4122,4351,-229
2010,10,MT,198,187,11
2010,10,NC,9763,9849,-86
2010,10,ND,213,205,8
2010,10,NE,345,334,11
2010,10,NH,366,355,11
2010,10,NJ,12777,13086,-309
2010,10,NM,589,622,-33
2010,10,NV,616,1006,-390
2010,10,NY,13299,13417,-118
2010,10,OH,1857,1882,-25
2010,10,OK,1035,988,47
2010,10,OR,2020,1866,154
2010,10,PA,4020,4122,-102
2010,10,PR,1600,1654,-54
2010,10,RI,1008,973,35
2010,10,SC,14157,14292,-135
2010,10,SD,225,223,2
2010,10,TN,2083,1642,441
2010,10,TX,50416,52014,-1598
2010,10,UT,251,236,15
2010,10,VA,9616,9616,0
2010,10,VI,121,124,-3
2010,10,VT,152,149,3
2010,10,WA,5824,8810,-2986
2010,10,WI,710,815,-105
2010,10,WV,970,997,-27
2010,10,WY,108,114,-6
2010,11,AK,101,103,-2
2010,11,AL,2660,2749,-89
2010,11,AR,650,667,-17
2010,11,AZ,1215,1283,-68
2010,11,CA,19602,21748,-2146
2010,11,CO,768,793,-25
2010,11,CT,2046,2033,13
2010,11,DC,80,76,4
2010,11,DE,1223,1230,-7
2010,11,FL,110478,114458,-3980
2010,11,GA,6030,6592,-562
2010,11,GU,1,2,-1
2010,11,HI,4952,4429,523
2010,11,IA,463,463,0
2010,11,ID,238,261,-23
2010,11,IL,1703,1671,32
2010,11,IN,1155,1174,-19
2010,11,KS,471,475,-4
2010,11,KY,891,893,-2
2010,11,LA,23827,24727,-900
2010,11,MA,2657,2662,-5
2010,11,MD,3346,3362,-16
2010,11,ME,535,523,12
2010,11,MI,604,626,-22
2010,11,MN,403,380,23
2010,11,MO,1023,1016,7
2010,11,MS,4100,4291,-191
2010,11,MT,157,166,-9
2010,11,NC,7690,7768,-78
2010,11,ND,217,219,-2
2010,11,NE,287,274,13
2010,11,NH,485,486,-1
2010,11,NJ,11558,11747,-189
2010,11,NM,448,435,13
2010,11,NV,634,716,-82
2010,11,NY,9386,9612,-226
2010,11,OH,1771,1856,-85
2010,11,OK,771,748,23
2010,11,OR,2386,2168,218
2010,11,PA,3339,3453,-114
2010,11,PR,1571,1827,-256
2010,11,RI,786,812,-26
2010,11,SC,10109,10182,-73
2010,11,SD,177,171,6
2010,11,TN,1494,1246,248
2010,11,TX,35745,37361,-1616
2010,11,UN,1,0,1
2010,11,UT,192,195,-3
2010,11,VA,6346,6365,-19
2010,11,VI,61,54,7
2010,11,VT,158,159,-1
2010,11,WA,5760,8559,-2799
2010,11,WI,560,536,24
2010,11,WV,911,957,-46
2010,11,WY,86,87,-1
2010,12,AK,106,108,-2
2010,12,AL,4168,4171,-3
2010,12,AR,593,592,1
2010,12,AZ,1218,1259,-41
2010,12,CA,19312,21929,-2617
2010,12,CO,765,762,3
2010,12,CT,2053,2073,-20
2010,12,DC,85,65,20
2010,12,DE,1182,1196,-14
2010,12,FL,114903,118700,-3797
2010,12,GA,4703,4850,-147
2010,12,GU,6,4,2
2010,12,HI,4204,4210,-6
2010,12,IA,421,386,35
2010,12,ID,350,353,-3
2010,12,IL,1532,1526,6
2010,12,IN,947,937,10
2010,12,KS,365,369,-4
2010,12,KY,886,868,18
2010,12,LA,22307,22698,-391
2010,12,MA,2411,2330,81
2010,12,MD,3773,3742,31
2010,12,ME,475,455,20
2010,12,MI,821,830,-9
2010,12,MN,362,330,32
2010,12,MO,820,806,14
2010,12,MS,3960,4123,-163
2010,12,MT,166,156,10
2010,12,NC,6530,6608,-78
2010,12,ND,236,239,-3
2010,12,NE,403,399,4
2010,12,NH,346,355,-9
2010,12,NJ,10470,10565,-95
2010,12,NM,507,416,91
2010,12,NV,494,548,-54
2010,12,NY,8049,8273,-224
2010,12,OH,1488,1482,6
2010,12,OK,555,545,10
2010,12,OR,2190,2053,137
2010,12,PA,3011,3086,-75
2010,12,PR,878,851,27
2010,12,RI,658,656,2
2010,12,SC,9460,9540,-80
2010,12,SD,247,217,30
2010,12,TN,1481,1306,175
2010,12,TX,28437,29501,-1064
2010,12,UN,1,1,0
2010,12,UT,173,172,1
2010,12,VA,5672,5732,-60
2010,12,VI,202,199,3
2010,12,VT,116,120,-4
2010,12,WA,3922,4169,-247
2010,12,WI,448,441,7
2010,12,WV,707,746,-39
2010,12,WY,94,98,-4
2011,1,AK,121,122,-1
2011,1,AL,1853,1833,20
2011,1,AR,478,544,-66
2011,1,AZ,1065,1026,39
2011,1,CA,17579,18784,-1205
2011,1,CO,802,818,-16
2011,1,CT,1644,1605,39
2011,1,DC,77,66,11
2011,1,DE,1432,1464,-32
2011,1,FL,114161,116321,-2160
2011,1,GA,3982,4006,-24
2011,1,GU,4,5,-1
2011,1,HI,2863,3255,-392
2011,1,IA,405,386,19
2011,1,ID,254,237,17
2011,1,IL,1756,1811,-55
2011,1,IN,777,785,-8
2011,1,KS,397,341,56
2011,1,KY,688,665,23
2011,1,LA,20697,20847,-150
2011,1,MA,1993,1994,-1
2011,1,MD,2961,2995,-34
2011,1,ME,390,380,10
2011,1,MI,581,715,-134
2011,1,MN,367,323,44
2011,1,MO,762,832,-70
2011,1,MS,3549,3733,-184
2011,1,MT,156,139,17
2011,1,NC,6414,6488,-74
2011,1,ND,204,180,24
2011,1,NE,357,277,80
2011,1,NH,337,351,-14
2011,1,NJ,8767,8797,-30
2011,1,NM,509,331,178
2011,1,NV,615,656,-41
2011,1,NY,7269,7417,-148
2011,1,OH,1393,1380,13
2011,1,OK,484,442,42
2011,1,OR,1998,1846,152
2011,1,PA,2979,3054,-75
2011,1,PR,914,1545,-631
2011,1,RI,738,722,16
2011,1,SC,8867,8764,103
2011,1,SD,196,185,11
2011,1,TN,1211,1099,112
2011,1,TX,23473,24166,-693
2011,1,UT,148,173,-25
2011,1,VA,4607,4686,-79
2011,1,VI,80,80,0
2011,1,VT,137,129,8
2011,1,WA,2624,2701,-77
2011,1,WI,533,485,48
2011,1,WV,698,710,-12
2011,1,WY,60,60,0
2011,2,AK,81,93,-12
2011,2,AL,2831,2796,35
2011,2,AR,688,657,31
2011,2,AZ,1126,1100,26
2011,2,CA,16688,16259,429
2011,2,CO,707,671,36
2011,2,CT,1342,1263,79
2011,2,DC,75,50,25
2011,2,DE,902,911,-9
2011,2,FL,102512,104519,-2007
2011,2,GA,4240,4238,2
2011,2,GU,3,2,1
2011,2,HI,5273,5293,-20
2011,2,IA,637,652,-15
2011,2,ID,412,415,-3
2011,2,IL,2047,2043,4
2011,2,IN,980,982,-2
2011,2,KS,417,399,18
2011,2,KY,899,852,47
2011,2,LA,24037,24234,-197
2011,2,MA,1903,1819,84
2011,2,MD,2740,2754,-14
2011,2,ME,387,381,6
2011,2,MI,801,783,18
2011,2,MN,1180,565,615
2011,2,MO,840,808,32
2011,2,MS,4274,4384,-110
2011,2,MT,328,256,72
2011,2,NC,6328,6332,-4
2011,2,ND,1772,815,957
2011,2,NE,467,464,3
2011,2,NH,353,342,11
2011,2,NJ,9066,8616,450
2011,2,NM,470,429,41
2011,2,NV,798,857,-59
2011,2,NY,6998,6560,438
2011,2,OH,1597,1548,49
2011,2,OK,558,527,31
2011,2,OR,1717,1664,53
2011,2,PA,4212,4328,-116
2011,2,PR,404,432,-28
2011,2,RI,714,682,32
2011,2,SC,7946,8096,-150
2011,2,SD,316,284,32
2011,2,TN,1250,1111,139
2011,2,TX,25587,26123,-536
2011,2,UN,1,1,0
2011,2,UT,302,279,23
2011,2,VA,4417,4399,18
2011,2,VI,80,78,2
2011,2,VT,129,129,0
2011,2,WA,2545,2496,49
2011,2,WI,500,443,57
2011,2,WV,1022,1065,-43
2011,2,WY,92,90,2
2011,3,AK,131,126,5
2011,3,AL,2673,2654,19
2011,3,AR,732,682,50
2011,3,AZ,1179,1181,-2
2011,3,CA,13043,12325,718
2011,3,CO,1008,993,15
2011,3,CT,2901,1443,1458
2011,3,DC,87,64,23
2011,3,DE,1065,1077,-12
2011,3,FL,132088,133739,-1651
2011,3,GA,5204,5051,153
2011,3,GU,3,3,0
2011,3,HI,2601,2218,383
2011,3,IA,1555,1704,-149
2011,3,ID,589,599,-10
2011,3,IL,2628,2380,248
2011,3,IN,1332,1255,77
2011,3,KS,556,552,4
2011,3,KY,1069,1007,62
2011,3,LA,30337,30976,-639
2011,3,MA,2506,2207,299
2011,3,MD,3559,3598,-39
2011,3,ME,533,515,18
2011,3,MI,834,815,19
2011,3,MN,7189,3022,4167
2011,3,MO,1268,1153,115
2011,3,MS,5428,5554,-126
2011,3,MT,721,426,295
2011,3,NC,7982,8001,-19
2011,3,ND,8366,5663,2703
2011,3,NE,465,468,-3
2011,3,NH,452,426,26
2011,3,NJ,9427,9433,-6
2011,3,NM,598,457,141
2011,3,NV,801,851,-50
2011,3,NY,7971,7263,708
2011,3,OH,2005,1783,222
2011,3,OK,753,721,32
2011,3,OR,1643,1544,99
2011,3,PA,4391,4512,-121
2011,3,PR,772,713,59
2011,3,RI,629,527,102
2011,3,SC,10914,10865,49
2011,3,SD,1202,1108,94
2011,3,TN,2347,2176,171
2011,3,TX,32217,32863,-646
2011,3,UN,2,0,2
2011,3,UT,314,302,12
2011,3,VA,6357,6248,109
2011,3,VI,388,384,4
2011,3,VT,205,198,7
2011,3,WA,2483,2538,-55
2011,3,WI,1026,890,136
2011,3,WV,1068,1129,-61
2011,3,WY,126,119,7
2011,4,AK,178,163,15
2011,4,AL,4294,4376,-82
2011,4,AR,837,750,87
2011,4,AZ,1082,1071,11
2011,4,CA,12443,10807,1636
2011,4,CO,1234,1193,41
2011,4,CT,1771,1560,211
2011,4,DC,83,75,8
2011,4,DE,1126,1139,-13
2011,4,FL,151722,153860,-2138
2011,4,GA,5419,5268,151
2011,4,GU,7,8,-1
2011,4,HI,3878,3776,102
2011,4,IA,1851,1685,166
2011,4,ID,454,418,36
2011,4,IL,3459,2932,527
2011,4,IN,1475,1253,222
2011,4,KS,800,798,2
2011,4,KY,1151,1063,88
2011,4,LA,37952,38130,-178
2011,4,MA,2352,2354,-2
2011,4,MD,3291,3281,10
2011,4,ME,693,681,12
2011,4,MI,769,748,21
2011,4,MN,3894,1536,2358
2011,4,MO,1917,1777,140
2011,4,MS,6362,6461,-99
2011,4,MT,1008,428,580
2011,4,NC,8499,8473,26
2011,4,ND,2919,2794,125
2011,4,NE,562,434,128
2011,4,NH,542,547,-5
2011,4,NJ,10242,10188,54
2011,4,NM,578,479,99
2011,4,NV,609,613,-4
2011,4,NY,8671,8593,78
2011,4,OH,2067,1752,315
2011,4,OK,902,839,63
2011,4,OR,1795,1276,519
2011,4,PA,3755,3746,9
2011,4,PR,1189,1217,-28
2011,4,RI,976,948,28
2011,4,SC,11854,12047,-193
2011,4,SD,779,696,83
2011,4,TN,2179,1521,658
2011,4,TX,38527,39159,-632
2011,4,UT,428,372,56
2011,4,VA,5828,5637,191
2011,4,VI,121,112,9
2011,4,VT,195,172,23
2011,4,WA,2177,2103,74
2011,4,WI,1529,1086,443
2011,4,WV,1023,1026,-3
2011,4,WY,294,225,69
2011,5,AK,139,120,19
2011,5,AL,3979,4037,-58
2011,5,AR,1068,814,254
2011,5,AZ,1121,1062,59
2011,5,CA,10518,10255,263
2011,5,CO,1494,1352,142
2011,5,CT,1656,1621,35
2011,5,DC,63,56,7
2011,5,DE,1212,1332,-120
2011,5,FL,156510,161289,-4779
2011,5,GA,6094,5973,121
2011,5,GU,5,6,-1
2011,5,HI,3794,4007,-213
2011,5,IA,787,718,69
2011,5,ID,698,455,243
2011,5,IL,2232,2198,34
2011,5,IN,1172,1050,122
2011,5,KS,647,676,-29
2011,5,KY,1077,997,80
2011,5,LA,45478,41942,3536
2011,5,MA,2132,2064,68
2011,5,MD,2917,2901,16
2011,5,ME,429,440,-11
2011,5,MI,709,673,36
2011,5,MN,509,521,-12
2011,5,MO,1393,1183,210
2011,5,MS,7675,7214,461
2011,5,MT,1100,380,720
2011,5,NC,9691,9556,135
2011,5,ND,400,333,67
2011,5,NE,528,436,92
2011,5,NH,359,377,-18
2011,5,NJ,11021,11006,15
2011,5,NM,605,523,82
2011,5,NV,568,569,-1
2011,5,NY,8852,8596,256
2011,5,OH,1702,1514,188
2011,5,OK,874,827,47
2011,5,OR,1393,1260,133
2011,5,PA,3441,3443,-2
2011,5,PR,1102,1387,-285
2011,5,RI,818,840,-22
2011,5,SC,13807,13648,159
2011,5,SD,364,288,76
2011,5,TN,2060,1468,592
2011,5,TX,51890,52237,-347
2011,5,UN,3,5,-2
2011,5,UT,682,400,282
2011,5,VA,6759,6662,97
2011,5,VI,46,44,2
2011,5,VT,154,138,16
2011,5,WA,2037,1904,133
2011,5,WI,792,718,74
2011,5,WV,831,853,-22
2011,5,WY,361,187,174
2011,6,AK,120,117,3
2011,6,AL,4475,4450,25
2011,6,AR,1602,865,737
2011,6,AZ,1471,1300,171
2011,6,CA,9474,9370,104
2011,6,CO,1567,1166,401
2011,6,CT,1971,1914,57
2011,6,DC,342,330,12
2011,6,DE,1457,1459,-2
2011,6,FL,178948,181191,-2243
2011,6,GA,7676,7676,0
2011,6,GU,6,5,1
2011,6,HI,3962,3879,83
2011,6,IA,945,627,318
2011,6,ID,392,297,95
2011,6,IL,2161,2029,132
2011,6,IN,1157,1019,138
2011,6,KS,844,832,12
2011,6,KY,1208,1163,45
2011,6,LA,57209,50439,6770
2011,6,MA,2573,2464,109
2011,6,MD,3705,3611,94
2011,6,ME,449,452,-3
2011,6,MI,771,695,76
2011,6,MN,454,462,-8
2011,6,MO,1416,1248,168
2011,6,MS,8923,8114,809
2011,6,MT,1225,524,701
2011,6,NC,11644,11595,49
2011,6,ND,1743,353,1390
2011,6,NE,821,400,421
2011,6,NH,362,380,-18
2011,6,NJ,12479,12513,-34
2011,6,NM,604,533,71
2011,6,NV,497,516,-19
2011,6,NY,11070,10920,150
2011,6,OH,1722,1496,226
2011,6,OK,954,883,71
2011,6,OR,1355,1238,117
2011,6,PA,3117,3074,43
2011,6,PR,639,663,-24
2011,6,RI,899,908,-9
2011,6,SC,15956,15651,305
2011,6,SD,924,243,681
2011,6,TN,4168,3731,437
2011,6,TX,76804,77587,-783
2011,6,UN,1,1,0
2011,6,UT,419,281,138
2011,6,VA,9214,9054,160
2011,6,VI,148,152,-4
2011,6,VT,139,130,9
2011,6,WA,1778,1710,68
2011,6,WI,648,567,81
2011,6,WV,821,846,-25
2011,6,WY,407,130,277
2011,7,AK,142,144,-2
2011,7,AL,4820,4800,20
2011,7,AR,852,750,102
2011,7,AZ,2011,1437,574
2011,7,CA,10044,9681,363
2011,7,CO,1307,1252,55
2011,7,CT,2133,2081,52
2011,7,DC,106,97,9
2011,7,DE,1738,1758,-20
2011,7,FL,187136,189508,-2372
2011,7,GA,9120,9052,68
2011,7,GU,1,1,0
2011,7,HI,2966,3237,-271
2011,7,IA,2615,1096,1519
2011,7,ID,579,517,62
2011,7,IL,2226,2165,61
2011,7,IN,1690,1633,57
2011,7,KS,1027,843,184
2011,7,KY,1214,1216,-2
2011,7,LA,54966,54782,184
2011,7,MA,2955,2945,10
2011,7,MD,4876,4847,29
2011,7,ME,495,502,-7
2011,7,MI,927,818,109
2011,7,MN,482,487,-5
2011,7,MO,1755,1328,427
2011,7,MS,6589,6503,86
2011,7,MT,554,457,97
2011,7,NC,13127,12972,155
2011,7,ND,723,365,358
2011,7,NE,1214,518,696
2011,7,NH,523,509,14
2011,7,NJ,13098,12618,480
2011,7,NM,706,652,54
2011,7,NV,573,609,-36
2011,7,NY,11291,11070,221
2011,7,OH,1843,1724,119
2011,7,OK,1057,1054,3
2011,7,OR,1511,1435,76
2011,7,PA,3663,3692,-29
2011,7,PR,1028,1726,-698
2011,7,RI,1167,1111,56
2011,7,SC,17997,17655,342
2011,7,SD,696,239,457
2011,7,TN,2217,2150,67
2011,7,TX,109584,110167,-583
2011,7,UT,280,244,36
2011,7,VA,11538,11267,271
2011,7,VI,51,83,-32
2011,7,VT,153,147,6
2011,7,WA,1779,1798,-19
2011,7,WI,838,836,2
2011,7,WV,978,1045,-67
2011,7,WY,200,152,48
2011,8,AK,166,161,5
2011,8,AL,4004,3943,61
2011,8,AR,884,820,64
2011,8,AZ,2312,2340,-28
2011,8,CA,9351,9329,22
2011,8,CO,1136,1075,61
2011,8,CT,2449,2412,37
2011,8,DC,428,420,8
2011,8,DE,1594,1618,-24
2011,8,FL,160608,162224,-1616
2011,8,GA,9206,9204,2
2011,8,GU,7,6,1
2011,8,HI,7012,7122,-110
2011,8,IA,935,860,75
2011,8,ID,278,243,35
2011,8,IL,2411,2245,166
2011,8,IN,1453,1394,59
2011,8,KS,680,687,-7
2011,8,KY,1060,1042,18
2011,8,LA,46340,46572,-232
2011,8,MA,3601,3544,57
2011,8,MD,4125,4079,46
2011,8,ME,545,551,-6
2011,8,MI,839,787,52
2011,8,MN,535,506,29
2011,8,MO,1421,1297,124
2011,8,MS,8832,8921,-89
2011,8,MT,298,292,6
2011,8,NC,13490,13393,97
2011,8,ND,680,343,337
2011,8,NE,531,459,72
2011,8,NH,336,341,-5
2011,8,NJ,13542,13356,186
2011,8,NM,752,718,34
2011,8,NV,692,714,-22
2011,8,NY,12369,12440,-71
2011,8,OH,1972,1848,124
2011,8,OK,1112,1202,-90
2011,8,OR,1701,1683,18
2011,8,PA,4373,4395,-22
2011,8,PR,11035,11283,-248
2011,8,RI,1433,1437,-4
2011,8,SC,17228,16995,233
2011,8,SD,460,487,-27
2011,8,TN,2400,2366,34
2011,8,TX,81231,84471,-3240
2011,8,UT,220,207,13
2011,8,VA,11556,11352,204
2011,8,VI,102,118,-16
2011,8,VT,163,155,8
2011,8,WA,1875,2172,-297
2011,8,WI,811,839,-28
2011,8,WV,930,1017,-87
2011,8,WY,153,151,2
2011,9,AK,159,157,2
2011,9,AL,3725,3573,152
2011,9,AR,807,747,60
2011,9,AZ,1713,1692,21
2011,9,CA,10048,10063,-15
2011,9,CO,1079,1040,39
2011,9,CT,2632,2440,192
2011,9,DC,430,386,44
2011,9,DE,1848,1735,113
2011,9,FL,144089,145493,-1404
2011,9,GA,7974,7709,265
2011,9,GU,8,8,0
2011,9,HI,4851,4871,-20
2011,9,IA,948,905,43
2011,9,ID,264,231,33
2011,9,IL,2128,1930,198
2011,9,IN,1341,1311,30
2011,9,KS,619,586,33
2011,9,KY,1221,1187,34
2011,9,LA,36224,36435,-211
2011,9,MA,3711,3310,401
2011,9,MD,4477,3918,559
2011,9,ME,569,561,8
2011,9,MI,844,829,15
2011,9,MN,510,480,30
2011,9,MO,1166,1026,140
2011,9,MS,5572,5683,-111
2011,9,MT,206,192,14
2011,9,NC,11788,11467,321
2011,9,ND,1225,305,920
2011,9,NE,403,378,25
2011,9,NH,639,611,28
2011,9,NJ,15647,14913,734
2011,9,NM,694,724,-30
2011,9,NV,593,637,-44
2011,9,NY,15543,14803,740
2011,9,OH,2026,1851,175
2011,9,OK,984,964,20
2011,9,OR,2676,2677,-1
2011,9,PA,4241,4129,112
2011,9,PR,1048,1151,-103
2011,9,RI,1402,1341,61
2011,9,SC,15475,14939,536
2011,9,SD,352,357,-5
2011,9,TN,2141,2178,-37
2011,9,TX,59155,60433,-1278
2011,9,UT,233,254,-21
2011,9,VA,10872,10119,753
2011,9,VI,68,78,-10
2011,9,VT,164,145,19
2011,9,WA,2364,2848,-484
2011,9,WI,833,866,-33
2011,9,WV,964,1047,-83
2011,9,WY,113,118,-5
2011,10,AK,148,131,17
2011,10,AL,3310,3231,79
2011,10,AR,820,761,59
2011,10,AZ,1701,1937,-236
2011,10,CA,15783,15877,-94
2011,10,CO,875,806,69
2011,10,CT,2476,2239,237
2011,10,DC,217,130,87
2011,10,DE,1926,1780,146
2011,10,FL,140904,142319,-1415
2011,10,GA,8204,8274,-70
2011,10,GU,3,3,0
2011,10,HI,3242,3439,-197
2011,10,IA,757,674,83
2011,10,ID,293,287,6
2011,10,IL,2061,2013,48
2011,10,IN,1365,1279,86
2011,10,KS,619,558,61
2011,10,KY,1088,1045,43
2011,10,LA,30067,30204,-137
2011,10,MA,3825,3620,205
2011,10,MD,4745,4233,512
2011,10,ME,710,700,10
2011,10,MI,833,771,62
2011,10,MN,528,572,-44
2011,10,MO,1118,1067,51
2011,10,MS,4673,4627,46
2011,10,MT,199,169,30
2011,10,NC,10694,10469,225
2011,10,ND,1208,320,888
2011,10,NE,365,353,12
2011,10,NH,482,375,107
2011,10,NJ,14366,12830,1536
2011,10,NM,584,590,-6
2011,10,NV,640,635,5
2011,10,NY,15057,13509,1548
2011,10,OH,2084,1798,286
2011,10,OK,1104,1087,17
2011,10,OR,2057,2007,50
2011,10,PA,5427,4174,1253
2011,10,PR,1387,1607,-220
2011,10,RI,1033,1009,24
2011,10,SC,13999,13812,187
2011,10,SD,268,238,30
2011,10,TN,2116,2050,66
2011,10,TX,50444,51409,-965
2011,10,UT,234,240,-6
2011,10,VA,10380,9673,707
2011,10,VI,52,60,-8
2011,10,VT,319,169,150
2011,10,WA,3996,5819,-1823
2011,10,WI,723,734,-11
2011,10,WV,916,960,-44
2011,10,WY,108,109,-1
2011,11,AK,109,107,2
2011,11,AL,2955,2873,82
2011,11,AR,703,652,51
2011,11,AZ,1287,1265,22
2011,11,CA,18726,19374,-648
2011,11,CO,990,785,205
2011,11,CT,2225,2109,116
2011,11,DC,97,78,19
2011,11,DE,1258,1242,16
2011,11,FL,107135,109156,-2021
2011,11,GA,5799,5913,-114
2011,11,GU,1,1,0
2011,11,HI,4096,4099,-3
2011,11,IA,552,480,72
2011,11,ID,258,237,21
2011,11,IL,1975,1926,49
2011,11,IN,1179,1148,31
2011,11,KS,515,477,38
2011,11,KY,983,934,49
2011,11,LA,24241,24605,-364
2011,11,MA,2751,2614,137
2011,11,MD,3740,3648,92
2011,11,ME,557,551,6
2011,11,MI,673,621,52
2011,11,MN,422,439,-17
2011,11,MO,1070,1039,31
2011,11,MS,3977,4106,-129
2011,11,MT,156,140,16
2011,11,NC,7712,7650,62
2011,11,ND,525,289,236
2011,11,NE,300,297,3
2011,11,NH,495,493,2
2011,11,NJ,13740,13218,522
2011,11,NM,478,473,5
2011,11,NV,637,616,21
2011,11,NY,10832,9962,870
2011,11,OH,1980,1700,280
2011,11,OK,813,798,15
2011,11,OR,2281,2377,-96
2011,11,PA,4017,3580,437
2011,11,PR,1525,1489,36
2011,11,RI,782,774,8
2011,11,SC,10099,10053,46
2011,11,SD,213,190,23
2011,11,TN,1561,1508,53
2011,11,TX,35651,36473,-822
2011,11,UN,1,1,0
2011,11,UT,222,196,26
2011,11,VA,6844,6546,298
2011,11,VI,45,61,-16
2011,11,VT,259,179,80
2011,11,WA,4260,5562,-1302
2011,11,WI,583,555,28
2011,11,WV,849,865,-16
2011,11,WY,97,86,11
2011,12,AK,113,105,8
2011,12,AL,3662,3616,46
2011,12,AR,658,587,71
2011,12,AZ,1092,1085,7
2011,12,CA,18241,18502,-261
2011,12,CO,768,750,18
2011,12,CT,2104,1981,123
2011,12,DC,100,86,14
2011,12,DE,1131,1115,16
2011,12,FL,108638,110536,-1898
2011,12,GA,5120,5180,-60
2011,12,GU,6,6,0
2011,12,HI,3146,3145,1
2011,12,IA,572,456,116
2011,12,ID,257,252,5
2011,12,IL,1503,1451,52
2011,12,IN,994,931,63
2011,12,KS,501,385,116
2011,12,KY,919,895,24
2011,12,LA,22857,23206,-349
2011,12,MA,2619,2504,115
2011,12,MD,3383,3306,77
2011,12,ME,463,470,-7
2011,12,MI,898,847,51
2011,12,MN,338,354,-16
2011,12,MO,951,861,90
2011,12,MP,1,0,1
2011,12,MS,3634,3697,-63
2011,12,MT,185,155,30
2011,12,NC,6993,6988,5
2011,12,ND,454,292,162
2011,12,NE,405,406,-1
2011,12,NH,337,335,2
2011,12,NJ,11626,11161,465
2011,12,NM,517,489,28
2011,12,NV,495,492,3
2011,12,NY,9243,8369,874
2011,12,OH,1696,1508,188
2011,12,OK,729,538,191
2011,12,OR,2131,2164,-33
2011,12,PA,3306,3101,205
2011,12,PR,830,890,-60
2011,12,RI,623,626,-3
2011,12,SC,9727,9582,145
2011,12,SD,221,227,-6
2011,12,TN,1457,1419,38
2011,12,TX,27915,28345,-430
2011,12,UN,1,1,0
2011,12,UT,235,210,25
2011,12,VA,5546,5375,171
2011,12,VI,108,113,-5
2011,12,VT,181,133,48
2011,12,WA,3186,3800,-614
2011,12,WI,468,445,23
2011,12,WV,719,718,1
2011,12,WY,86,84,2
2012,1,AK,107,102,5
2012,1,AL,1997,1865,132
2012,1,AR,639,539,100
2012,1,AZ,1123,1087,36
2012,1,CA,16195,17300,-1105
2012,1,CO,803,789,14
2012,1,CT,1855,1795,60
2012,1,DC,113,108,5
2012,1,DE,1443,1436,7
2012,1,FL,106081,107833,-1752
2012,1,GA,4697,4656,41
2012,1,GU,5,5,0
2012,1,HI,2877,2949,-72
2012,1,IA,565,474,91
2012,1,ID,253,263,-10
2012,1,IL,1835,1814,21
2012,1,IN,887,812,75
2012,1,KS,476,404,72
2012,1,KY,755,700,55
2012,1,LA,22087,22191,-104
2012,1,MA,1979,1947,32
2012,1,MD,3170,3043,127
2012,1,ME,392,404,-12
2012,1,MI,604,564,40
2012,1,MN,352,397,-45
2012,1,MO,833,779,54
2012,1,MS,3527,3581,-54
2012,1,MT,178,156,22
2012,1,NC,6568,6523,45
2012,1,ND,406,259,147
2012,1,NE,376,377,-1
2012,1,NH,324,305,19
2012,1,NJ,9629,8873,756
2012,1,NM,520,526,-6
2012,1,NV,686,615,71
2012,1,NY,7674,7301,373
2012,1,OH,1500,1377,123
2012,1,OK,565,495,70
2012,1,OR,1957,1981,-24
2012,1,PA,3153,3066,87
2012,1,PR,831,903,-72
2012,1,RI,678,670,8
2012,1,SC,8811,8763,48
2012,1,SD,207,194,13
2012,1,TN,1291,1202,89
2012,1,TX,26050,26099,-49
2012,1,UT,147,149,-2
2012,1,VA,4682,4568,114
2012,1,VI,61,55,6
2012,1,VT,174,145,29
2012,1,WA,2358,2647,-289
2012,1,WI,553,542,11
2012,1,WV,738,734,4
2012,1,WY,70,62,8
2012,2,AK,97,89,8
2012,2,AL,3024,2952,72
2012,2,AR,727,689,38
2012,2,AZ,1209,1188,21
2012,2,CA,15510,16444,-934
2012,2,CO,695,660,35
2012,2,CT,1279,1277,2
2012,2,DC,90,80,10
2012,2,DE,981,963,18
2012,2,FL,97869,98893,-1024
2012,2,GA,4341,4264,77
2012,2,GU,3,3,0
2012,2,HI,4541,4537,4
2012,2,IA,730,674,56
2012,2,ID,399,412,-13
2012,2,IL,2044,2068,-24
2012,2,IN,1103,1028,75
2012,2,KS,509,423,86
2012,2,KY,906,890,16
2012,2,LA,25472,25587,-115
2012,2,MA,1864,1845,19
2012,2,MD,2540,2456,84
2012,2,ME,372,381,-9
2012,2,MI,853,838,15
2012,2,MN,681,1161,-480
2012,2,MO,890,862,28
2012,2,MS,4010,4085,-75
2012,2,MT,285,334,-49
2012,2,NC,6484,6358,126
2012,2,ND,1029,1693,-664
2012,2,NE,443,473,-30
2012,2,NH,335,318,17
2012,2,NJ,9302,9189,113
2012,2,NM,466,492,-26
2012,2,NV,1013,796,217
2012,2,NY,7121,7028,93
2012,2,OH,1778,1602,176
2012,2,OK,588,573,15
2012,2,OR,1968,1678,290
2012,2,PA,4243,4204,39
2012,2,PR,437,427,10
2012,2,RI,719,721,-2
2012,2,SC,8430,8588,-158
2012,2,SD,286,312,-26
2012,2,TN,1330,1271,59
2012,2,TX,27375,26573,802
2012,2,UN,1,1,0
2012,2,UT,311,308,3
2012,2,VA,4567,4470,97
2012,2,VI,79,80,-1
2012,2,VT,170,131,39
2012,2,WA,2174,2284,-110
2012,2,WI,488,501,-13
2012,2,WV,952,981,-29
2012,2,WY,111,113,-2
2012,3,AK,138,127,11
2012,3,AL,2752,2632,120
2012,3,AR,801,749,52
2012,3,AZ,1207,1222,-15
2012,3,CA,12212,12714,-502
2012,3,CO,1003,1003,0
2012,3,CT,2104,2966,-862
2012,3,DC,108,101,7
2012,3,DE,1118,1096,22
2012,3,FL,122510,123544,-1034
2012,3,GA,5179,5183,-4
2012,3,GU,2,3,-1
2012,3,HI,2350,2337,13
2012,3,IA,1382,1524,-142
2012,3,ID,884,875,9
2012,3,IL,2448,2558,-110
2012,3,IN,1346,1347,-1
2012,3,KS,599,565,34
2012,3,KY,1096,1065,31
2012,3,LA,30368,30608,-240
2012,3,MA,2402,2479,-77
2012,3,MD,3563,3412,151
2012,3,ME,500,518,-18
2012,3,MI,1026,864,162
2012,3,MN,2124,7007,-4883
2012,3,MO,1176,1263,-87
2012,3,MS,5386,5435,-49
2012,3,MT,470,714,-244
2012,3,NC,8146,8077,69
2012,3,ND,3822,8037,-4215
2012,3,NE,527,483,44
2012,3,NH,430,449,-19
2012,3,NJ,9915,9581,334
2012,3,NM,600,610,-10
2012,3,NV,892,809,83
2012,3,NY,8366,7897,469
2012,3,OH,2057,1938,119
2012,3,OK,832,757,75
2012,3,OR,1712,1644,68
2012,3,PA,4693,4410,283
2012,3,PR,709,777,-68
2012,3,RI,588,599,-11
2012,3,SC,11158,10967,191
2012,3,SD,601,1158,-557
2012,3,TN,2274,2276,-2
2012,3,TX,34765,34080,685
2012,3,UN,2,2,0
2012,3,UT,285,314,-29
2012,3,VA,6233,6084,149
2012,3,VI,66,387,-321
2012,3,VT,229,212,17
2012,3,WA,2352,2435,-83
2012,3,WI,841,984,-143
2012,3,WV,1051,1108,-57
2012,3,WY,118,124,-6
2012,4,AK,273,189,84
2012,4,AL,4226,4245,-19
2012,4,AR,895,872,23
2012,4,AZ,1151,1115,36
2012,4,CA,11190,11913,-723
2012,4,CO,1249,1289,-40
2012,4,CT,1717,1827,-110
2012,4,DC,101,96,5
2012,4,DE,1227,1189,38
2012,4,FL,147035,148692,-1657
2012,4,GA,5510,5541,-31
2012,4,GU,5,6,-1
2012,4,HI,3514,3384,130
2012,4,IA,1392,1758,-366
2012,4,ID,473,500,-27
2012,4,IL,2787,3395,-608
2012,4,IN,1531,1498,33
2012,4,KS,834,830,4
2012,4,KY,1134,1097,37
2012,4,LA,39724,39782,-58
2012,4,MA,2324,2327,-3
2012,4,MD,3508,3457,51
2012,4,ME,623,659,-36
2012,4,MI,1288,782,506
2012,4,MN,1516,3800,-2284
2012,4,MO,1695,1902,-207
2012,4,MS,6081,6291,-210
2012,4,MT,569,997,-428
2012,4,NC,8665,8633,32
2012,4,ND,1835,2863,-1028
2012,4,NE,543,565,-22
2012,4,NH,508,527,-19
2012,4,NJ,10653,10364,289
2012,4,NM,590,571,19
2012,4,NV,648,652,-4
2012,4,NY,9442,9128,314
2012,4,OH,2196,2114,82
2012,4,OK,1032,969,63
2012,4,OR,1841,1851,-10
2012,4,PA,3839,3718,121
2012,4,PR,758,866,-108
2012,4,RI,755,766,-11
2012,4,SC,12443,12217,226
2012,4,SD,463,742,-279
2012,4,TN,2200,2185,15
2012,4,TX,39989,39771,218
2012,4,UT,346,408,-62
2012,4,VA,6131,5967,164
2012,4,VI,111,118,-7
2012,4,VT,240,208,32
2012,4,WA,2076,2178,-102
2012,4,WI,1152,1495,-343
2012,4,WV,1037,1039,-2
2012,4,WY,227,292,-65
2012,5,AK,153,145,8
2012,5,AL,4029,4018,11
2012,5,AR,983,1059,-76
2012,5,AZ,1170,1144,26
2012,5,CA,10226,10369,-143
2012,5,CO,1442,1421,21
2012,5,CT,1611,1602,9
2012,5,DC,76,71,5
2012,5,DE,1329,1239,90
2012,5,FL,154105,155465,-1360
2012,5,GA,6096,6107,-11
2012,5,GU,6,6,0
2012,5,HI,3630,3653,-23
2012,5,IA,835,842,-7
2012,5,ID,704,712,-8
2012,5,IL,2165,2214,-49
2012,5,IN,1201,1147,54
2012,5,KS,638,649,-11
2012,5,KY,1082,1073,9
2012,5,LA,42772,45107,-2335
2012,5,MA,2275,2201,74
2012,5,MD,3155,2994,161
2012,5,ME,439,424,15
2012,5,MI,984,748,236
2012,5,MN,546,519,27
2012,5,MO,1236,1372,-136
2012,5,MS,7179,7608,-429
2012,5,MT,474,1083,-609
2012,5,NC,9655,9590,65
2012,5,ND,433,435,-2
2012,5,NE,518,536,-18
2012,5,NH,374,376,-2
2012,5,NJ,11122,10888,234
2012,5,NM,571,537,34
2012,5,NV,555,549,6
2012,5,NY,9142,8786,356
2012,5,OH,1715,1708,7
2012,5,OK,985,900,85
2012,5,OR,1423,1427,-4
2012,5,PA,3603,3526,77
2012,5,PR,846,824,22
2012,5,RI,697,714,-17
2012,5,SC,14268,14061,207
2012,5,SD,349,377,-28
2012,5,TN,1831,1923,-92
2012,5,TX,51684,52727,-1043
2012,5,UN,2,3,-1
2012,5,UT,423,643,-220
2012,5,VA,7326,7178,148
2012,5,VI,38,44,-6
2012,5,VT,159,152,7
2012,5,WA,1857,2014,-157
2012,5,WI,767,770,-3
2012,5,WV,856,848,8
2012,5,WY,212,350,-138
2012,6,AK,134,127,7
2012,6,AL,4489,4556,-67
2012,6,AR,1216,1511,-295
2012,6,AZ,1471,1492,-21
2012,6,CA,8853,8979,-126
2012,6,CO,1466,1610,-144
2012,6,CT,1825,1787,38
2012,6,DC,369,363,6
2012,6,DE,1454,1438,16
2012,6,FL,176072,176710,-638
2012,6,GA,8169,8146,23
2012,6,GU,8,5,3
2012,6,HI,6246,6296,-50
2012,6,IA,773,922,-149
2012,6,ID,349,389,-40
2012,6,IL,2120,2197,-77
2012,6,IN,1181,1220,-39
2012,6,KS,783,797,-14
2012,6,KY,1116,1168,-52
2012,6,LA,52749,56571,-3822
2012,6,MA,2666,2564,102
2012,6,MD,4441,4142,299
2012,6,ME,422,457,-35
2012,6,MI,944,799,145
2012,6,MN,523,479,44
2012,6,MO,1306,1413,-107
2012,6,MS,7780,8573,-793
2012,6,MT,607,1194,-587
2012,6,NC,11894,11776,118
2012,6,ND,887,1704,-817
2012,6,NE,539,810,-271
2012,6,NH,366,354,12
2012,6,NJ,12516,12239,277
2012,6,NM,600,589,11
2012,6,NV,517,508,9
2012,6,NY,9742,10650,-908
2012,6,OH,1691,1678,13
2012,6,OK,1053,959,94
2012,6,OR,1341,1329,12
2012,6,PA,3360,3190,170
2012,6,PR,574,648,-74
2012,6,RI,894,886,8
2012,6,SC,16616,16039,577
2012,6,SD,500,877,-377
2012,6,TN,3606,4184,-578
2012,6,TX,76096,78344,-2248
2012,6,UN,1,1,0
2012,6,UT,266,412,-146
2012,6,VA,9605,9457,148
2012,6,VI,197,144,53
2012,6,VT,169,144,25
2012,6,WA,1675,1748,-73
2012,6,WI,702,670,32
2012,6,WV,844,847,-3
2012,6,WY,197,396,-199
2012,7,AK,141,137,4
2012,7,AL,4815,4830,-15
2012,7,AR,852,841,11
2012,7,AZ,1806,1954,-148
2012,7,CA,9603,9618,-15
2012,7,CO,1258,1183,75
2012,7,CT,2049,2010,39
2012,7,DC,117,99,18
2012,7,DE,1614,1600,14
2012,7,FL,183366,182703,663
2012,7,GA,9137,9122,15
2012,7,GU,3,2,1
2012,7,HI,3163,2976,187
2012,7,IA,1284,2417,-1133
2012,7,ID,276,293,-17
2012,7,IL,2117,2184,-67
2012,7,IN,1638,1687,-49
2012,7,KS,869,1031,-162
2012,7,KY,1108,1125,-17
2012,7,LA,52808,54219,-1411
2012,7,MA,3366,3108,258
2012,7,MD,4956,4838,118
2012,7,ME,493,488,5
2012,7,MI,1003,936,67
2012,7,MN,615,512,103
2012,7,MO,1385,1669,-284
2012,7,MS,6543,6569,-26
2012,7,MT,431,532,-101
2012,7,NC,13247,13286,-39
2012,7,ND,552,702,-150
2012,7,NE,756,1203,-447
2012,7,NH,550,542,8
2012,7,NJ,13292,12931,361
2012,7,NM,756,713,43
2012,7,NV,559,571,-12
2012,7,NY,11432,11327,105
2012,7,OH,1868,1862,6
2012,7,OK,1064,1054,10
2012,7,OR,1439,1460,-21
2012,7,PA,3686,3593,93
2012,7,PR,751,974,-223
2012,7,RI,1137,1146,-9
2012,7,SC,17654,17672,-18
2012,7,SD,359,669,-310
2012,7,TN,2143,2158,-15
2012,7,TX,104912,108513,-3601
2012,7,UT,240,262,-22
2012,7,VA,11628,11589,39
2012,7,VI,40,46,-6
2012,7,VT,195,159,36
2012,7,WA,1692,1737,-45
2012,7,WI,868,870,-2
2012,7,WV,910,954,-44
2012,7,WY,161,198,-37
2012,8,AK,162,179,-17
2012,8,AL,3999,3932,67
2012,8,AR,875,859,16
2012,8,AZ,2081,2249,-168
2012,8,CA,9259,9119,140
2012,8,CO,2205,1120,1085
2012,8,CT,2472,2442,30
2012,8,DC,439,416,23
2012,8,DE,1876,1671,205
2012,8,FL,163307,160069,3238
2012,8,GA,8775,8977,-202
2012,8,GU,8,7,1
2012,8,HI,6848,6794,54
2012,8,IA,838,928,-90
2012,8,ID,280,268,12
2012,8,IL,2201,2348,-147
2012,8,IN,1442,1456,-14
2012,8,KS,704,679,25
2012,8,KY,1103,1054,49
2012,8,LA,43959,43953,6
2012,8,MA,3842,3492,350
2012,8,MD,4321,4155,166
2012,8,ME,543,529,14
2012,8,MI,918,813,105
2012,8,MN,575,493,82
2012,8,MO,1410,1414,-4
2012,8,MS,5774,5612,162
2012,8,MT,269,274,-5
2012,8,NC,13204,13152,52
2012,8,ND,648,663,-15
2012,8,NE,493,513,-20
2012,8,NH,366,365,1
2012,8,NJ,13653,13385,268
2012,8,NM,783,747,36
2012,8,NV,719,716,3
2012,8,NY,12409,11946,463
2012,8,OH,1926,1921,5
2012,8,OK,1129,1143,-14
2012,8,OR,1466,1630,-164
2012,8,PA,4404,4351,53
2012,8,PR,10836,11025,-189
2012,8,RI,1380,1417,-37
2012,8,SC,17264,17149,115
2012,8,SD,412,446,-34
2012,8,TN,2195,2199,-4
2012,8,TX,77262,78515,-1253
2012,8,UT,236,206,30
2012,8,VA,12017,12018,-1
2012,8,VI,96,98,-2
2012,8,VT,178,176,2
2012,8,WA,1654,1788,-134
2012,8,WI,841,816,25
2012,8,WV,941,949,-8
2012,8,WY,158,150,8
2012,9,AK,164,163,1
2012,9,AL,3875,3704,171
2012,9,AR,886,797,89
2012,9,AZ,2094,1667,427
2012,9,CA,10346,10274,72
2012,9,CO,1354,1121,233
2012,9,CT,2508,2470,38
2012,9,DC,454,444,10
2012,9,DE,2013,2012,1
2012,9,FL,144362,142651,1711
2012,9,GA,7739,7777,-38
2012,9,GU,7,9,-2
2012,9,HI,4980,4779,201
2012,9,IA,937,939,-2
2012,9,ID,252,259,-7
2012,9,IL,1988,2134,-146
2012,9,IN,1314,1308,6
2012,9,KS,642,635,7
2012,9,KY,1253,1264,-11
2012,9,LA,35923,35792,131
2012,9,MA,4089,3856,233
2012,9,MD,4678,4406,272
2012,9,ME,541,545,-4
2012,9,MI,843,831,12
2012,9,MN,560,544,16
2012,9,MO,1172,1155,17
2012,9,MS,5318,5247,71
2012,9,MT,214,222,-8
2012,9,NC,11621,11627,-6
2012,9,ND,1062,1211,-149
2012,9,NE,387,396,-9
2012,9,NH,615,613,2
2012,9,NJ,14628,14453,175
2012,9,NM,698,702,-4
2012,9,NV,609,603,6
2012,9,NY,15083,14688,395
2012,9,OH,1997,2026,-29
2012,9,OK,985,956,29
2012,9,OR,2217,2439,-222
2012,9,PA,4127,4031,96
2012,9,PR,978,1058,-80
2012,9,RI,1393,1394,-1
2012,9,SC,15437,15191,246
2012,9,SD,315,327,-12
2012,9,TN,2044,2131,-87
2012,9,TX,57206,58177,-971
2012,9,UT,281,240,41
2012,9,VA,11348,11362,-14
2012,9,VI,65,68,-3
2012,9,VT,214,167,47
2012,9,WA,2074,2349,-275
2012,9,WI,827,800,27
2012,9,WV,913,951,-38
2012,9,WY,103,101,2
2012,10,AK,171,154,17
2012,10,AL,3330,3311,19
2012,10,AR,835,804,31
2012,10,AZ,1788,1681,107
2012,10,CA,15535,15909,-374
2012,10,CO,1052,877,175
2012,10,CT,2581,2539,42
2012,10,DC,171,215,-44
2012,10,DE,1980,1949,31
2012,10,FL,138646,140292,-1646
2012,10,GA,8030,8079,-49
2012,10,GU,3,3,0
2012,10,HI,3698,3689,9
2012,10,IA,730,745,-15
2012,10,ID,297,304,-7
2012,10,IL,2099,2117,-18
2012,10,IN,1313,1347,-34
2012,10,KS,602,608,-6
2012,10,KY,1058,1074,-16
2012,10,LA,30690,30181,509
2012,10,MA,4301,3873,428
2012,10,MD,5079,4831,248
2012,10,ME,699,706,-7
2012,10,MI,834,847,-13
2012,10,MN,564,568,-4
2012,10,MO,1165,1120,45
2012,10,MS,4275,4162,113
2012,10,MT,195,189,6
2012,10,NC,9868,9918,-50
2012,10,ND,979,1235,-256
2012,10,NE,379,374,5
2012,10,NH,467,475,-8
2012,10,NJ,15300,15177,123
2012,10,NM,580,568,12
2012,10,NV,1072,646,426
2012,10,NY,15307,14954,353
2012,10,OH,2059,2072,-13
2012,10,OK,1083,1073,10
2012,10,OR,2072,2097,-25
2012,10,PA,5544,5255,289
2012,10,PR,1395,1377,18
2012,10,RI,1049,1043,6
2012,10,SC,14006,13985,21
2012,10,SD,251,263,-12
2012,10,TN,2029,2056,-27
2012,10,TX,48290,50267,-1977
2012,10,UT,306,245,61
2012,10,VA,10347,10182,165
2012,10,VI,54,48,6
2012,10,VT,310,311,-1
2012,10,WA,3288,3923,-635
2012,10,WI,688,699,-11
2012,10,WV,906,928,-22
2012,10,WY,103,106,-3
2012,11,AK,134,109,25
2012,11,AL,2720,2689,31
2012,11,AR,721,677,44
2012,11,AZ,1376,1280,96
2012,11,CA,17757,18553,-796
2012,11,CO,1162,1047,115
2012,11,CT,2283,2175,108
2012,11,DC,155,107,48
2012,11,DE,1442,1349,93
2012,11,FL,104564,105098,-534
2012,11,GA,5881,5816,65
2012,11,GU,2,1,1
2012,11,HI,3713,4115,-402
2012,11,IA,534,541,-7
2012,11,ID,271,245,26
2012,11,IL,1738,1744,-6
2012,11,IN,1163,1200,-37
2012,11,KS,490,501,-11
2012,11,KY,1043,968,75
2012,11,LA,24045,23868,177
2012,11,MA,3101,2708,393
2012,11,MD,4114,3585,529
2012,11,ME,559,536,23
2012,11,MI,754,688,66
2012,11,MN,466,430,36
2012,11,MO,1101,1103,-2
2012,11,MS,3939,3907,32
2012,11,MT,164,150,14
2012,11,NC,7871,7829,42
2012,11,ND,510,541,-31
2012,11,NE,317,309,8
2012,11,NH,515,489,26
2012,11,NJ,13358,12889,469
2012,11,NM,462,459,3
2012,11,NV,711,634,77
2012,11,NY,11551,10717,834
2012,11,OH,1750,1938,-188
2012,11,OK,858,800,58
2012,11,OR,2381,2370,11
2012,11,PA,4082,3847,235
2012,11,PR,1453,1522,-69
2012,11,RI,802,781,21
2012,11,SC,10307,10097,210
2012,11,SD,214,205,9
2012,11,TN,1659,1500,159
2012,11,TX,35354,35913,-559
2012,11,UT,255,220,35
2012,11,VA,7236,6877,359
2012,11,VI,31,42,-11
2012,11,VT,267,243,24
2012,11,WA,3762,4147,-385
2012,11,WI,603,584,19
2012,11,WV,799,842,-43
2012,11,WY,85,95,-10
2012,12,AK,123,113,10
2012,12,AL,3823,3721,102
2012,12,AR,661,650,11
2012,12,AZ,1233,1084,149
2012,12,CA,19118,18017,1101
2012,12,CO,1048,937,111
2012,12,CT,2368,2127,241
2012,12,DC,132,100,32
2012,12,DE,1402,1172,230
2012,12,FL,112075,111048,1027
2012,12,GA,4709,4623,86
2012,12,GU,6,7,-1
2012,12,HI,4634,4549,85
2012,12,IA,576,551,25
2012,12,ID,302,281,21
2012,12,IL,1616,1560,56
2012,12,IN,969,971,-2
2012,12,KS,492,480,12
2012,12,KY,977,919,58
2012,12,LA,22579,22431,148
2012,12,MA,3190,2616,574
2012,12,MD,4069,3505,564
2012,12,ME,514,467,47
2012,12,MI,1009,929,80
2012,12,MN,392,356,36
2012,12,MO,981,928,53
2012,12,MP,1,1,0
2012,12,MS,3651,3622,29
2012,12,MT,183,175,8
2012,12,NC,7035,6748,287
2012,12,ND,506,481,25
2012,12,NE,401,394,7
2012,12,NH,348,331,17
2012,12,NJ,12729,11393,1336
2012,12,NM,532,521,11
2012,12,NV,606,510,96
2012,12,NY,13025,9718,3307
2012,12,OH,1676,1649,27
2012,12,OK,757,735,22
2012,12,OR,2170,1995,175
2012,12,PA,3506,3237,269
2012,12,PR,782,818,-36
2012,12,RI,638,606,32
2012,12,SC,9992,9546,446
2012,12,SD,215,227,-12
2012,12,TN,1554,1468,86
2012,12,TX,29034,28871,163
2012,12,UN,1,1,0
2012,12,UT,210,194,16
2012,12,VA,6286,5842,444
2012,12,VI,100,105,-5
2012,12,VT,180,157,23
2012,12,WA,3254,3171,83
2012,12,WI,491,453,38
2012,12,WV,704,708,-4
2012,12,WY,81,81,0
2013,1,AK,107,112,-5
2013,1,AL,2254,2250,4
2013,1,AR,598,594,4
2013,1,AZ,1248,1168,80
2013,1,CA,16194,16005,189
2013,1,CO,809,837,-28
2013,1,CT,1903,1786,117
2013,1,DC,98,85,13
2013,1,DE,1435,1556,-121
2013,1,FL,106148,106177,-29
2013,1,GA,4099,4047,52
2013,1,GU,6,5,1
2013,1,HI,3303,3279,24
2013,1,IA,644,596,48
2013,1,ID,261,252,9
2013,1,IL,1715,1752,-37
2013,1,IN,867,850,17
2013,1,KS,468,489,-21
2013,1,KY,846,799,47
2013,1,LA,21976,22078,-102
2013,1,MA,2366,2133,233
2013,1,MD,3497,3092,405
2013,1,ME,421,401,20
2013,1,MI,649,615,34
2013,1,MN,347,335,12
2013,1,MO,796,812,-16
2013,1,MS,3300,3353,-53
2013,1,MT,198,174,24
2013,1,NC,6791,6653,138
2013,1,ND,358,380,-22
2013,1,NE,343,352,-9
2013,1,NH,312,312,0
2013,1,NJ,11863,10255,1608
2013,1,NM,505,510,-5
2013,1,NV,697,690,7
2013,1,NY,11485,8694,2791
2013,1,OH,1464,1446,18
2013,1,OK,612,578,34
2013,1,OR,1956,1968,-12
2013,1,PA,3725,3293,432
2013,1,PR,803,824,-21
2013,1,RI,754,740,14
2013,1,SC,8722,8740,-18
2013,1,SD,200,203,-3
2013,1,TN,1316,1270,46
2013,1,TX,24464,24702,-238
2013,1,UT,174,163,11
2013,1,VA,5583,5421,162
2013,1,VI,57,63,-6
2013,1,VT,174,166,8
2013,1,WA,2390,2331,59
2013,1,WI,592,556,36
2013,1,WV,691,700,-9
2013,1,WY,78,79,-1
2013,2,AK,115,97,18
2013,2,AL,3105,3080,25
2013,2,AR,730,742,-12
2013,2,AZ,1257,1224,33
2013,2,CA,14914,15456,-542
2013,2,CO,771,706,65
2013,2,CT,1368,1312,56
2013,2,DC,209,93,116
2013,2,DE,963,891,72
2013,2,FL,98776,99714,-938
2013,2,GA,4349,4365,-16
2013,2,GU,2,3,-1
2013,2,HI,4835,4695,140
2013,2,IA,673,705,-32
2013,2,ID,417,399,18
2013,2,IL,1921,1971,-50
2013,2,IN,1052,1073,-21
2013,2,KS,512,494,18
2013,2,KY,962,941,21
2013,2,LA,24186,23924,262
2013,2,MA,2179,1993,186
2013,2,MD,2888,2661,227
2013,2,ME,386,366,20
2013,2,MI,867,819,48
2013,2,MN,618,665,-47
2013,2,MO,915,886,29
2013,2,MS,4025,4025,0
2013,2,MT,279,278,1
2013,2,NC,6788,6685,103
2013,2,ND,905,981,-76
2013,2,NE,423,430,-7
2013,2,NH,347,332,15
2013,2,NJ,11975,10848,1127
2013,2,NM,430,457,-27
2013,2,NV,1003,1011,-8
2013,2,NY,12018,8438,3580
2013,2,OH,1829,1796,33
2013,2,OK,630,596,34
2013,2,OR,1894,1956,-62
2013,2,PA,4210,4165,45
2013,2,PR,355,438,-83
2013,2,RI,728,698,30
2013,2,SC,8330,8182,148
2013,2,SD,248,264,-16
2013,2,TN,1446,1347,99
2013,2,TX,26493,26537,-44
2013,2,UN,1,1,0
2013,2,UT,334,306,28
2013,2,VA,4921,4688,233
2013,2,VI,78,77,1
2013,2,VT,158,156,2
2013,2,WA,2239,2206,33
2013,2,WI,518,493,25
2013,2,WV,967,986,-19
2013,2,WY,93,95,-2
2013,3,AK,144,139,5
2013,3,AL,3084,3000,84
2013,3,AR,844,806,38
2013,3,AZ,1268,1222,46
2013,3,CA,12572,12506,66
2013,3,CO,1174,1042,132
2013,3,CT,2043,1958,85
2013,3,DC,118,98,20
2013,3,DE,1175,1139,36
2013,3,FL,126255,127426,-1171
2013,3,GA,5523,5342,181
2013,3,GU,4,3,1
2013,3,HI,3429,3399,30
2013,3,IA,1313,1374,-61
2013,3,ID,551,582,-31
2013,3,IL,2382,2386,-4
2013,3,IN,1281,1343,-62
2013,3,KS,598,611,-13
2013,3,KY,1137,1123,14
2013,3,LA,31463,31843,-380
2013,3,MA,2641,2483,158
2013,3,MD,4020,3774,246
2013,3,ME,554,529,25
2013,3,MI,1058,1026,32
2013,3,MN,1898,2085,-187
2013,3,MO,1214,1183,31
2013,3,MS,5330,5244,86
2013,3,MT,447,465,-18
2013,3,NC,8478,8365,113
2013,3,ND,3266,3653,-387
2013,3,NE,495,534,-39
2013,3,NH,421,423,-2
2013,3,NJ,11890,10774,1116
2013,3,NM,590,623,-33
2013,3,NV,951,918,33
2013,3,NY,13096,9892,3204
2013,3,OH,2007,2048,-41
2013,3,OK,869,863,6
2013,3,OR,1643,1676,-33
2013,3,PA,4724,4618,106
2013,3,PR,600,708,-108
2013,3,RI,657,653,4
2013,3,SC,11676,11673,3
2013,3,SD,514,579,-65
2013,3,TN,2249,2310,-61
2013,3,TX,33781,34708,-927
2013,3,UN,2,2,0
2013,3,UT,302,294,8
2013,3,VA,6749,6427,322
2013,3,VI,63,67,-4
2013,3,VT,258,230,28
2013,3,WA,2432,2467,-35
2013,3,WI,851,832,19
2013,3,WV,992,1024,-32
2013,3,WY,112,122,-10
2013,4,AK,212,261,-49
2013,4,AL,4246,4224,22
2013,4,AR,906,888,18
2013,4,AZ,1274,1190,84
2013,4,CA,10728,11259,-531
2013,4,CO,1322,1273,49
2013,4,CT,1885,1694,191
2013,4,DC,94,93,1
2013,4,DE,1366,1300,66
2013,4,FL,149770,151545,-1775
2013,4,GA,5772,5714,58
2013,4,GU,3,4,-1
2013,4,HI,3895,3976,-81
2013,4,IA,1335,1342,-7
2013,4,ID,481,508,-27
2013,4,IL,2852,2799,53
2013,4,IN,1526,1522,4
2013,4,KS,771,796,-25
2013,4,KY,1146,1118,28
2013,4,LA,37794,38645,-851
2013,4,MA,2396,2320,76
2013,4,MD,3571,3472,99
2013,4,ME,623,629,-6
2013,4,MI,986,1301,-315
2013,4,MN,1743,1478,265
2013,4,MO,1709,1704,5
2013,4,MS,5981,6101,-120
2013,4,MT,518,570,-52
2013,4,NC,8921,8855,66
2013,4,ND,2332,1788,544
2013,4,NE,530,539,-9
2013,4,NH,474,485,-11
2013,4,NJ,12359,11453,906
2013,4,NM,626,594,32
2013,4,NV,640,626,14
2013,4,NY,11905,10127,1778
2013,4,OH,2123,2165,-42
2013,4,OK,997,994,3
2013,4,OR,1777,1824,-47
2013,4,PA,3794,3787,7
2013,4,PR,675,775,-100
2013,4,RI,760,772,-12
2013,4,SC,12750,12561,189
2013,4,SD,402,452,-50
2013,4,TN,2194,2209,-15
2013,4,TX,39408,40369,-961
2013,4,UT,341,348,-7
2013,4,VA,6299,6210,89
2013,4,VI,103,102,1
2013,4,VT,243,232,11
2013,4,WA,2019,2104,-85
2013,4,WI,1168,1159,9
2013,4,WV,990,1037,-47
2013,4,WY,199,220,-21
2013,5,AK,165,154,11
2013,5,AL,3772,3846,-74
2013,5,AR,950,983,-33
2013,5,AZ,1250,1249,1
2013,5,CA,10234,10561,-327
2013,5,CO,1718,1518,200
2013,5,CT,1954,1733,221
2013,5,DC,95,76,19
2013,5,DE,1449,1380,69
2013,5,FL,157584,157818,-234
2013,5,GA,6346,6216,130
2013,5,GU,5,5,0
2013,5,HI,3550,3259,291
2013,5,IA,903,821,82
2013,5,ID,695,709,-14
2013,5,IL,2824,2193,631
2013,5,IN,1301,1232,69
2013,5,KS,638,654,-16
2013,5,KY,1126,1066,60
2013,5,LA,43329,43411,-82
2013,5,MA,2396,2228,168
2013,5,MD,3557,3317,240
2013,5,ME,454,460,-6
2013,5,MI,1032,955,77
2013,5,MN,672,562,110
2013,5,MO,1323,1259,64
2013,5,MS,6838,7064,-226
2013,5,MT,427,452,-25
2013,5,NC,9893,9752,141
2013,5,ND,738,459,279
2013,5,NE,489,507,-18
2013,5,NH,385,372,13
2013,5,NJ,12848,11817,1031
2013,5,NM,585,605,-20
2013,5,NV,615,583,32
2013,5,NY,12673,9957,2716
2013,5,OH,1739,1698,41
2013,5,OK,1013,997,16
2013,5,OR,1488,1463,25
2013,5,PA,3727,3627,100
2013,5,PR,538,842,-304
2013,5,RI,725,718,7
2013,5,SC,14847,14466,381
2013,5,SD,337,337,0
2013,5,TN,1886,1858,28
2013,5,TX,50655,51858,-1203
2013,5,UN,2,2,0
2013,5,UT,422,436,-14
2013,5,VA,7163,7127,36
2013,5,VI,35,37,-2
2013,5,VT,177,162,15
2013,5,WA,1923,1886,37
2013,5,WI,831,764,67
2013,5,WV,819,842,-23
2013,5,WY,194,213,-19
2013,6,AK,147,142,5
2013,6,AL,4142,4226,-84
2013,6,AR,1118,1199,-81
2013,6,AZ,1434,1479,-45
2013,6,CA,8903,9075,-172
2013,6,CO,1598,1452,146
2013,6,CT,2226,2040,186
2013,6,DC,370,362,8
2013,6,DE,1529,1461,68
2013,6,FL,178333,177635,698
2013,6,GA,7787,7835,-48
2013,6,GU,8,8,0
2013,6,HI,3601,3740,-139
2013,6,IA,827,776,51
2013,6,ID,311,345,-34
2013,6,IL,2484,2096,388
2013,6,IN,1176,1148,28
2013,6,KS,764,788,-24
2013,6,KY,1126,1125,1
2013,6,LA,52233,52896,-663
2013,6,MA,2794,2712,82
2013,6,MD,4664,4529,135
2013,6,ME,422,406,16
2013,6,MI,918,905,13
2013,6,MN,520,498,22
2013,6,MO,1307,1280,27
2013,6,MS,7740,7940,-200
2013,6,MT,554,589,-35
2013,6,NC,12117,12032,85
2013,6,ND,726,866,-140
2013,6,NE,512,535,-23
2013,6,NH,392,378,14
2013,6,NJ,13750,13129,621
2013,6,NM,562,602,-40
2013,6,NV,538,528,10
2013,6,NY,13150,10585,2565
2013,6,OH,1677,1676,1
2013,6,OK,1069,1034,35
2013,6,OR,1303,1308,-5
2013,6,PA,3462,3347,115
2013,6,PR,506,564,-58
2013,6,RI,892,899,-7
2013,6,SC,17070,16735,335
2013,6,SD,469,498,-29
2013,6,TN,3453,3659,-206
2013,6,TX,72674,74027,-1353
2013,6,UN,1,1,0
2013,6,UT,270,264,6
2013,6,VA,9809,9724,85
2013,6,VI,202,198,4
2013,6,VT,207,177,30
2013,6,WA,1638,1684,-46
2013,6,WI,714,701,13
2013,6,WV,797,809,-12
2013,6,WY,173,201,-28
2013,7,AK,159,152,7
2013,7,AL,4747,4791,-44
2013,7,AR,854,845,9
2013,7,AZ,1934,1823,111
2013,7,CA,9643,9878,-235
2013,7,CO,1361,1313,48
2013,7,CT,2599,2419,180
2013,7,DC,136,121,15
2013,7,DE,1732,1654,78
2013,7,FL,183999,182373,1626
2013,7,GA,9744,9325,419
2013,7,GU,1,2,-1
2013,7,HI,2639,2707,-68
2013,7,IA,1269,1302,-33
2013,7,ID,276,287,-11
2013,7,IL,2632,2198,434
2013,7,IN,1614,1600,14
2013,7,KS,815,845,-30
2013,7,KY,1169,1142,27
2013,7,LA,52123,52409,-286
2013,7,MA,3291,3232,59
2013,7,MD,5454,5106,348
2013,7,ME,539,503,36
2013,7,MI,999,987,12
2013,7,MN,639,629,10
2013,7,MO,1383,1389,-6
2013,7,MS,6629,6502,127
2013,7,MT,423,430,-7
2013,7,NC,13473,13261,212
2013,7,ND,528,537,-9
2013,7,NE,619,708,-89
2013,7,NH,552,512,40
2013,7,NJ,15290,14567,723
2013,7,NM,703,721,-18
2013,7,NV,588,564,24
2013,7,NY,14581,12106,2475
2013,7,OH,1843,1819,24
2013,7,OK,1216,1081,135
2013,7,OR,1427,1528,-101
2013,7,PA,3880,3786,94
2013,7,PR,546,737,-191
2013,7,RI,1156,1133,23
2013,7,SC,18773,18249,524
2013,7,SD,398,384,14
2013,7,TN,2328,2342,-14
2013,7,TX,100433,103919,-3486
2013,7,UT,282,268,14
2013,7,VA,11974,11747,227
2013,7,VI,47,39,8
2013,7,VT,229,196,33
2013,7,WA,1676,1707,-31
2013,7,WI,863,866,-3
2013,7,WV,905,914,-9
2013,7,WY,151,156,-5
2013,8,AK,160,152,8
2013,8,AL,4182,4136,46
2013,8,AR,856,881,-25
2013,8,AZ,2171,2085,86
2013,8,CA,9118,9350,-232
2013,8,CO,2008,2197,-189
2013,8,CT,2896,2489,407
2013,8,DC,459,453,6
2013,8,DE,1909,1836,73
2013,8,FL,157345,159986,-2641
2013,8,GA,9209,8935,274
2013,8,GU,8,9,-1
2013,8,HI,7332,7259,73
2013,8,IA,815,855,-40
2013,8,ID,306,303,3
2013,8,IL,2389,2307,82
2013,8,IN,1426,1434,-8
2013,8,KS,694,698,-4
2013,8,KY,1140,1123,17
2013,8,LA,43416,44146,-730
2013,8,MA,3989,3890,99
2013,8,MD,4442,4374,68
2013,8,ME,562,562,0
2013,8,MI,973,967,6
2013,8,MN,542,577,-35
2013,8,MO,1343,1382,-39
2013,8,MS,6174,6272,-98
2013,8,MT,308,279,29
2013,8,NC,13690,13348,342
2013,8,ND,610,650,-40
2013,8,NE,455,489,-34
2013,8,NH,381,354,27
2013,8,NJ,14974,14135,839
2013,8,NM,795,772,23
2013,8,NV,802,700,102
2013,8,NY,14978,13196,1782
2013,8,OH,2033,1919,114
2013,8,OK,1142,1130,12
2013,8,OR,1409,1498,-89
2013,8,PA,4463,4400,63
2013,8,PR,10343,10893,-550
2013,8,RI,1452,1360,92
2013,8,SC,17558,17163,395
2013,8,SD,431,401,30
2013,8,TN,2329,2318,11
2013,8,TX,73223,76579,-3356
2013,8,UT,242,236,6
2013,8,VA,11174,11383,-209
2013,8,VI,81,91,-10
2013,8,VT,204,165,39
2013,8,WA,1681,1697,-16
2013,8,WI,799,826,-27
2013,8,WV,903,917,-14
2013,8,WY,151,163,-12
2013,9,AK,182,164,18
2013,9,AL,3939,3909,30
2013,9,AR,873,862,11
2013,9,AZ,1958,2059,-101
2013,9,CA,10074,10077,-3
2013,9,CO,1765,1656,109
2013,9,CT,3079,2693,386
2013,9,DC,431,446,-15
2013,9,DE,1870,1845,25
2013,9,FL,141543,143598,-2055
2013,9,GA,7985,7909,76
2013,9,GU,7,7,0
2013,9,HI,4793,4744,49
2013,9,IA,889,938,-49
2013,9,ID,264,258,6
2013,9,IL,2034,2005,29
2013,9,IN,1244,1279,-35
2013,9,KS,636,616,20
2013,9,KY,1220,1222,-2
2013,9,LA,34678,35218,-540
2013,9,MA,3985,3911,74
2013,9,MD,4654,4657,-3
2013,9,ME,606,588,18
2013,9,MI,805,829,-24
2013,9,MN,530,542,-12
2013,9,MO,1209,1187,22
2013,9,MS,4674,4787,-113
2013,9,MT,259,224,35
2013,9,NC,11642,11695,-53
2013,9,ND,946,1040,-94
2013,9,NE,381,372,9
2013,9,NH,657,665,-8
2013,9,NJ,15367,15579,-212
2013,9,NM,718,714,4
2013,9,NV,666,621,45
2013,9,NY,18402,16968,1434
2013,9,OH,1970,1962,8
2013,9,OK,1021,1006,15
2013,9,OR,1793,2181,-388
2013,9,PA,4105,4094,11
2013,9,PR,731,969,-238
2013,9,RI,1400,1386,14
2013,9,SC,15504,15394,110
2013,9,SD,311,309,2
2013,9,TN,2279,2233,46
2013,9,TX,54868,56230,-1362
2013,9,UT,276,279,-3
2013,9,VA,10282,10701,-419
2013,9,VI,74,67,7
2013,9,VT,218,202,16
2013,9,WA,1984,2010,-26
2013,9,WI,805,808,-3
2013,9,WV,965,963,2
2013,9,WY,112,101,11
2013,10,AK,193,181,12
2013,10,AL,4325,4418,-93
2013,10,AR,788,818,-30
2013,10,AZ,1818,1773,45
2013,10,CA,14853,15116,-263
2013,10,CO,2089,1125,964
2013,10,CT,2686,2551,135
2013,10,DC,158,166,-8
2013,10,DE,2083,2104,-21
2013,10,FL,130609,133967,-3358
2013,10,GA,7375,7923,-548
2013,10,GU,2,3,-1
2013,10,HI,5657,5673,-16
2013,10,IA,719,753,-34
2013,10,ID,332,295,37
2013,10,IL,1960,1886,74
2013,10,IN,1268,1290,-22
2013,10,KS,590,584,6
2013,10,KY,1048,1075,-27
2013,10,LA,28912,29743,-831
2013,10,MA,4187,4161,26
2013,10,MD,4957,5094,-137
2013,10,ME,736,716,20
2013,10,MI,783,805,-22
2013,10,MN,525,535,-10
2013,10,MO,1061,1119,-58
2013,10,MS,4062,4230,-168
2013,10,MT,234,209,25
2013,10,NC,9519,9784,-265
2013,10,ND,855,931,-76
2013,10,NE,371,377,-6
2013,10,NH,515,529,-14
2013,10,NJ,13721,13976,-255
2013,10,NM,640,588,52
2013,10,NV,1087,1071,16
2013,10,NY,15911,15266,645
2013,10,OH,1981,2041,-60
2013,10,OK,1029,1083,-54
2013,10,OR,1968,2010,-42
2013,10,PA,5170,5451,-281
2013,10,PR,1176,1396,-220
2013,10,RI,1190,1169,21
2013,10,SC,13954,14117,-163
2013,10,SD,244,239,5
2013,10,TN,1957,2031,-74
2013,10,TX,45429,47031,-1602
2013,10,UT,309,284,25
2013,10,VA,9821,10205,-384
2013,10,VI,165,53,112
2013,10,VT,285,300,-15
2013,10,WA,3152,3261,-109
2013,10,WI,668,682,-14
2013,10,WV,861,906,-45
2013,10,WY,116,103,13
2013,11,AK,164,135,29
2013,11,AL,2716,2775,-59
2013,11,AR,700,733,-33
2013,11,AZ,1331,1323,8
2013,11,CA,17088,17744,-656
2013,11,CO,1308,1171,137
2013,11,CT,2558,2416,142
2013,11,DC,135,146,-11
2013,11,DE,1372,1366,6
2013,11,FL,101296,103909,-2613
2013,11,GA,5666,5818,-152
2013,11,GU,2,2,0
2013,11,HI,5195,5225,-30
2013,11,IA,518,536,-18
2013,11,ID,269,276,-7
2013,11,IL,1871,1754,117
2013,11,IN,1096,1138,-42
2013,11,KS,480,486,-6
2013,11,KY,992,1028,-36
2013,11,LA,22903,23514,-611
2013,11,MA,3274,3157,117
2013,11,MD,4082,4111,-29
2013,11,ME,569,561,8
2013,11,MI,673,707,-34
2013,11,MN,419,437,-18
2013,11,MO,999,1046,-47
2013,11,MS,3778,3947,-169
2013,11,MT,199,185,14
2013,11,NC,7549,7547,2
2013,11,ND,499,494,5
2013,11,NE,282,297,-15
2013,11,NH,507,511,-4
2013,11,NJ,12707,12310,397
2013,11,NM,476,468,8
2013,11,NV,694,695,-1
2013,11,NY,12170,11786,384
2013,11,OH,1663,1757,-94
2013,11,OK,830,844,-14
2013,11,OR,2118,2167,-49
2013,11,PA,3733,3960,-227
2013,11,PR,1205,1447,-242
2013,11,RI,774,787,-13
2013,11,SC,10345,10319,26
2013,11,SD,203,203,0
2013,11,TN,1643,1655,-12
2013,11,TX,33408,34721,-1313
2013,11,UT,256,258,-2
2013,11,VA,6906,7215,-309
2013,11,VI,32,31,1
2013,11,VT,264,264,0
2013,11,WA,3678,3872,-194
2013,11,WI,544,559,-15
2013,11,WV,737,810,-73
2013,11,WY,94,87,7
2013,12,AK,143,140,3
2013,12,AL,2873,3899,-1026
2013,12,AR,645,661,-16
2013,12,AZ,1301,1217,84
2013,12,CA,17610,19014,-1404
2013,12,CO,1154,975,179
2013,12,CT,2275,2275,0
2013,12,DC,145,139,6
2013,12,DE,1357,1390,-33
2013,12,FL,107134,111097,-3963
2013,12,GA,4521,4658,-137
2013,12,GU,5,5,0
2013,12,HI,3325,3369,-44
2013,12,IA,549,575,-26
2013,12,ID,266,277,-11
2013,12,IL,1589,1525,64
2013,12,IN,937,960,-23
2013,12,KS,467,494,-27
2013,12,KY,889,926,-37
2013,12,LA,23297,23946,-649
2013,12,MA,3025,3035,-10
2013,12,MD,4222,4318,-96
2013,12,ME,505,502,3
2013,12,MI,897,926,-29
2013,12,MN,345,368,-23
2013,12,MO,932,1017,-85
2013,12,MP,1,1,0
2013,12,MS,3479,3625,-146
2013,12,MT,193,191,2
2013,12,NC,6576,6807,-231
2013,12,ND,453,467,-14
2013,12,NE,361,386,-25
2013,12,NH,363,381,-18
2013,12,NJ,13102,13482,-380
2013,12,NM,538,545,-7
2013,12,NV,557,583,-26
2013,12,NY,12453,12308,145
2013,12,OH,1636,1683,-47
2013,12,OK,773,746,27
2013,12,OR,2073,2162,-89
2013,12,PA,3262,3464,-202
2013,12,PR,506,783,-277
2013,12,RI,671,647,24
2013,12,SC,9897,9885,12
2013,12,SD,229,236,-7
2013,12,TN,1466,1523,-57
2013,12,TX,27260,27958,-698
2013,12,UN,1,1,0
2013,12,UT,209,213,-4
2013,12,VA,5962,6184,-222
2013,12,VI,91,102,-11
2013,12,VT,165,182,-17
2013,12,WA,2959,3200,-241
2013,12,WI,487,485,2
2013,12,WV,667,707,-40
2013,12,WY,86,83,3
2014,1,AK,113,111,2
2014,1,AL,2004,2009,-5
2014,1,AR,561,596,-35
2014,1,AZ,1247,1199,48
2014,1,CA,14745,16011,-1266
2014,1,CO,968,850,118
2014,1,CT,1999,1931,68
2014,1,DC,154,97,57
2014,1,DE,1356,1351,5
2014,1,FL,101582,105472,-3890
2014,1,GA,4126,4110,16
2014,1,GU,3,5,-2
2014,1,HI,2529,2575,-46
2014,1,IA,542,564,-22
2014,1,ID,242,258,-16
2014,1,IL,1748,1729,19
2014,1,IN,925,888,37
2014,1,KS,461,449,12
2014,1,KY,756,770,-14
2014,1,LA,20168,20477,-309
2014,1,MA,2312,2261,51
2014,1,MD,3496,3540,-44
2014,1,ME,422,418,4
2014,1,MI,639,640,-1
2014,1,MN,332,332,0
2014,1,MO,802,804,-2
2014,1,MS,3142,3307,-165
2014,1,MT,228,205,23
2014,1,NC,6649,6704,-55
2014,1,ND,603,579,24
2014,1,NE,340,345,-5
2014,1,NH,330,312,18
2014,1,NJ,9954,10370,-416
2014,1,NM,522,517,5
2014,1,NV,660,704,-44
2014,1,NY,10569,10691,-122
2014,1,OH,1452,1450,2
2014,1,OK,640,619,21
2014,1,OR,1807,1931,-124
2014,1,PA,3573,3677,-104
2014,1,PR,606,892,-286
2014,1,RI,731,694,37
2014,1,SC,8954,8730,224
2014,1,SD,195,207,-12
2014,1,TN,1266,1268,-2
2014,1,TX,25044,25880,-836
2014,1,UT,162,162,0
2014,1,VA,4821,4842,-21
2014,1,VI,48,56,-8
2014,1,VT,162,167,-5
2014,1,WA,2280,2344,-64
2014,1,WI,565,588,-23
2014,1,WV,599,645,-46
2014,1,WY,72,80,-8
2014,2,AK,146,133,13
2014,2,AL,2951,3069,-118
2014,2,AR,740,754,-14
2014,2,AZ,1351,1292,59
2014,2,CA,14170,14843,-673
2014,2,CO,988,813,175
2014,2,CT,1348,1345,3
2014,2,DC,156,208,-52
2014,2,DE,982,964,18
2014,2,FL,94382,97257,-2875
2014,2,GA,4457,4544,-87
2014,2,GU,1,2,-1
2014,2,HI,5356,5360,-4
2014,2,IA,659,665,-6
2014,2,ID,389,411,-22
2014,2,IL,1982,1904,78
2014,2,IN,1121,1069,52
2014,2,KS,467,499,-32
2014,2,KY,909,957,-48
2014,2,LA,22955,23655,-700
2014,2,MA,2310,2045,265
2014,2,MD,2832,2865,-33
2014,2,ME,405,394,11
2014,2,MI,929,873,56
2014,2,MN,614,595,19
2014,2,MO,813,930,-117
2014,2,MS,3905,4039,-134
2014,2,MT,312,279,33
2014,2,NC,6655,6756,-101
2014,2,ND,851,899,-48
2014,2,NE,418,415,3
2014,2,NH,361,363,-2
2014,2,NJ,9788,9972,-184
2014,2,NM,438,444,-6
2014,2,NV,914,979,-65
2014,2,NY,10652,10595,57
2014,2,OH,1804,1793,11
2014,2,OK,629,641,-12
2014,2,OR,1781,1868,-87
2014,2,PA,4041,4173,-132
2014,2,PR,217,349,-132
2014,2,RI,758,743,15
2014,2,SC,8783,8691,92
2014,2,SD,247,252,-5
2014,2,TN,1400,1449,-49
2014,2,TX,28479,29587,-1108
2014,2,UN,1,1,0
2014,2,UT,322,333,-11
2014,2,VA,5018,5072,-54
2014,2,VI,71,76,-5
2014,2,VT,173,170,3
2014,2,WA,2095,2227,-132
2014,2,WI,543,519,24
2014,2,WV,865,931,-66
2014,2,WY,102,98,4
2014,3,AK,134,138,-4
2014,3,AL,2861,2920,-59
2014,3,AR,804,815,-11
2014,3,AZ,1234,1240,-6
2014,3,CA,11774,12375,-601
2014,3,CO,1380,1204,176
2014,3,CT,2140,2230,-90
2014,3,DC,153,124,29
2014,3,DE,1161,1156,5
2014,3,FL,119196,123280,-4084
2014,3,GA,5404,5431,-27
2014,3,GU,2,3,-1
2014,3,HI,3438,3515,-77
2014,3,IA,1345,1315,30
2014,3,ID,540,553,-13
2014,3,IL,3132,2399,733
2014,3,IN,1478,1303,175
2014,3,KS,592,595,-3
2014,3,KY,1071,1123,-52
2014,3,LA,29767,30422,-655
2014,3,MA,2534,2500,34
2014,3,MD,3951,3904,47
2014,3,ME,521,526,-5
2014,3,MI,1401,1023,378
2014,3,MN,1879,1854,25
2014,3,MO,1149,1209,-60
2014,3,MS,5113,5374,-261
2014,3,MT,494,440,54
2014,3,NC,8140,8324,-184
2014,3,ND,2705,3190,-485
2014,3,NE,548,489,59
2014,3,NH,421,429,-8
2014,3,NJ,10699,11479,-780
2014,3,NM,551,562,-11
2014,3,NV,888,934,-46
2014,3,NY,11368,11552,-184
2014,3,OH,2000,1982,18
2014,3,OK,853,839,14
2014,3,OR,1506,1608,-102
2014,3,PA,4578,4606,-28
2014,3,PR,235,529,-294
2014,3,RI,692,666,26
2014,3,SC,11379,11493,-114
2014,3,SD,450,501,-51
2014,3,TN,2074,2194,-120
2014,3,TX,31850,32951,-1101
2014,3,UN,2,2,0
2014,3,UT,284,294,-10
2014,3,VA,6681,6776,-95
2014,3,VI,64,63,1
2014,3,VT,235,247,-12
2014,3,WA,2280,2291,-11
2014,3,WI,954,841,113
2014,3,WV,912,1001,-89
2014,3,WY,125,112,13
2014,4,AK,200,219,-19
2014,4,AL,4582,4514,68
2014,4,AR,867,888,-21
2014,4,AZ,1288,1286,2
2014,4,CA,10802,11296,-494
2014,4,CO,1932,1379,553
2014,4,CT,1837,1883,-46
2014,4,DC,92,89,3
2014,4,DE,1357,1357,0
2014,4,FL,141516,145050,-3534
2014,4,GA,5427,5528,-101
2014,4,GU,2,3,-1
2014,4,HI,3486,3515,-29
2014,4,IA,1324,1328,-4
2014,4,ID,402,412,-10
2014,4,IL,2724,2731,-7
2014,4,IN,1419,1475,-56
2014,4,KS,763,779,-16
2014,4,KY,1132,1157,-25
2014,4,LA,37869,38781,-912
2014,4,MA,2376,2386,-10
2014,4,MD,3504,3505,-1
2014,4,ME,645,623,22
2014,4,MI,1137,960,177
2014,4,MN,1739,1705,34
2014,4,MO,1576,1676,-100
2014,4,MS,5713,5940,-227
2014,4,MT,856,504,352
2014,4,NC,8903,9098,-195
2014,4,ND,1782,2264,-482
2014,4,NE,614,538,76
2014,4,NH,452,468,-16
2014,4,NJ,11065,11466,-401
2014,4,NM,627,639,-12
2014,4,NV,634,660,-26
2014,4,NY,11355,11087,268
2014,4,OH,2022,2086,-64
2014,4,OK,940,980,-40
2014,4,OR,1713,1756,-43
2014,4,PA,3623,3736,-113
2014,4,PR,364,649,-285
2014,4,RI,750,770,-20
2014,4,SC,13021,13055,-34
2014,4,SD,389,388,1
2014,4,TN,2102,2148,-46
2014,4,TX,39071,40577,-1506
2014,4,UT,295,318,-23
2014,4,VA,5947,6110,-163
2014,4,VI,87,105,-18
2014,4,VT,246,234,12
2014,4,WA,1951,1959,-8
2014,4,WI,1197,1127,70
2014,4,WV,939,1000,-61
2014,4,WY,239,197,42
2014,5,AK,171,156,15
2014,5,AL,4212,4062,150
2014,5,AR,874,940,-66
2014,5,AZ,1284,1223,61
2014,5,CA,9581,9899,-318
2014,5,CO,2299,1758,541
2014,5,CT,1963,1916,47
2014,5,DC,137,101,36
2014,5,DE,1504,1428,76
2014,5,FL,147118,151422,-4304
2014,5,GA,6246,6405,-159
2014,5,GU,5,5,0
2014,5,HI,4180,4146,34
2014,5,IA,831,887,-56
2014,5,ID,635,670,-35
2014,5,IL,2622,2809,-187
2014,5,IN,1281,1302,-21
2014,5,KS,624,638,-14
2014,5,KY,1102,1082,20
2014,5,LA,41205,42514,-1309
2014,5,MA,3071,2695,376
2014,5,MD,3506,3457,49
2014,5,ME,446,425,21
2014,5,MI,1011,1041,-30
2014,5,MN,637,633,4
2014,5,MO,1260,1277,-17
2014,5,MS,6727,6999,-272
2014,5,MT,605,438,167
2014,5,NC,9892,9903,-11
2014,5,ND,521,730,-209
2014,5,NE,473,512,-39
2014,5,NH,431,416,15
2014,5,NJ,11459,11656,-197
2014,5,NM,584,581,3
2014,5,NV,575,605,-30
2014,5,NY,13439,12438,1001
2014,5,OH,1738,1767,-29
2014,5,OK,987,1000,-13
2014,5,OR,1336,1419,-83
2014,5,PA,3621,3691,-70
2014,5,PR,279,533,-254
2014,5,RI,870,873,-3
2014,5,SC,14506,14502,4
2014,5,SD,322,329,-7
2014,5,TN,1743,1855,-112
2014,5,TX,48995,50542,-1547
2014,5,UN,3,2,1
2014,5,UT,392,413,-21
2014,5,VA,6783,6959,-176
2014,5,VI,41,37,4
2014,5,VT,165,164,1
2014,5,WA,1762,1919,-157
2014,5,WI,750,819,-69
2014,5,WV,751,813,-62
2014,5,WY,214,191,23
2014,6,AK,151,142,9
2014,6,AL,4263,4084,179
2014,6,AR,1063,1144,-81
2014,6,AZ,1524,1482,42
2014,6,CA,8970,9096,-126
2014,6,CO,1953,1620,333
2014,6,CT,2021,2049,-28
2014,6,DC,386,370,16
2014,6,DE,1534,1547,-13
2014,6,FL,170305,173251,-2946
2014,6,GA,7497,7754,-257
2014,6,GU,7,9,-2
2014,6,HI,4174,4159,15
2014,6,IA,796,834,-38
2014,6,ID,314,328,-14
2014,6,IL,2620,2586,34
2014,6,IN,1171,1165,6
2014,6,KS,732,771,-39
2014,6,KY,1107,1111,-4
2014,6,LA,50220,51774,-1554
2014,6,MA,3460,3020,440
2014,6,MD,4675,4663,12
2014,6,ME,426,421,5
2014,6,MI,915,927,-12
2014,6,MN,531,559,-28
2014,6,MO,1189,1271,-82
2014,6,MS,7161,7572,-411
2014,6,MT,516,545,-29
2014,6,NC,11654,11921,-267
2014,6,ND,672,747,-75
2014,6,NE,514,528,-14
2014,6,NH,389,392,-3
2014,6,NJ,12982,13274,-292
2014,6,NM,536,566,-30
2014,6,NV,549,552,-3
2014,6,NY,13603,12860,743
2014,6,OH,1889,1710,179
2014,6,OK,1026,1081,-55
2014,6,OR,1377,1321,56
2014,6,PA,3440,3497,-57
2014,6,PR,285,501,-216
2014,6,RI,899,896,3
2014,6,SC,16610,16938,-328
2014,6,SD,454,471,-17
2014,6,TN,3024,3269,-245
2014,6,TX,69892,73075,-3183
2014,6,UT,252,266,-14
2014,6,VA,9328,9573,-245
2014,6,VI,138,199,-61
2014,6,VT,200,214,-14
2014,6,WA,1573,1645,-72
2014,6,WI,708,722,-14
2014,6,WV,732,785,-53
2014,6,WY,181,185,-4
2014,7,AK,160,156,4
2014,7,AL,4814,4645,169
2014,7,AR,863,866,-3
2014,7,AZ,1937,1917,20
2014,7,CA,9601,9609,-8
2014,7,CO,1565,1399,166
2014,7,CT,2363,2352,11
2014,7,DC,166,146,20
2014,7,DE,1695,1732,-37
2014,7,FL,175831,180918,-5087
2014,7,GA,9086,9530,-444
2014,7,GU,1,1,0
2014,7,HI,3556,3543,13
2014,7,IA,1230,1272,-42
2014,7,ID,257,271,-14
2014,7,IL,2478,2598,-120
2014,7,IN,1573,1605,-32
2014,7,KS,812,829,-17
2014,7,KY,1109,1195,-86
2014,7,LA,50889,52001,-1112
2014,7,MA,3681,3445,236
2014,7,MD,5227,5311,-84
2014,7,ME,535,539,-4
2014,7,MI,1000,1046,-46
2014,7,MN,733,665,68
2014,7,MO,1340,1369,-29
2014,7,MS,6451,6691,-240
2014,7,MT,386,415,-29
2014,7,NC,12944,13307,-363
2014,7,ND,554,641,-87
2014,7,NE,597,621,-24
2014,7,NH,531,562,-31
2014,7,NJ,14412,14756,-344
2014,7,NM,671,701,-30
2014,7,NV,606,614,-8
2014,7,NY,14052,14255,-203
2014,7,OH,2022,1884,138
2014,7,OK,1136,1199,-63
2014,7,OR,1368,1418,-50
2014,7,PA,3695,3849,-154
2014,7,PR,338,543,-205
2014,7,RI,1153,1167,-14
2014,7,SC,18121,18424,-303
2014,7,SD,399,390,9
2014,7,TN,2095,2158,-63
2014,7,TX,93732,99363,-5631
2014,7,UT,251,274,-23
2014,7,VA,11433,11804,-371
2014,7,VI,37,44,-7
2014,7,VT,219,231,-12
2014,7,WA,1700,1732,-32
2014,7,WI,820,849,-29
2014,7,WV,803,885,-82
2014,7,WY,145,160,-15
2014,8,AK,224,197,27
2014,8,AL,3946,3969,-23
2014,8,AR,847,860,-13
2014,8,AZ,2323,2261,62
2014,8,CA,9073,9200,-127
2014,8,CO,2023,2088,-65
2014,8,CT,2794,2885,-91
2014,8,DC,449,450,-1
2014,8,DE,1897,1902,-5
2014,8,FL,154275,158796,-4521
2014,8,GA,8929,9053,-124
2014,8,GU,4,7,-3
2014,8,HI,6972,6960,12
2014,8,IA,871,873,-2
2014,8,ID,316,302,14
2014,8,IL,2263,2342,-79
2014,8,IN,1390,1419,-29
2014,8,KS,649,678,-29
2014,8,KY,1097,1127,-30
2014,8,LA,42534,43462,-928
2014,8,MA,4426,4069,357
2014,8,MD,4745,4731,14
2014,8,ME,546,563,-17
2014,8,MI,952,957,-5
2014,8,MN,566,553,13
2014,8,MO,1315,1327,-12
2014,8,MS,5588,5787,-199
2014,8,MT,298,304,-6
2014,8,NC,12920,13347,-427
2014,8,ND,701,744,-43
2014,8,NE,464,482,-18
2014,8,NH,372,385,-13
2014,8,NJ,14305,14764,-459
2014,8,NM,766,785,-19
2014,8,NV,770,823,-53
2014,8,NY,14811,14874,-63
2014,8,OH,2100,2040,60
2014,8,OK,1054,1135,-81
2014,8,OR,1348,1424,-76
2014,8,PA,4331,4475,-144
2014,8,PR,505,10362,-9857
2014,8,RI,1667,1477,190
2014,8,SC,18206,18193,13
2014,8,SD,434,433,1
2014,8,TN,2143,2184,-41
2014,8,TX,69655,73025,-3370
2014,8,UT,222,238,-16
2014,8,VA,11193,11566,-373
2014,8,VI,71,85,-14
2014,8,VT,196,197,-1
2014,8,WA,1699,1711,-12
2014,8,WI,785,802,-17
2014,8,WV,839,918,-79
2014,8,WY,147,148,-1
2014,9,AK,163,171,-8
2014,9,AL,3904,4036,-132
2014,9,AR,895,917,-22
2014,9,AZ,2348,1998,350
2014,9,CA,9926,10277,-351
2014,9,CO,1770,1659,111
2014,9,CT,2801,2904,-103
2014,9,DC,429,432,-3
2014,9,DE,1848,1870,-22
2014,9,FL,134352,141056,-6704
2014,9,GA,7422,7719,-297
2014,9,GU,7,6,1
2014,9,HI,6207,5172,1035
2014,9,IA,869,888,-19
2014,9,ID,296,279,17
2014,9,IL,2002,2042,-40
2014,9,IN,1265,1286,-21
2014,9,KS,619,650,-31
2014,9,KY,1149,1218,-69
2014,9,LA,36307,37086,-779
2014,9,MA,4811,4112,699
2014,9,MD,4589,4610,-21
2014,9,ME,576,580,-4
2014,9,MI,1040,826,214
2014,9,MN,540,540,0
2014,9,MO,1141,1195,-54
2014,9,MS,4582,4695,-113
2014,9,MT,243,266,-23
2014,9,NC,11058,11335,-277
2014,9,ND,961,978,-17
2014,9,NE,404,394,10
2014,9,NH,597,624,-27
2014,9,NJ,14259,14528,-269
2014,9,NM,716,699,17
2014,9,NV,655,657,-2
2014,9,NY,16843,16880,-37
2014,9,OH,2030,2016,14
2014,9,OK,951,1032,-81
2014,9,OR,1691,1812,-121
2014,9,PA,3947,4121,-174
2014,9,PR,354,754,-400
2014,9,RI,1474,1479,-5
2014,9,SC,16215,16404,-189
2014,9,SD,307,314,-7
2014,9,TN,2071,2113,-42
2014,9,TX,52576,54766,-2190
2014,9,UT,316,282,34
2014,9,VA,9863,10223,-360
2014,9,VI,63,80,-17
2014,9,VT,219,218,1
2014,9,WA,1887,1958,-71
2014,9,WI,806,846,-40
2014,9,WV,833,909,-76
2014,9,WY,101,112,-11
2014,10,AK,181,190,-9
2014,10,AL,3432,3409,23
2014,10,AR,809,822,-13
2014,10,AZ,2854,1859,995
2014,10,CA,14894,14951,-57
2014,10,CO,1854,2061,-207
2014,10,CT,2529,2554,-25
2014,10,DC,166,158,8
2014,10,DE,1994,1974,20
2014,10,FL,126002,130520,-4518
2014,10,GA,7234,7435,-201
2014,10,GU,3,2,1
2014,10,HI,4923,4086,837
2014,10,IA,703,703,0
2014,10,ID,356,344,12
2014,10,IL,2037,2006,31
2014,10,IN,1315,1292,23
2014,10,KS,594,592,2
2014,10,KY,1040,1053,-13
2014,10,LA,28463,29014,-551
2014,10,MA,5412,4261,1151
2014,10,MD,4901,4930,-29
2014,10,ME,759,727,32
2014,10,MI,1013,829,184
2014,10,MN,560,556,4
2014,10,MO,1041,1054,-13
2014,10,MP,1,0,1
2014,10,MS,4031,4124,-93
2014,10,MT,220,236,-16
2014,10,NC,9237,9490,-253
2014,10,ND,816,843,-27
2014,10,NE,382,372,10
2014,10,NH,463,471,-8
2014,10,NJ,13739,13954,-215
2014,10,NM,653,652,1
2014,10,NV,741,1095,-354
2014,10,NY,15356,15118,238
2014,10,OH,2047,2035,12
2014,10,OK,989,1040,-51
2014,10,OR,2003,2053,-50
2014,10,PA,5038,5211,-173
2014,10,PR,356,1171,-815
2014,10,RI,1052,1072,-20
2014,10,SC,13812,13777,35
2014,10,SD,253,251,2
2014,10,TN,1992,1950,42
2014,10,TX,44256,45767,-1511
2014,10,UT,324,313,11
2014,10,VA,9950,10181,-231
2014,10,VI,59,165,-106
2014,10,VT,294,285,9
2014,10,WA,3037,3252,-215
2014,10,WI,643,678,-35
2014,10,WV,802,844,-42
2014,10,WY,100,116,-16
2014,11,AK,165,158,7
2014,11,AL,2768,2719,49
2014,11,AR,676,671,5
2014,11,AZ,1642,1371,271
2014,11,CA,16317,16882,-565
2014,11,CO,1179,1288,-109
2014,11,CT,2376,2395,-19
2014,11,DC,127,132,-5
2014,11,DE,1368,1356,12
2014,11,FL,93996,99609,-5613
2014,11,GA,5410,5639,-229
2014,11,GU,1,2,-1
2014,11,HI,3926,3898,28
2014,11,IA,513,507,6
2014,11,ID,267,274,-7
2014,11,IL,1696,1848,-152
2014,11,IN,1087,1067,20
2014,11,KS,490,495,-5
2014,11,KY,976,980,-4
2014,11,LA,22427,22985,-558
2014,11,MA,3873,3246,627
2014,11,MD,3895,3974,-79
2014,11,ME,566,575,-9
2014,11,MI,761,689,72
2014,11,MN,415,422,-7
2014,11,MO,980,997,-17
2014,11,MS,3756,3836,-80
2014,11,MT,218,200,18
2014,11,NC,7378,7439,-61
2014,11,ND,536,522,14
2014,11,NE,276,289,-13
2014,11,NH,490,505,-15
2014,11,NJ,12384,12485,-101
2014,11,NM,453,466,-13
2014,11,NV,665,689,-24
2014,11,NY,11675,11432,243
2014,11,OH,1614,1632,-18
2014,11,OK,808,841,-33
2014,11,OR,2133,2124,9
2014,11,PA,3630,3717,-87
2014,11,PR,223,1216,-993
2014,11,RI,790,776,14
2014,11,SC,10465,10312,153
2014,11,SD,222,222,0
2014,11,TN,1593,1629,-36
2014,11,TX,31922,32982,-1060
2014,11,UT,263,246,17
2014,11,VA,6749,6730,19
2014,11,VI,32,36,-4
2014,11,VT,269,269,0
2014,11,WA,3288,3446,-158
2014,11,WI,555,561,-6
2014,11,WV,716,745,-29
2014,11,WY,90,93,-3
2014,12,AK,118,129,-11
2014,12,AL,2794,2641,153
2014,12,AR,673,624,49
2014,12,AZ,1424,1338,86
2014,12,CA,16839,17374,-535
2014,12,CO,1147,1128,19
2014,12,CT,2279,2306,-27
2014,12,DC,136,147,-11
2014,12,DE,1336,1333,3
2014,12,FL,98148,105657,-7509
2014,12,GA,4484,4580,-96
2014,12,GU,3,5,-2
2014,12,HI,4323,4261,62
2014,12,IA,547,561,-14
2014,12,ID,258,268,-10
2014,12,IL,1577,1627,-50
2014,12,IN,1002,973,29
2014,12,KS,448,464,-16
2014,12,KY,892,922,-30
2014,12,LA,21028,21394,-366
2014,12,MA,3499,3166,333
2014,12,MD,4087,4098,-11
2014,12,ME,521,515,6
2014,12,MI,1003,932,71
2014,12,MN,375,372,3
2014,12,MO,909,898,11
2014,12,MP,1,1,0
2014,12,MS,3431,3527,-96
2014,12,MT,188,198,-10
2014,12,NC,6410,6525,-115
2014,12,ND,536,444,92
2014,12,NE,341,351,-10
2014,12,NH,343,347,-4
2014,12,NJ,10947,11128,-181
2014,12,NM,526,556,-30
2014,12,NV,567,560,7
2014,12,NY,12294,12233,61
2014,12,OH,1616,1651,-35
2014,12,OK,712,793,-81
2014,12,OR,1966,2055,-89
2014,12,PA,3299,3275,24
2014,12,PR,238,506,-268
2014,12,RI,677,689,-12
2014,12,SC,10305,10066,239
2014,12,SD,225,217,8
2014,12,TN,1445,1459,-14
2014,12,TX,26965,28215,-1250
2014,12,UN,1,1,0
2014,12,UT,238,225,13
2014,12,VA,6607,6754,-147
2014,12,VI,86,91,-5
2014,12,VT,158,163,-5
2014,12,WA,2904,2963,-59
2014,12,WI,473,500,-27
2014,12,WV,642,647,-5
2014,12,WY,94,89,5
2015,1,AK,129,128,1
2015,1,AL,2179,2116,63
2015,1,AR,562,579,-17
2015,1,AZ,1333,1300,33
2015,1,CA,15214,14748,466
2015,1,CO,1016,997,19
2015,1,CT,1862,1882,-20
2015,1,DC,136,154,-18
2015,1,DE,1400,1373,27
2015,1,FL,93539,100321,-6782
2015,1,GA,4522,4526,-4
2015,1,GU,3,3,0
2015,1,HI,3091,2935,156
2015,1,IA,517,518,-1
2015,1,ID,239,243,-4
2015,1,IL,1708,1740,-32
2015,1,IN,990,906,84
2015,1,KS,486,493,-7
2015,1,KY,766,768,-2
2015,1,LA,20297,20663,-366
2015,1,MA,2572,2453,119
2015,1,MD,3487,3482,5
2015,1,ME,425,415,10
2015,1,MI,706,655,51
2015,1,MN,330,339,-9
2015,1,MO,752,765,-13
2015,1,MS,3095,3187,-92
2015,1,MT,225,227,-2
2015,1,NC,6564,6663,-99
2015,1,ND,1108,442,666
2015,1,NE,329,321,8
2015,1,NH,310,322,-12
2015,1,NJ,9505,9671,-166
2015,1,NM,470,486,-16
2015,1,NV,653,651,2
2015,1,NY,10513,10382,131
2015,1,OH,1426,1438,-12
2015,1,OK,608,655,-47
2015,1,OR,1720,1755,-35
2015,1,PA,3450,3400,50
2015,1,PR,468,511,-43
2015,1,RI,733,734,-1
2015,1,SC,9062,8958,104
2015,1,SD,192,190,2
2015,1,TN,1211,1259,-48
2015,1,TX,24720,25355,-635
2015,1,UT,194,178,16
2015,1,VA,5370,5588,-218
2015,1,VI,47,49,-2
2015,1,VT,158,168,-10
2015,1,WA,2335,2279,56
2015,1,WI,640,569,71
2015,1,WV,565,606,-41
2015,1,WY,63,68,-5
2015,2,AK,129,130,-1
2015,2,AL,3247,3177,70
2015,2,AR,689,717,-28
2015,2,AZ,1385,1355,30
2015,2,CA,13689,14156,-467
2015,2,CO,919,931,-12
2015,2,CT,1335,1339,-4
2015,2,DC,148,151,-3
2015,2,DE,1003,1000,3
2015,2,FL,89400,93796,-4396
2015,2,GA,4356,4446,-90
2015,2,HI,5261,5223,38
2015,2,IA,641,664,-23
2015,2,ID,370,377,-7
2015,2,IL,1887,1973,-86
2015,2,IN,1137,1111,26
2015,2,KS,449,448,1
2015,2,KY,866,877,-11
2015,2,LA,22734,23173,-439
2015,2,MA,2604,2331,273
2015,2,MD,2915,2883,32
2015,2,ME,390,391,-1
2015,2,MI,845,935,-90
2015,2,MN,563,610,-47
2015,2,MO,794,839,-45
2015,2,MS,4009,4139,-130
2015,2,MT,312,308,4
2015,2,NC,6240,6401,-161
2015,2,ND,1241,839,402
2015,2,NE,380,397,-17
2015,2,NH,345,338,7
2015,2,NJ,9320,9483,-163
2015,2,NM,423,417,6
2015,2,NV,890,921,-31
2015,2,NY,10720,10710,10
2015,2,OH,1726,1766,-40
2015,2,OK,622,639,-17
2015,2,OR,1725,1768,-43
2015,2,PA,3992,4009,-17
2015,2,PR,145,206,-61
2015,2,RI,743,744,-1
2015,2,SC,8371,8386,-15
2015,2,SD,234,242,-8
2015,2,TN,1334,1381,-47
2015,2,TX,26639,27406,-767
2015,2,UN,1,1,0
2015,2,UT,321,317,4
2015,2,VA,4794,4861,-67
2015,2,VI,63,68,-5
2015,2,VT,163,160,3
2015,2,WA,2096,2114,-18
2015,2,WI,520,531,-11
2015,2,WV,794,837,-43
2015,2,WY,91,96,-5
2015,3,AK,128,136,-8
2015,3,AL,2933,2907,26
2015,3,AR,780,822,-42
2015,3,AZ,1302,1285,17
2015,3,CA,11973,12147,-174
2015,3,CO,1416,1352,64
2015,3,CT,1882,1880,2
2015,3,DC,159,147,12
2015,3,DE,1958,1944,14
2015,3,FL,112339,120178,-7839
2015,3,GA,5419,5513,-94
2015,3,GU,4,2,2
2015,3,HI,3329,2938,391
2015,3,IA,1188,1297,-109
2015,3,ID,511,525,-14
2015,3,IL,2864,3115,-251
2015,3,IN,1422,1443,-21
2015,3,KS,573,585,-12
2015,3,KY,1108,1120,-12
2015,3,LA,29419,29988,-569
2015,3,MA,3030,2593,437
2015,3,MD,4087,4131,-44
2015,3,ME,516,496,20
2015,3,MI,1153,1384,-231
2015,3,MN,1530,1849,-319
2015,3,MO,1189,1133,56
2015,3,MS,5105,5275,-170
2015,3,MT,450,492,-42
2015,3,NC,7913,8025,-112
2015,3,ND,2580,2734,-154
2015,3,NE,496,521,-25
2015,3,NH,459,401,58
2015,3,NJ,9960,10216,-256
2015,3,NM,587,570,17
2015,3,NV,858,895,-37
2015,3,NY,11632,11317,315
2015,3,OH,1934,1986,-52
2015,3,OK,863,921,-58
2015,3,OR,1980,1783,197
2015,3,PA,4514,4600,-86
2015,3,PR,159,227,-68
2015,3,RI,695,638,57
2015,3,SC,12145,11837,308
2015,3,SD,391,436,-45
2015,3,TN,1989,2070,-81
2015,3,TX,30381,31321,-940
2015,3,UN,2,2,0
2015,3,UT,272,287,-15
2015,3,VA,6768,6690,78
2015,3,VI,57,63,-6
2015,3,VT,234,232,2
2015,3,WA,2167,2217,-50
2015,3,WI,828,943,-115
2015,3,WV,880,905,-25
2015,3,WY,118,123,-5
2015,4,AK,174,186,-12
2015,4,AL,4201,4358,-157
2015,4,AR,820,880,-60
2015,4,AZ,1345,1356,-11
2015,4,CA,9394,10271,-877
2015,4,CO,1618,1898,-280
2015,4,CT,1780,1817,-37
2015,4,DC,103,96,7
2015,4,DE,1281,1281,0
2015,4,FL,130944,143560,-12616
2015,4,GA,5448,5741,-293
2015,4,GU,3,2,1
2015,4,HI,3585,3630,-45
2015,4,IA,1080,1274,-194
2015,4,ID,634,694,-60
2015,4,IL,2629,2991,-362
2015,4,IN,1335,1395,-60
2015,4,KS,671,751,-80
2015,4,KY,1109,1143,-34
2015,4,LA,34625,36643,-2018
2015,4,MA,2508,2477,31
2015,4,MD,3431,3611,-180
2015,4,ME,582,648,-66
2015,4,MI,1033,1122,-89
2015,4,MN,1223,1723,-500
2015,4,MO,1396,1587,-191
2015,4,MS,5234,5754,-520
2015,4,MT,483,846,-363
2015,4,NC,8466,8964,-498
2015,4,ND,1623,1833,-210
2015,4,NE,476,577,-101
2015,4,NH,437,452,-15
2015,4,NJ,10338,10818,-480
2015,4,NM,616,621,-5
2015,4,NV,546,593,-47
2015,4,NY,11031,11301,-270
2015,4,OH,1886,2032,-146
2015,4,OK,901,981,-80
2015,4,OR,1638,1775,-137
2015,4,PA,3419,3631,-212
2015,4,PR,174,368,-194
2015,4,RI,713,734,-21
2015,4,SC,12030,12885,-855
2015,4,SD,320,391,-71
2015,4,TN,2013,2111,-98
2015,4,TX,36021,38385,-2364
2015,4,UT,288,304,-16
2015,4,VA,5822,6108,-286
2015,4,VI,80,85,-5
2015,4,VT,231,254,-23
2015,4,WA,1785,1956,-171
2015,4,WI,940,1187,-247
2015,4,WV,866,935,-69
2015,4,WY,186,241,-55
2015,5,AK,159,181,-22
2015,5,AL,3748,3957,-209
2015,5,AR,808,891,-83
2015,5,AZ,1324,1334,-10
2015,5,CA,8737,9693,-956
2015,5,CO,2000,2260,-260
2015,5,CT,1755,1898,-143
2015,5,DC,116,129,-13
2015,5,DE,1706,1559,147
2015,5,FL,136725,148874,-12149
2015,5,GA,5810,6162,-352
2015,5,GU,4,5,-1
2015,5,HI,3889,4064,-175
2015,5,IA,775,843,-68
2015,5,ID,631,667,-36
2015,5,IL,2327,2578,-251
2015,5,IN,1259,1298,-39
2015,5,KS,619,634,-15
2015,5,KY,1092,1117,-25
2015,5,LA,39187,41441,-2254
2015,5,MA,2707,2859,-152
2015,5,MD,3439,3608,-169
2015,5,ME,416,452,-36
2015,5,MI,981,1022,-41
2015,5,MN,561,659,-98
2015,5,MO,1226,1310,-84
2015,5,MS,5968,6532,-564
2015,5,MT,395,598,-203
2015,5,NC,9270,9809,-539
2015,5,ND,521,544,-23
2015,5,NE,454,491,-37
2015,5,NH,399,412,-13
2015,5,NJ,11344,11771,-427
2015,5,NM,582,611,-29
2015,5,NV,513,548,-35
2015,5,NY,12631,12964,-333
2015,5,OH,1572,1728,-156
2015,5,OK,950,1007,-57
2015,5,OR,1214,1345,-131
2015,5,PA,3385,3603,-218
2015,5,PR,171,277,-106
2015,5,RI,701,736,-35
2015,5,SC,14122,14883,-761
2015,5,SD,294,327,-33
2015,5,TN,1630,1753,-123
2015,5,TX,46610,49043,-2433
2015,5,UN,3,3,0
2015,5,UT,355,391,-36
2015,5,VA,6626,7128,-502
2015,5,VI,55,42,13
2015,5,VT,182,182,0
2015,5,WA,1705,1797,-92
2015,5,WI,683,763,-80
2015,5,WV,664,745,-81
2015,5,WY,170,209,-39
2015,6,AK,151,161,-10
2015,6,AL,4012,4203,-191
2015,6,AR,982,1076,-94
2015,6,AZ,1625,1518,107
2015,6,CA,8868,9252,-384
2015,6,CO,2073,2040,33
2015,6,CT,1832,1988,-156
2015,6,DC,612,630,-18
2015,6,DE,1708,1584,124
2015,6,FL,155386,170690,-15304
2015,6,GA,7115,7595,-480
2015,6,GU,5,6,-1
2015,6,HI,4157,4101,56
2015,6,IA,758,819,-61
2015,6,ID,288,297,-9
2015,6,IL,2785,2917,-132
2015,6,IN,1201,1245,-44
2015,6,KS,739,744,-5
2015,6,KY,1108,1120,-12
2015,6,LA,46650,49675,-3025
2015,6,MA,3104,3328,-224
2015,6,MD,4007,4418,-411
2015,6,ME,413,441,-28
2015,6,MI,934,949,-15
2015,6,MN,475,526,-51
2015,6,MO,1200,1196,4
2015,6,MS,6481,7129,-648
2015,6,MT,474,528,-54
2015,6,NC,10859,11532,-673
2015,6,ND,669,712,-43
2015,6,NE,498,526,-28
2015,6,NH,380,395,-15
2015,6,NJ,12333,12771,-438
2015,6,NM,526,537,-11
2015,6,NV,503,530,-27
2015,6,NY,13265,13689,-424
2015,6,OH,1814,1908,-94
2015,6,OK,1321,1063,258
2015,6,OR,1329,1489,-160
2015,6,PA,3262,3422,-160
2015,6,PR,202,284,-82
2015,6,RI,822,891,-69
2015,6,SC,17328,17907,-579
2015,6,SD,381,451,-70
2015,6,TN,2736,2991,-255
2015,6,TX,71567,68991,2576
2015,6,UT,237,265,-28
2015,6,VA,8940,9660,-720
2015,6,VI,142,141,1
2015,6,VT,173,184,-11
2015,6,WA,1509,1639,-130
2015,6,WI,624,695,-71
2015,6,WV,665,761,-96
2015,6,WY,159,185,-26
2015,7,AK,153,159,-6
2015,7,AL,4890,5130,-240
2015,7,AR,785,854,-69
2015,7,AZ,2077,1945,132
2015,7,CA,9484,9645,-161
2015,7,CO,1743,1604,139
2015,7,CT,2203,2334,-131
2015,7,DC,182,168,14
2015,7,DE,1672,1686,-14
2015,7,FL,157624,172551,-14927
2015,7,GA,8535,8996,-461
2015,7,GU,1,1,0
2015,7,HI,2385,2413,-28
2015,7,IA,1100,1224,-124
2015,7,ID,248,257,-9
2015,7,IL,2431,2477,-46
2015,7,IN,1636,1654,-18
2015,7,KS,829,832,-3
2015,7,KY,1103,1107,-4
2015,7,LA,50140,52252,-2112
2015,7,MA,3395,3580,-185
2015,7,MD,9417,9400,17
2015,7,ME,508,548,-40
2015,7,MI,1246,1002,244
2015,7,MN,605,709,-104
2015,7,MO,1320,1353,-33
2015,7,MS,6024,6327,-303
2015,7,MT,363,418,-55
2015,7,NC,11918,12771,-853
2015,7,ND,460,501,-41
2015,7,NE,593,619,-26
2015,7,NH,541,562,-21
2015,7,NJ,13618,14077,-459
2015,7,NM,672,688,-16
2015,7,NV,593,595,-2
2015,7,NY,13676,14179,-503
2015,7,OH,2094,2012,82
2015,7,OK,1234,1153,81
2015,7,OR,1352,1418,-66
2015,7,PA,3526,3659,-133
2015,7,PR,234,342,-108
2015,7,RI,1021,1104,-83
2015,7,SC,18283,18898,-615
2015,7,SD,352,391,-39
2015,7,TN,2021,2118,-97
2015,7,TX,96393,93948,2445
2015,7,UT,253,252,1
2015,7,VA,10513,11279,-766
2015,7,VI,39,44,-5
2015,7,VT,212,219,-7
2015,7,WA,1590,1694,-104
2015,7,WI,737,810,-73
2015,7,WV,728,804,-76
2015,7,WY,133,139,-6
2015,8,AK,150,174,-24
2015,8,AL,3694,3926,-232
2015,8,AR,853,856,-3
2015,8,AZ,2206,2235,-29
2015,8,CA,10111,9115,996
2015,8,CO,1791,1974,-183
2015,8,CT,2576,2732,-156
2015,8,DC,248,485,-237
2015,8,DE,1857,1931,-74
2015,8,FL,135701,147784,-12083
2015,8,GA,8038,8812,-774
2015,8,GU,5,5,0
2015,8,HI,6866,6885,-19
2015,8,IA,752,836,-84
2015,8,ID,280,299,-19
2015,8,IL,2099,2264,-165
2015,8,IN,1443,1429,14
2015,8,KS,643,668,-25
2015,8,KY,1130,1107,23
2015,8,LA,39428,41734,-2306
2015,8,MA,4169,4310,-141
2015,8,MD,4778,4978,-200
2015,8,ME,494,538,-44
2015,8,MI,935,911,24
2015,8,MN,499,565,-66
2015,8,MO,1290,1323,-33
2015,8,MS,5227,5511,-284
2015,8,MT,275,298,-23
2015,8,NC,11773,12731,-958
2015,8,ND,565,642,-77
2015,8,NE,416,432,-16
2015,8,NH,368,361,7
2015,8,NJ,13269,13756,-487
2015,8,NM,759,771,-12
2015,8,NV,744,755,-11
2015,8,NY,14176,14995,-819
2015,8,OH,2118,2101,17
2015,8,OK,1004,1048,-44
2015,8,OR,1438,1469,-31
2015,8,PA,3947,4280,-333
2015,8,PR,247,493,-246
2015,8,RI,1542,1612,-70
2015,8,SC,16792,17388,-596
2015,8,SD,391,421,-30
2015,8,TN,2001,2114,-113
2015,8,TX,65374,69146,-3772
2015,8,UT,231,227,4
2015,8,VA,10141,10785,-644
2015,8,VI,68,67,1
2015,8,VT,180,198,-18
2015,8,WA,1560,1658,-98
2015,8,WI,720,787,-67
2015,8,WV,754,806,-52
2015,8,WY,153,153,0
2015,9,AK,179,167,12
2015,9,AL,3622,3774,-152
2015,9,AR,863,851,12
2015,9,AZ,2342,2359,-17
2015,9,CA,12973,10040,2933
2015,9,CO,1491,1602,-111
2015,9,CT,2657,2766,-109
2015,9,DC,397,427,-30
2015,9,DE,1934,1979,-45
2015,9,FL,125050,133325,-8275
2015,9,GA,7174,7477,-303
2015,9,GU,5,7,-2
2015,9,HI,7238,7174,64
2015,9,IA,812,864,-52
2015,9,ID,266,281,-15
2015,9,IL,1964,2107,-143
2015,9,IN,1190,1255,-65
2015,9,KS,584,621,-37
2015,9,KY,1120,1155,-35
2015,9,LA,32689,34087,-1398
2015,9,MA,4565,4708,-143
2015,9,MD,4287,4539,-252
2015,9,ME,538,580,-42
2015,9,MI,963,1026,-63
2015,9,MN,584,536,48
2015,9,MO,1086,1139,-53
2015,9,MS,4311,4585,-274
2015,9,MT,258,242,16
2015,9,NC,10539,11098,-559
2015,9,ND,880,972,-92
2015,9,NE,369,397,-28
2015,9,NH,529,569,-40
2015,9,NJ,13613,14186,-573
2015,9,NM,673,718,-45
2015,9,NV,649,654,-5
2015,9,NY,15740,16455,-715
2015,9,OH,1964,2041,-77
2015,9,OK,906,928,-22
2015,9,OR,1595,1594,1
2015,9,PA,3673,3927,-254
2015,9,PR,280,324,-44
2015,9,RI,1307,1374,-67
2015,9,SC,15190,15370,-180
2015,9,SD,278,303,-25
2015,9,TN,1820,2021,-201
2015,9,TX,50580,53355,-2775
2015,9,UT,281,310,-29
2015,9,VA,9147,9712,-565
2015,9,VI,63,72,-9
2015,9,VT,206,218,-12
2015,9,WA,1830,1908,-78
2015,9,WI,701,781,-80
2015,9,WV,750,836,-86
2015,9,WY,97,105,-8
2015,10,AK,183,188,-5
2015,10,AL,3199,3322,-123
2015,10,AR,801,817,-16
2015,10,AZ,2638,2805,-167
2015,10,CA,20655,15007,5648
2015,10,CO,1699,1832,-133
2015,10,CT,2472,2568,-96
2015,10,DC,172,170,2
2015,10,DE,1890,1947,-57
2015,10,FL,117031,124304,-7273
2015,10,GA,6880,7244,-364
2015,10,GU,1,3,-2
2015,10,HI,4296,4304,-8
2015,10,IA,695,713,-18
2015,10,ID,326,346,-20
2015,10,IL,1901,2014,-113
2015,10,IN,1315,1310,5
2015,10,KS,600,629,-29
2015,10,KY,1005,1014,-9
2015,10,LA,28919,29178,-259
2015,10,MA,5483,5518,-35
2015,10,MD,4537,4663,-126
2015,10,ME,727,749,-22
2015,10,MI,904,995,-91
2015,10,MN,501,533,-32
2015,10,MO,1097,1090,7
2015,10,MS,3908,4121,-213
2015,10,MT,249,239,10
2015,10,NC,9018,9219,-201
2015,10,ND,728,845,-117
2015,10,NE,360,380,-20
2015,10,NH,381,459,-78
2015,10,NJ,12635,13072,-437
2015,10,NM,624,644,-20
2015,10,NV,735,747,-12
2015,10,NY,15331,15631,-300
2015,10,OH,1926,1966,-40
2015,10,OK,921,951,-30
2015,10,OR,1909,1918,-9
2015,10,PA,4631,4965,-334
2015,10,PR,254,349,-95
2015,10,RI,975,1047,-72
2015,10,SC,14204,14493,-289
2015,10,SD,231,235,-4
2015,10,TN,1848,1970,-122
2015,10,TX,42897,44704,-1807
2015,10,UT,297,318,-21
2015,10,VA,9540,9703,-163
2015,10,VI,52,61,-9
2015,10,VT,260,293,-33
2015,10,WA,2739,2999,-260
2015,10,WI,644,646,-2
2015,10,WV,751,800,-49
2015,10,WY,110,118,-8
2015,11,AK,155,165,-10
2015,11,AL,2723,2724,-1
2015,11,AR,707,699,8
2015,11,AZ,1825,1640,185
2015,11,CA,40745,16589,24156
2015,11,CO,1129,1187,-58
2015,11,CT,2262,2379,-117
2015,11,DC,154,130,24
2015,11,DE,1341,1382,-41
2015,11,FL,91335,95413,-4078
2015,11,GA,5430,5370,60
2015,11,GU,1,1,0
2015,11,HI,3975,3983,-8
2015,11,IA,511,515,-4
2015,11,ID,280,272,8
2015,11,IL,1657,1713,-56
2015,11,IN,1172,1110,62
2015,11,KS,476,496,-20
2015,11,KY,982,992,-10
2015,11,LA,22971,22778,193
2015,11,MA,3871,3912,-41
2015,11,MD,3772,3934,-162
2015,11,ME,532,563,-31
2015,11,MI,723,755,-32
2015,11,MN,375,411,-36
2015,11,MO,972,987,-15
2015,11,MS,3622,3741,-119
2015,11,MT,198,216,-18
2015,11,NC,7787,7568,219
2015,11,ND,489,544,-55
2015,11,NE,273,269,4
2015,11,NH,438,489,-51
2015,11,NJ,12156,12195,-39
2015,11,NM,475,465,10
2015,11,NV,736,662,74
2015,11,NY,11415,11684,-269
2015,11,OH,1593,1620,-27
2015,11,OK,777,791,-14
2015,11,OR,2095,2087,8
2015,11,PA,3932,4110,-178
2015,11,PR,186,214,-28
2015,11,RI,794,806,-12
2015,11,SC,11882,10650,1232
2015,11,SD,193,211,-18
2015,11,TN,1626,1610,16
2015,11,TX,32791,32287,504
2015,11,UT,272,273,-1
2015,11,VA,6794,6934,-140
2015,11,VI,33,30,3
2015,11,VT,260,267,-7
2015,11,WA,3104,3273,-169
2015,11,WI,505,546,-41
2015,11,WV,672,714,-42
2015,11,WY,98,86,12
2015,12,AK,113,114,-1
2015,12,AL,2859,2888,-29
2015,12,AR,619,670,-51
2015,12,AZ,1701,1447,254
2015,12,CA,45181,17301,27880
2015,12,CO,1092,1118,-26
2015,12,CT,2159,2268,-109
2015,12,DC,125,129,-4
2015,12,DE,1323,1381,-58
2015,12,FL,96613,100351,-3738
2015,12,GA,4574,4515,59
2015,12,GU,2,3,-1
2015,12,HI,4272,4424,-152
2015,12,IA,536,555,-19
2015,12,ID,262,256,6
2015,12,IL,1538,1515,23
2015,12,IN,967,987,-20
2015,12,KS,455,457,-2
2015,12,KY,907,877,30
2015,12,LA,22748,22460,288
2015,12,MA,3557,3410,147
2015,12,MD,3682,3908,-226
2015,12,ME,478,513,-35
2015,12,MI,968,1015,-47
2015,12,MN,393,396,-3
2015,12,MO,936,967,-31
2015,12,MP,1,1,0
2015,12,MS,3398,3488,-90
2015,12,MT,184,184,0
2015,12,NC,6587,6636,-49
2015,12,ND,510,570,-60
2015,12,NE,328,347,-19
2015,12,NH,377,377,0
2015,12,NJ,10935,11132,-197
2015,12,NM,490,501,-11
2015,12,NV,679,600,79
2015,12,NY,12166,12411,-245
2015,12,OH,1602,1647,-45
2015,12,OK,687,693,-6
2015,12,OR,1946,1986,-40
2015,12,PA,3195,3356,-161
2015,12,PR,214,233,-19
2015,12,RI,942,905,37
2015,12,SC,11043,10656,387
2015,12,SD,218,220,-2
2015,12,TN,1465,1471,-6
2015,12,TX,27970,27422,548
2015,12,UN,1,1,0
2015,12,UT,212,228,-16
2015,12,VA,5627,5844,-217
2015,12,VI,86,86,0
2015,12,VT,164,170,-6
2015,12,WA,2926,2957,-31
2015,12,WI,483,476,7
2015,12,WV,623,655,-32
2015,12,WY,88,95,-7
2016,1,AK,141,146,-5
2016,1,AL,2432,2335,97
2016,1,AR,692,627,65
2016,1,AZ,1532,1323,209
2016,1,CA,26534,15426,11108
2016,1,CO,959,969,-10
2016,1,CT,1756,1855,-99
2016,1,DC,137,135,2
2016,1,DE,1342,1382,-40
2016,1,FL,93684,96412,-2728
2016,1,GA,4488,4370,118
2016,1,GU,2,3,-1
2016,1,HI,2527,2460,67
2016,1,IA,483,512,-29
2016,1,ID,236,233,3
2016,1,IL,1740,1693,47
2016,1,IN,980,992,-12
2016,1,KS,480,482,-2
2016,1,KY,817,794,23
2016,1,LA,20437,19453,984
2016,1,MA,2389,2406,-17
2016,1,MD,3405,3527,-122
2016,1,ME,395,417,-22
2016,1,MI,725,709,16
2016,1,MN,316,327,-11
2016,1,MO,938,851,87
2016,1,MS,3168,3084,84
2016,1,MT,234,245,-11
2016,1,NC,6476,6599,-123
2016,1,ND,787,1048,-261
2016,1,NE,337,354,-17
2016,1,NH,303,306,-3
2016,1,NJ,8999,9293,-294
2016,1,NM,470,479,-9
2016,1,NV,683,653,30
2016,1,NY,10215,10282,-67
2016,1,OH,1335,1361,-26
2016,1,OK,611,596,15
2016,1,OR,1995,1714,281
2016,1,PA,3348,3470,-122
2016,1,PR,434,468,-34
2016,1,RI,744,743,1
2016,1,SC,9237,9078,159
2016,1,SD,173,193,-20
2016,1,TN,1192,1184,8
2016,1,TX,24548,24453,95
2016,1,UT,176,181,-5
2016,1,VA,4254,4466,-212
2016,1,VI,35,46,-11
2016,1,VT,161,154,7
2016,1,WA,2432,2371,61
2016,1,WI,637,648,-11
2016,1,WV,564,583,-19
2016,1,WY,57,62,-5
2016,2,AK,116,121,-5
2016,2,AL,3161,3090,71
2016,2,AR,697,700,-3
2016,2,AZ,1572,1387,185
2016,2,CA,17981,13774,4207
2016,2,CO,920,914,6
2016,2,CT,1327,1329,-2
2016,2,DC,146,152,-6
2016,2,DE,935,970,-35
2016,2,FL,88203,91116,-2913
2016,2,GA,4988,4969,19
2016,2,GU,2,0,2
2016,2,HI,5227,4933,294
2016,2,IA,608,618,-10
2016,2,ID,377,373,4
2016,2,IL,1989,1896,93
2016,2,IN,1101,1121,-20
2016,2,KS,449,458,-9
2016,2,KY,856,889,-33
2016,2,LA,25183,24321,862
2016,2,MA,2745,2601,144
2016,2,MD,2710,2801,-91
2016,2,ME,386,384,2
2016,2,MI,813,825,-12
2016,2,MN,559,569,-10
2016,2,MO,930,820,110
2016,2,MP,2,0,2
2016,2,MS,3714,3829,-115
2016,2,MT,326,336,-10
2016,2,NC,6377,6431,-54
2016,2,ND,946,1229,-283
2016,2,NE,361,384,-23
2016,2,NH,300,346,-46
2016,2,NJ,9469,9756,-287
2016,2,NM,427,423,4
2016,2,NV,878,881,-3
2016,2,NY,10916,11107,-191
2016,2,OH,1637,1718,-81
2016,2,OK,623,630,-7
2016,2,OR,1559,1708,-149
2016,2,PA,3831,3970,-139
2016,2,PR,119,148,-29
2016,2,RI,741,756,-15
2016,2,SC,9099,8848,251
2016,2,SD,216,234,-18
2016,2,TN,1402,1406,-4
2016,2,TX,25075,25422,-347
2016,2,UN,1,1,0
2016,2,UT,320,322,-2
2016,2,VA,4719,4888,-169
2016,2,VI,61,63,-2
2016,2,VT,183,163,20
2016,2,WA,2145,2165,-20
2016,2,WI,533,524,9
2016,2,WV,755,808,-53
2016,2,WY,93,95,-2
2016,3,AK,120,124,-4
2016,3,AL,2841,2829,12
2016,3,AR,772,764,8
2016,3,AZ,1413,1416,-3
2016,3,CA,12595,12162,433
2016,3,CO,1346,1403,-57
2016,3,CT,1812,1883,-71
2016,3,DC,149,155,-6
2016,3,DE,1178,1200,-22
2016,3,FL,108092,112152,-4060
2016,3,GA,5294,5447,-153
2016,3,GU,6,7,-1
2016,3,HI,3624,3795,-171
2016,3,IA,1089,1196,-107
2016,3,ID,505,492,13
2016,3,IL,2428,2843,-415
2016,3,IN,1382,1428,-46
2016,3,KS,584,569,15
2016,3,KY,1096,1056,40
2016,3,LA,32754,32414,340
2016,3,MA,3509,3174,335
2016,3,MD,3880,3958,-78
2016,3,ME,474,524,-50
2016,3,MI,1084,1143,-59
2016,3,MN,1330,1526,-196
2016,3,MO,1291,1199,92
2016,3,MS,4752,4865,-113
2016,3,MT,576,430,146
2016,3,NC,7826,8012,-186
2016,3,ND,2172,2477,-305
2016,3,NE,525,517,8
2016,3,NH,410,466,-56
2016,3,NJ,9879,9933,-54
2016,3,NM,589,592,-3
2016,3,NV,737,836,-99
2016,3,NY,11164,11387,-223
2016,3,OH,1820,1949,-129
2016,3,OK,784,823,-39
2016,3,OR,1689,1728,-39
2016,3,PA,4799,4937,-138
2016,3,PR,135,169,-34
2016,3,RI,655,682,-27
2016,3,SC,12328,12064,264
2016,3,SD,376,390,-14
2016,3,TN,1932,2023,-91
2016,3,TX,30806,31346,-540
2016,3,UT,263,256,7
2016,3,VA,6147,6440,-293
2016,3,VI,58,53,5
2016,3,VT,238,236,2
2016,3,WA,2114,2172,-58
2016,3,WI,764,819,-55
2016,3,WV,776,859,-83
2016,3,WY,168,165,3
2016,4,AK,161,178,-17
2016,4,AL,4265,4314,-49
2016,4,AR,900,821,79
2016,4,AZ,1377,1392,-15
2016,4,CA,10254,10191,63
2016,4,CO,1582,1623,-41
2016,4,CT,1759,1863,-104
2016,4,DC,117,112,5
2016,4,DE,1259,1279,-20
2016,4,FL,124321,129144,-4823
2016,4,GA,5900,6009,-109
2016,4,GU,2,3,-1
2016,4,HI,3850,3649,201
2016,4,IA,1007,1089,-82
2016,4,ID,354,351,3
2016,4,IL,2327,2324,3
2016,4,IN,1408,1446,-38
2016,4,KS,672,673,-1
2016,4,KY,1083,1073,10
2016,4,LA,38647,35503,3144
2016,4,MA,2793,2573,220
2016,4,MD,3232,3345,-113
2016,4,ME,532,570,-38
2016,4,MI,980,1006,-26
2016,4,MN,1119,1218,-99
2016,4,MO,1440,1388,52
2016,4,MS,5298,5306,-8
2016,4,MT,426,474,-48
2016,4,NC,8367,8546,-179
2016,4,ND,1361,1530,-169
2016,4,NE,532,498,34
2016,4,NH,402,444,-42
2016,4,NJ,10209,10408,-199
2016,4,NM,556,590,-34
2016,4,NV,551,531,20
2016,4,NY,10825,10997,-172
2016,4,OH,1881,1937,-56
2016,4,OK,897,894,3
2016,4,OR,1604,1627,-23
2016,4,PA,3476,3508,-32
2016,4,PR,162,194,-32
2016,4,RI,655,716,-61
2016,4,SC,11813,11709,104
2016,4,SD,311,305,6
2016,4,TN,2082,2057,25
2016,4,TX,36188,35797,391
2016,4,UT,273,287,-14
2016,4,VA,6063,6210,-147
2016,4,VI,77,82,-5
2016,4,VT,219,236,-17
2016,4,WA,1908,1904,4
2016,4,WI,884,934,-50
2016,4,WV,834,891,-57
2016,4,WY,184,192,-8
2016,5,AK,138,151,-13
2016,5,AL,3856,3887,-31
2016,5,AR,796,792,4
2016,5,AZ,1372,1386,-14
2016,5,CA,9209,9342,-133
2016,5,CO,1914,1998,-84
2016,5,CT,1800,1859,-59
2016,5,DC,107,119,-12
2016,5,DE,1595,1666,-71
2016,5,FL,129138,134154,-5016
2016,5,GA,5779,5860,-81
2016,5,GU,4,4,0
2016,5,HI,3583,3667,-84
2016,5,IA,745,771,-26
2016,5,ID,616,615,1
2016,5,IL,2242,2338,-96
2016,5,IN,1222,1244,-22
2016,5,KS,632,640,-8
2016,5,KY,1111,1108,3
2016,5,LA,41141,39917,1224
2016,5,MA,2972,2749,223
2016,5,MD,3227,3321,-94
2016,5,ME,409,417,-8
2016,5,MI,904,950,-46
2016,5,MN,551,577,-26
2016,5,MO,1170,1204,-34
2016,5,MS,5853,5974,-121
2016,5,MT,363,391,-28
2016,5,NC,9400,9688,-288
2016,5,ND,430,500,-70
2016,5,NE,468,462,6
2016,5,NH,366,400,-34
2016,5,NJ,10971,11247,-276
2016,5,NM,518,550,-32
2016,5,NV,609,512,97
2016,5,NY,12451,12578,-127
2016,5,OH,1513,1589,-76
2016,5,OK,929,955,-26
2016,5,OR,1443,1257,186
2016,5,PA,3575,3399,176
2016,5,PR,164,189,-25
2016,5,RI,678,702,-24
2016,5,SC,13948,14310,-362
2016,5,SD,317,318,-1
2016,5,TN,1652,1692,-40
2016,5,TX,53918,46248,7670
2016,5,UN,3,4,-1
2016,5,UT,351,353,-2
2016,5,VA,6535,6731,-196
2016,5,VI,43,59,-16
2016,5,VT,171,177,-6
2016,5,WA,1677,1703,-26
2016,5,WI,667,696,-29
2016,5,WV,613,671,-58
2016,5,WY,170,172,-2
2016,6,AK,141,150,-9
2016,6,AL,4049,4118,-69
2016,6,AR,949,980,-31
2016,6,AZ,1614,1652,-38
2016,6,CA,8607,9031,-424
2016,6,CO,1830,1981,-151
2016,6,CT,1805,1864,-59
2016,6,DC,364,369,-5
2016,6,DE,1639,1674,-35
2016,6,FL,148350,154296,-5946
2016,6,GA,7065,7210,-145
2016,6,GU,4,5,-1
2016,6,HI,5213,5221,-8
2016,6,IA,721,740,-19
2016,6,ID,286,293,-7
2016,6,IL,2224,2342,-118
2016,6,IN,1254,1187,67
2016,6,KS,702,709,-7
2016,6,KY,1116,1130,-14
2016,6,LA,47265,46571,694
2016,6,MA,3322,3156,166
2016,6,MD,3892,4101,-209
2016,6,ME,427,441,-14
2016,6,MI,920,957,-37
2016,6,MN,472,485,-13
2016,6,MO,1145,1194,-49
2016,6,MS,6536,6539,-3
2016,6,MT,450,473,-23
2016,6,NC,10803,11081,-278
2016,6,ND,645,683,-38
2016,6,NE,512,498,14
2016,6,NH,337,365,-28
2016,6,NJ,12449,12663,-214
2016,6,NM,502,512,-10
2016,6,NV,534,542,-8
2016,6,NY,13011,13108,-97
2016,6,OH,1720,1814,-94
2016,6,OK,1100,1277,-177
2016,6,OR,1298,1345,-47
2016,6,PA,3201,3330,-129
2016,6,PR,165,200,-35
2016,6,RI,811,842,-31
2016,6,SC,16196,16265,-69
2016,6,SD,360,383,-23
2016,6,TN,2627,2791,-164
2016,6,TX,75669,71358,4311
2016,6,UT,223,239,-16
2016,6,VA,8369,8759,-390
2016,6,VI,129,137,-8
2016,6,VT,164,169,-5
2016,6,WA,1462,1539,-77
2016,6,WI,615,646,-31
2016,6,WV,623,652,-29
2016,6,WY,136,146,-10
2016,7,AK,157,159,-2
2016,7,AL,4472,4548,-76
2016,7,AR,782,781,1
2016,7,AZ,1940,2040,-100
2016,7,CA,9111,9761,-650
2016,7,CO,1554,1707,-153
2016,7,CT,2128,2179,-51
2016,7,DC,161,168,-7
2016,7,DE,1778,1640,138
2016,7,FL,154037,157955,-3918
2016,7,GA,8425,8611,-186
2016,7,HI,2394,2399,-5
2016,7,IA,1008,1069,-61
2016,7,ID,246,256,-10
2016,7,IL,2202,2369,-167
2016,7,IN,1630,1583,47
2016,7,KS,733,780,-47
2016,7,KY,1074,1069,5
2016,7,LA,49310,48101,1209
2016,7,MA,3473,3450,23
2016,7,MD,5386,5547,-161
2016,7,ME,509,523,-14
2016,7,MI,1144,1217,-73
2016,7,MN,559,594,-35
2016,7,MO,1208,1303,-95
2016,7,MS,6347,6416,-69
2016,7,MT,304,324,-20
2016,7,NC,11826,11974,-148
2016,7,ND,426,470,-44
2016,7,NE,583,581,2
2016,7,NH,457,486,-29
2016,7,NJ,13314,13572,-258
2016,7,NM,651,671,-20
2016,7,NV,537,601,-64
2016,7,NY,12847,13188,-341
2016,7,OH,1937,2052,-115
2016,7,OK,1112,1188,-76
2016,7,OR,1265,1311,-46
2016,7,PA,3334,3536,-202
2016,7,PR,200,240,-40
2016,7,RI,964,1001,-37
2016,7,SC,17667,17501,166
2016,7,SD,295,335,-40
2016,7,TN,1927,1980,-53
2016,7,TX,100182,93936,6246
2016,7,UT,234,244,-10
2016,7,VA,9883,10371,-488
2016,7,VI,31,33,-2
2016,7,VT,198,210,-12
2016,7,WA,1651,1674,-23
2016,7,WI,714,734,-20
2016,7,WV,757,738,19
2016,7,WY,121,130,-9
2016,8,AK,156,159,-3
2016,8,AL,3720,3816,-96
2016,8,AR,817,844,-27
2016,8,AZ,2025,2164,-139
2016,8,CA,9337,10494,-1157
2016,8,CO,1630,1773,-143
2016,8,CT,2529,2608,-79
2016,8,DC,205,212,-7
2016,8,DE,1791,1823,-32
2016,8,FL,130262,135254,-4992
2016,8,GA,7708,8010,-302
2016,8,GU,3,4,-1
2016,8,HI,7521,7541,-20
2016,8,IA,730,770,-40
2016,8,ID,259,275,-16
2016,8,IL,2060,2112,-52
2016,8,IN,1385,1450,-65
2016,8,KS,643,627,16
2016,8,KY,1147,1137,10
2016,8,LA,41432,39830,1602
2016,8,MA,4253,4281,-28
2016,8,MD,4243,4338,-95
2016,8,ME,491,510,-19
2016,8,MI,947,988,-41
2016,8,MN,498,520,-22
2016,8,MO,1275,1294,-19
2016,8,MS,5155,5280,-125
2016,8,MT,265,295,-30
2016,8,NC,11638,11857,-219
2016,8,ND,516,543,-27
2016,8,NE,400,428,-28
2016,8,NH,340,355,-15
2016,8,NJ,13420,13420,0
2016,8,NM,826,774,52
2016,8,NV,730,773,-43
2016,8,NY,13126,13500,-374
2016,8,OH,1956,2127,-171
2016,8,OK,945,987,-42
2016,8,OR,1322,1373,-51
2016,8,PA,4085,4230,-145
2016,8,PR,176,240,-64
2016,8,RI,1501,1580,-79
2016,8,SC,16902,16599,303
2016,8,SD,334,392,-58
2016,8,TN,1953,1993,-40
2016,8,TX,64911,65769,-858
2016,8,UT,214,228,-14
2016,8,VA,9679,10228,-549
2016,8,VI,64,63,1
2016,8,VT,225,225,0
2016,8,WA,1641,1617,24
2016,8,WI,685,712,-27
2016,8,WV,865,782,83
2016,8,WY,140,155,-15
2016,9,AK,192,194,-2
2016,9,AL,4117,3740,377
2016,9,AR,846,839,7
2016,9,AZ,2293,2289,4
2016,9,CA,10992,13038,-2046
2016,9,CO,1443,1441,2
2016,9,CT,2502,2649,-147
2016,9,DC,190,430,-240
2016,9,DE,1798,1802,-4
2016,9,FL,123112,123947,-835
2016,9,GA,7146,7026,120
2016,9,GU,3,5,-2
2016,9,HI,6669,6476,193
2016,9,IA,820,803,17
2016,9,ID,275,276,-1
2016,9,IL,1794,1826,-32
2016,9,IN,1248,1204,44
2016,9,KS,590,556,34
2016,9,KY,1089,1112,-23
2016,9,LA,65479,44827,20652
2016,9,MA,4476,4559,-83
2016,9,MD,4385,4300,85
2016,9,ME,538,529,9
2016,9,MI,971,985,-14
2016,9,MN,514,575,-61
2016,9,MO,1057,1052,5
2016,9,MS,5072,4581,491
2016,9,MT,247,259,-12
2016,9,NC,10813,10627,186
2016,9,ND,812,894,-82
2016,9,NE,361,380,-19
2016,9,NH,518,539,-21
2016,9,NJ,13328,13431,-103
2016,9,NM,692,647,45
2016,9,NV,611,652,-41
2016,9,NY,15194,15616,-422
2016,9,OH,1913,1957,-44
2016,9,OK,885,912,-27
2016,9,OR,1570,1572,-2
2016,9,PA,3913,3836,77
2016,9,PR,225,282,-57
2016,9,RI,1250,1313,-63
2016,9,SC,15255,15004,251
2016,9,SD,262,274,-12
2016,9,TN,1836,1799,37
2016,9,TX,53011,49532,3479
2016,9,UT,260,274,-14
2016,9,VA,9153,9132,21
2016,9,VI,60,61,-1
2016,9,VT,215,211,4
2016,9,WA,1896,1854,42
2016,9,WI,700,709,-9
2016,9,WV,823,766,57
2016,9,WY,92,95,-3
2016,10,AK,166,179,-13
2016,10,AL,3272,3176,96
2016,10,AR,840,830,10
2016,10,AZ,2216,2536,-320
2016,10,CA,16341,20412,-4071
2016,10,CO,1550,1664,-114
2016,10,CT,2319,2416,-97
2016,10,DC,155,181,-26
2016,10,DE,1819,1880,-61
2016,10,FL,113410,115891,-2481
2016,10,GA,6602,6584,18
2016,10,GU,2,1,1
2016,10,HI,4876,4868,8
2016,10,IA,702,692,10
2016,10,ID,308,327,-19
2016,10,IL,1839,1884,-45
2016,10,IN,1212,1283,-71
2016,10,KS,572,569,3
2016,10,KY,932,1020,-88
2016,10,LA,38781,29545,9236
2016,10,MA,5227,5270,-43
2016,10,MD,4725,4863,-138
2016,10,ME,733,742,-9
2016,10,MI,851,880,-29
2016,10,MN,508,505,3
2016,10,MO,1048,1045,3
2016,10,MS,3795,3781,14
2016,10,MT,216,230,-14
2016,10,NC,9316,9247,69
2016,10,ND,661,715,-54
2016,10,NE,334,348,-14
2016,10,NH,361,374,-13
2016,10,NJ,12414,12695,-281
2016,10,NM,616,622,-6
2016,10,NV,642,731,-89
2016,10,NY,14327,14897,-570
2016,10,OH,1836,1888,-52
2016,10,OK,865,909,-44
2016,10,OR,1776,1902,-126
2016,10,PA,4352,4600,-248
2016,10,PR,159,251,-92
2016,10,RI,1085,1132,-47
2016,10,SC,14034,13814,220
2016,10,SD,208,231,-23
2016,10,TN,1749,1832,-83
2016,10,TX,42241,42320,-79
2016,10,UT,266,290,-24
2016,10,VA,9123,9325,-202
2016,10,VI,43,50,-7
2016,10,VT,234,253,-19
2016,10,WA,2481,2726,-245
2016,10,WI,608,640,-32
2016,10,WV,711,762,-51
2016,10,WY,97,103,-6
2016,11,AK,142,155,-13
2016,11,AL,2890,2668,222
2016,11,AR,679,712,-33
2016,11,AZ,1551,1784,-233
2016,11,CA,22404,40207,-17803
2016,11,CO,1043,1120,-77
2016,11,CT,2143,2208,-65
2016,11,DC,146,155,-9
2016,11,DE,1339,1342,-3
2016,11,FL,91624,91801,-177
2016,11,GA,5327,5390,-63
2016,11,GU,1,1,0
2016,11,HI,3946,3903,43
2016,11,IA,522,530,-8
2016,11,ID,256,262,-6
2016,11,IL,1554,1653,-99
2016,11,IN,1018,1132,-114
2016,11,KS,470,466,4
2016,11,KY,947,996,-49
2016,11,LA,28056,24285,3771
2016,11,MA,3819,3877,-58
2016,11,MD,3730,3668,62
2016,11,ME,514,534,-20
2016,11,MI,712,735,-23
2016,11,MN,407,414,-7
2016,11,MO,942,979,-37
2016,11,MS,3551,3611,-60
2016,11,MT,180,191,-11
2016,11,NC,8274,7722,552
2016,11,ND,425,467,-42
2016,11,NE,342,363,-21
2016,11,NH,461,463,-2
2016,11,NJ,12041,12417,-376
2016,11,NM,478,471,7
2016,11,NV,609,751,-142
2016,11,NY,10883,11224,-341
2016,11,OH,1480,1599,-119
2016,11,OK,699,762,-63
2016,11,OR,2135,2162,-27
2016,11,PA,3247,3408,-161
2016,11,PR,144,192,-48
2016,11,RI,716,766,-50
2016,11,SC,12257,11997,260
2016,11,SD,180,179,1
2016,11,TN,1646,1626,20
2016,11,TX,32526,33237,-711
2016,11,UT,267,268,-1
2016,11,VA,7206,6487,719
2016,11,VI,31,33,-2
2016,11,VT,238,258,-20
2016,11,WA,3051,3076,-25
2016,11,WI,471,491,-20
2016,11,WV,640,674,-34
2016,11,WY,90,96,-6
2016,12,AK,100,113,-13
2016,12,AL,2745,2790,-45
2016,12,AR,561,617,-56
2016,12,AZ,1490,1684,-194
2016,12,CA,23557,44073,-20516
2016,12,CO,1059,1113,-54
2016,12,CT,1939,2130,-191
2016,12,DC,111,118,-7
2016,12,DE,1282,1324,-42
2016,12,FL,92566,95679,-3113
2016,12,GA,4392,4559,-167
2016,12,GU,3,2,1
2016,12,HI,4009,4040,-31
2016,12,IA,672,688,-16
2016,12,ID,243,250,-7
2016,12,IL,1411,1535,-124
2016,12,IN,902,964,-62
2016,12,KS,496,499,-3
2016,12,KY,848,891,-43
2016,12,LA,24616,22796,1820
2016,12,MA,3596,3533,63
2016,12,MD,3645,3641,4
2016,12,ME,479,476,3
2016,12,MI,898,937,-39
2016,12,MN,390,394,-4
2016,12,MO,828,866,-38
2016,12,MP,1,1,0
2016,12,MS,3664,3788,-124
2016,12,MT,170,183,-13
2016,12,NC,6735,6569,166
2016,12,ND,460,502,-42
2016,12,NE,297,324,-27
2016,12,NH,322,342,-20
2016,12,NJ,10532,10750,-218
2016,12,NM,478,487,-9
2016,12,NV,573,686,-113
2016,12,NY,11829,12089,-260
2016,12,OH,1489,1615,-126
2016,12,OK,617,677,-60
2016,12,OR,1869,1881,-12
2016,12,PA,3150,3299,-149
2016,12,PR,179,210,-31
2016,12,RI,705,773,-68
2016,12,SC,10888,10917,-29
2016,12,SD,190,218,-28
2016,12,TN,1464,1476,-12
2016,12,TX,26807,27683,-876
2016,12,UT,220,204,16
2016,12,VA,5304,5367,-63
2016,12,VI,80,86,-6
2016,12,VT,154,159,-5
2016,12,WA,2613,2790,-177
2016,12,WI,449,478,-29
2016,12,WV,551,611,-60
2016,12,WY,93,93,0
2017,1,AK,103,110,-7
2017,1,AL,2112,2203,-91
2017,1,AR,536,605,-69
2017,1,AZ,1365,1503,-138
2017,1,CA,18044,25908,-7864
2017,1,CO,987,1001,-14
2017,1,CT,1660,1723,-63
2017,1,DC,119,138,-19
2017,1,DE,1274,1305,-31
2017,1,FL,90574,93437,-2863
2017,1,GA,4036,4129,-93
2017,1,GU,1,2,-1
2017,1,HI,3146,3108,38
2017,1,IA,443,470,-27
2017,1,ID,221,226,-5
2017,1,IL,1576,1725,-149
2017,1,IN,885,952,-67
2017,1,KS,458,517,-59
2017,1,KY,727,790,-63
2017,1,LA,23318,22768,550
2017,1,MA,2500,2452,48
2017,1,MD,3468,3523,-55
2017,1,ME,394,400,-6
2017,1,MI,685,696,-11
2017,1,MN,353,340,13
2017,1,MO,838,915,-77
2017,1,MS,2944,3094,-150
2017,1,MT,197,224,-27
2017,1,NC,6454,6433,21
2017,1,ND,764,758,6
2017,1,NE,294,319,-25
2017,1,NH,278,296,-18
2017,1,NJ,8737,8832,-95
2017,1,NM,462,484,-22
2017,1,NV,595,691,-96
2017,1,NY,10144,10306,-162
2017,1,OH,1207,1307,-100
2017,1,OK,528,563,-35
2017,1,OR,1809,1984,-175
2017,1,PA,3169,3293,-124
2017,1,PR,126,443,-317
2017,1,RI,717,755,-38
2017,1,SC,9249,9328,-79
2017,1,SD,160,180,-20
2017,1,TN,1139,1206,-67
2017,1,TX,26061,26393,-332
2017,1,UT,169,175,-6
2017,1,VA,4847,4882,-35
2017,1,VI,22,34,-12
2017,1,VT,145,156,-11
2017,1,WA,2203,2317,-114
2017,1,WI,600,619,-19
2017,1,WV,530,567,-37
2017,1,WY,52,54,-2
2017,2,AK,93,114,-21
2017,2,AL,3102,3165,-63
2017,2,AR,647,679,-32
2017,2,AZ,1363,1530,-167
2017,2,CA,17116,17724,-608
2017,2,CO,937,959,-22
2017,2,CT,1277,1314,-37
2017,2,DC,123,142,-19
2017,2,DE,895,926,-31
2017,2,FL,84351,87349,-2998
2017,2,GA,4086,4144,-58
2017,2,GU,1,2,-1
2017,2,HI,4943,5025,-82
2017,2,IA,551,587,-36
2017,2,ID,717,360,357
2017,2,IL,1834,1942,-108
2017,2,IN,986,1073,-87
2017,2,KS,472,441,31
2017,2,KY,782,822,-40
2017,2,LA,24275,23492,783
2017,2,MA,2683,2691,-8
2017,2,MD,2705,2780,-75
2017,2,ME,360,373,-13
2017,2,MI,845,895,-50
2017,2,MN,550,539,11
2017,2,MO,812,860,-48
2017,2,MP,1,2,-1
2017,2,MS,3605,3622,-17
2017,2,MT,306,288,18
2017,2,NC,6276,6248,28
2017,2,ND,1033,929,104
2017,2,NE,331,344,-13
2017,2,NH,261,285,-24
2017,2,NJ,8681,8965,-284
2017,2,NM,436,434,2
2017,2,NV,742,843,-101
2017,2,NY,10108,10346,-238
2017,2,OH,1497,1580,-83
2017,2,OK,561,584,-23
2017,2,OR,1704,1579,125
2017,2,PA,3448,3727,-279
2017,2,PR,116,123,-7
2017,2,RI,677,716,-39
2017,2,SC,8580,8648,-68
2017,2,SD,191,219,-28
2017,2,TN,1286,1305,-19
2017,2,TX,26332,26259,73
2017,2,UN,1,1,0
2017,2,UT,328,315,13
2017,2,VA,5064,5082,-18
2017,2,VI,16,60,-44
2017,2,VT,178,190,-12
2017,2,WA,2197,2245,-48
2017,2,WI,477,511,-34
2017,2,WV,646,725,-79
2017,2,WY,86,88,-2
2017,3,AK,120,120,0
2017,3,AL,2793,2893,-100
2017,3,AR,732,749,-17
2017,3,AZ,1279,1330,-51
2017,3,CA,17710,12361,5349
2017,3,CO,1254,1310,-56
2017,3,CT,1652,1761,-109
2017,3,DC,129,159,-30
2017,3,DE,1224,1249,-25
2017,3,FL,104366,108468,-4102
2017,3,GA,5069,5138,-69
2017,3,GU,3,3,0
2017,3,HI,3248,3058,190
2017,3,IA,997,1077,-80
2017,3,ID,977,514,463
2017,3,IL,2213,2406,-193
2017,3,IN,1240,1337,-97
2017,3,KS,622,587,35
2017,3,KY,1038,1111,-73
2017,3,LA,30951,29808,1143
2017,3,MA,3329,3439,-110
2017,3,MD,3660,3807,-147
2017,3,ME,435,467,-32
2017,3,MI,1025,1065,-40
2017,3,MN,1184,1268,-84
2017,3,MO,1268,1268,0
2017,3,MS,4471,4744,-273
2017,3,MT,633,581,52
2017,3,NC,7913,7888,25
2017,3,ND,2107,2120,-13
2017,3,NE,428,483,-55
2017,3,NH,421,411,10
2017,3,NJ,9497,9782,-285
2017,3,NM,544,575,-31
2017,3,NV,834,723,111
2017,3,NY,11567,11413,154
2017,3,OH,1643,1769,-126
2017,3,OK,684,738,-54
2017,3,OR,1465,1670,-205
2017,3,PA,3925,4259,-334
2017,3,PR,112,131,-19
2017,3,RI,598,648,-50
2017,3,SC,11907,12025,-118
2017,3,SD,407,543,-136
2017,3,TN,1863,1903,-40
2017,3,TX,30425,30484,-59
2017,3,UT,341,276,65
2017,3,VA,6112,6127,-15
2017,3,VI,57,60,-3
2017,3,VT,210,225,-15
2017,3,WA,2383,2328,55
2017,3,WI,707,751,-44
2017,3,WV,672,763,-91
2017,3,WY,229,115,114
2017,4,AK,163,151,12
2017,4,AL,3967,4102,-135
2017,4,AR,755,872,-117
2017,4,AZ,1238,1313,-75
2017,4,CA,11358,9877,1481
2017,4,CO,1496,1545,-49
2017,4,CT,1576,1631,-55
2017,4,DC,100,103,-3
2017,4,DE,1241,1253,-12
2017,4,FL,119261,123863,-4602
2017,4,GA,4851,4981,-130
2017,4,GU,1,2,-1
2017,4,HI,3775,3806,-31
2017,4,IA,924,968,-44
2017,4,ID,944,372,572
2017,4,IL,2196,2312,-116
2017,4,IN,1208,1316,-108
2017,4,KS,697,658,39
2017,4,KY,1017,1100,-83
2017,4,LA,37065,37233,-168
2017,4,MA,2826,2863,-37
2017,4,MD,2927,3057,-130
2017,4,ME,511,533,-22
2017,4,MI,908,958,-50
2017,4,MN,1055,1122,-67
2017,4,MO,1376,1383,-7
2017,4,MS,4887,5139,-252
2017,4,MT,462,437,25
2017,4,NC,8010,8069,-59
2017,4,ND,1281,1326,-45
2017,4,NE,467,501,-34
2017,4,NH,369,390,-21
2017,4,NJ,9743,10040,-297
2017,4,NM,461,526,-65
2017,4,NV,722,544,178
2017,4,NY,10358,10609,-251
2017,4,OH,1709,1811,-102
2017,4,OK,781,849,-68
2017,4,OR,1553,1568,-15
2017,4,PA,3187,3388,-201
2017,4,PR,131,147,-16
2017,4,RI,588,636,-48
2017,4,SC,11612,11632,-20
2017,4,SD,274,395,-121
2017,4,TN,2109,2176,-67
2017,4,TX,35280,36156,-876
2017,4,UT,312,273,39
2017,4,VA,5520,5608,-88
2017,4,VI,79,80,-1
2017,4,VT,190,210,-20
2017,4,WA,1822,1776,46
2017,4,WI,813,886,-73
2017,4,WV,721,791,-70
2017,4,WY,300,182,118
2017,5,AK,153,147,6
2017,5,AL,3485,3601,-116
2017,5,AR,751,795,-44
2017,5,AZ,1301,1327,-26
2017,5,CA,9192,9003,189
2017,5,CO,1800,1886,-86
2017,5,CT,1621,1685,-64
2017,5,DC,96,104,-8
2017,5,DE,1534,1565,-31
2017,5,FL,125960,130029,-4069
2017,5,GA,5749,5718,31
2017,5,GU,3,4,-1
2017,5,HI,4161,4077,84
2017,5,IA,727,740,-13
2017,5,ID,1192,643,549
2017,5,IL,2086,2219,-133
2017,5,IN,1068,1194,-126
2017,5,KS,606,622,-16
2017,5,KY,1012,1075,-63
2017,5,LA,40854,39990,864
2017,5,MA,2701,2894,-193
2017,5,MD,2924,3182,-258
2017,5,ME,385,398,-13
2017,5,MI,825,876,-51
2017,5,MN,523,543,-20
2017,5,MO,1133,1156,-23
2017,5,MS,5666,5881,-215
2017,5,MT,392,354,38
2017,5,NC,9083,9084,-1
2017,5,ND,430,455,-25
2017,5,NE,402,442,-40
2017,5,NH,345,361,-16
2017,5,NJ,10487,10805,-318
2017,5,NM,500,521,-21
2017,5,NV,755,615,140
2017,5,NY,12493,12738,-245
2017,5,OH,1399,1505,-106
2017,5,OK,859,891,-32
2017,5,OR,1397,1421,-24
2017,5,PA,3387,3543,-156
2017,5,PR,122,141,-19
2017,5,RI,639,686,-47
2017,5,SC,13628,13798,-170
2017,5,SD,227,306,-79
2017,5,TN,1703,1640,63
2017,5,TX,49625,53224,-3599
2017,5,UN,2,2,0
2017,5,UT,372,359,13
2017,5,VA,6052,6119,-67
2017,5,VI,35,38,-3
2017,5,VT,152,159,-7
2017,5,WA,1835,1695,140
2017,5,WI,635,664,-29
2017,5,WV,571,597,-26
2017,5,WY,190,175,15
2017,6,AK,127,133,-6
2017,6,AL,4146,4231,-85
2017,6,AR,989,950,39
2017,6,AZ,1503,1567,-64
2017,6,CA,8804,8741,63
2017,6,CO,1732,1813,-81
2017,6,CT,1728,1849,-121
2017,6,DC,363,360,3
2017,6,DE,1570,1623,-53
2017,6,FL,144747,147792,-3045
2017,6,GA,6852,6888,-36
2017,6,HI,4188,3976,212
2017,6,IA,741,759,-18
2017,6,ID,443,309,134
2017,6,IL,2052,2259,-207
2017,6,IN,1144,1239,-95
2017,6,KS,662,702,-40
2017,6,KY,1038,1095,-57
2017,6,LA,48953,47016,1937
2017,6,MA,3155,3348,-193
2017,6,MD,3700,3842,-142
2017,6,ME,376,383,-7
2017,6,MI,859,896,-37
2017,6,MN,484,465,19
2017,6,MO,1175,1166,9
2017,6,MS,6257,6449,-192
2017,6,MT,423,447,-24
2017,6,NC,10650,10677,-27
2017,6,ND,566,612,-46
2017,6,NE,451,495,-44
2017,6,NH,331,348,-17
2017,6,NJ,11802,12128,-326
2017,6,NM,464,502,-38
2017,6,NV,549,510,39
2017,6,NY,12012,12705,-693
2017,6,OH,1625,1724,-99
2017,6,OK,1016,1123,-107
2017,6,OR,1262,1319,-57
2017,6,PA,2983,3174,-191
2017,6,PR,130,165,-35
2017,6,RI,768,823,-55
2017,6,SC,15947,16038,-91
2017,6,SD,280,356,-76
2017,6,TN,2565,2555,10
2017,6,TX,69410,74492,-5082
2017,6,UT,211,231,-20
2017,6,VA,8117,8297,-180
2017,6,VI,125,129,-4
2017,6,VT,144,155,-11
2017,6,WA,1527,1499,28
2017,6,WI,585,611,-26
2017,6,WV,567,623,-56
2017,6,WY,145,140,5
2017,7,AK,122,144,-22
2017,7,AL,4394,4530,-136
2017,7,AR,803,790,13
2017,7,AZ,1760,1889,-129
2017,7,CA,9046,9071,-25
2017,7,CO,1376,1489,-113
2017,7,CT,2046,2092,-46
2017,7,DC,220,166,54
2017,7,DE,1758,1805,-47
2017,7,FL,147744,149665,-1921
2017,7,GA,8122,8205,-83
2017,7,HI,2642,2490,152
2017,7,IA,956,1015,-59
2017,7,ID,242,255,-13
2017,7,IL,2053,2203,-150
2017,7,IN,1442,1567,-125
2017,7,KS,655,728,-73
2017,7,KY,1021,1068,-47
2017,7,LA,51994,48520,3474
2017,7,MA,3313,3471,-158
2017,7,MD,4908,5099,-191
2017,7,ME,544,543,1
2017,7,MI,864,1151,-287
2017,7,MN,519,568,-49
2017,7,MO,1169,1212,-43
2017,7,MS,5814,5881,-67
2017,7,MT,296,311,-15
2017,7,NC,11287,11462,-175
2017,7,ND,470,470,0
2017,7,NE,487,570,-83
2017,7,NH,399,444,-45
2017,7,NJ,12932,13306,-374
2017,7,NM,598,624,-26
2017,7,NV,479,544,-65
2017,7,NY,12295,12686,-391
2017,7,OH,1795,1911,-116
2017,7,OK,986,1119,-133
2017,7,OR,1234,1264,-30
2017,7,PA,3223,3420,-197
2017,7,PR,161,191,-30
2017,7,RI,894,957,-63
2017,7,SC,17461,17573,-112
2017,7,SD,221,273,-52
2017,7,TN,1852,1942,-90
2017,7,TX,91911,98305,-6394
2017,7,UT,214,235,-21
2017,7,VA,9742,9885,-143
2017,7,VI,30,32,-2
2017,7,VT,183,197,-14
2017,7,WA,1538,1594,-56
2017,7,WI,685,714,-29
2017,7,WV,640,735,-95
2017,7,WY,117,124,-7
2017,8,AK,138,150,-12
2017,8,AL,3582,3618,-36
2017,8,AR,832,859,-27
2017,8,AZ,2052,2002,50
2017,8,CA,9222,9298,-76
2017,8,CO,1459,1594,-135
2017,8,CT,2388,2473,-85
2017,8,DC,204,199,5
2017,8,DE,1773,1783,-10
2017,8,FL,128298,129956,-1658
2017,8,GA,7791,7607,184
2017,8,HI,6568,6582,-14
2017,8,IA,698,734,-36
2017,8,ID,270,297,-27
2017,8,IL,2062,2033,29
2017,8,IN,1271,1377,-106
2017,8,KS,555,604,-49
2017,8,KY,1029,1112,-83
2017,8,LA,42901,41553,1348
2017,8,MA,3958,4144,-186
2017,8,MD,3860,3975,-115
2017,8,ME,505,505,0
2017,8,MI,839,900,-61
2017,8,MN,474,502,-28
2017,8,MO,1251,1283,-32
2017,8,MS,5047,5120,-73
2017,8,MT,224,245,-21
2017,8,NC,11398,11463,-65
2017,8,ND,503,534,-31
2017,8,NE,347,371,-24
2017,8,NH,324,341,-17
2017,8,NJ,12759,13072,-313
2017,8,NM,804,856,-52
2017,8,NV,637,701,-64
2017,8,NY,12944,13301,-357
2017,8,OH,1799,1903,-104
2017,8,OK,853,947,-94
2017,8,OR,1234,1298,-64
2017,8,PA,3643,3764,-121
2017,8,PR,139,176,-37
2017,8,RI,1364,1432,-68
2017,8,SC,16935,16843,92
2017,8,SD,233,289,-56
2017,8,TN,1950,1949,1
2017,8,TX,63087,63487,-400
2017,8,UT,267,262,5
2017,8,VA,9221,9289,-68
2017,8,VI,69,68,1
2017,8,VT,178,181,-3
2017,8,WA,1572,1658,-86
2017,8,WI,688,670,18
2017,8,WV,733,820,-87
2017,8,WY,124,136,-12
2017,9,AK,161,164,-3
2017,9,AL,4395,4140,255
2017,9,AR,867,860,7
2017,9,AZ,2179,2260,-81
2017,9,CA,10991,10866,125
2017,9,CO,1402,1442,-40
2017,9,CT,2380,2448,-68
2017,9,DC,194,152,42
2017,9,DE,1826,1755,71
2017,9,FL,127020,120012,7008
2017,9,GA,7883,7063,820
2017,9,GU,1,3,-2
2017,9,HI,8050,8067,-17
2017,9,IA,781,819,-38
2017,9,ID,270,289,-19
2017,9,IL,1708,1759,-51
2017,9,IN,1138,1200,-62
2017,9,KS,613,601,12
2017,9,KY,1036,1063,-27
2017,9,LA,54878,52842,2036
2017,9,MA,4328,4437,-109
2017,9,MD,4332,4263,69
2017,9,ME,544,547,-3
2017,9,MI,1001,1018,-17
2017,9,MN,492,521,-29
2017,9,MO,1070,1052,18
2017,9,MS,4832,4742,90
2017,9,MT,225,246,-21
2017,9,NC,11336,10633,703
2017,9,ND,782,806,-24
2017,9,NE,347,355,-8
2017,9,NH,522,522,0
2017,9,NJ,12915,13105,-190
2017,9,NM,634,696,-62
2017,9,NV,576,600,-24
2017,9,NY,15154,15412,-258
2017,9,OH,1909,1979,-70
2017,9,OK,818,844,-26
2017,9,OR,1559,1598,-39
2017,9,PA,3653,3687,-34
2017,9,PR,190,222,-32
2017,9,RI,1236,1264,-28
2017,9,SC,16446,15309,1137
2017,9,SD,203,256,-53
2017,9,TN,1903,1844,59
2017,9,TX,66552,53708,12844
2017,9,UT,256,262,-6
2017,9,VA,9709,9031,678
2017,9,VI,59,60,-1
2017,9,VT,189,208,-19
2017,9,WA,1841,1833,8
2017,9,WI,676,686,-10
2017,9,WV,719,790,-71
2017,9,WY,90,93,-3
2017,10,AK,160,156,4
2017,10,AL,4294,3409,885
2017,10,AR,796,759,37
2017,10,AZ,2260,2208,52
2017,10,CA,17160,16249,911
2017,10,CO,1578,1513,65
2017,10,CT,2528,2347,181
2017,10,DC,234,161,73
2017,10,DE,2317,1844,473
2017,10,FL,149611,120495,29116
2017,10,GA,9393,6628,2765
2017,10,HI,4875,4430,445
2017,10,IA,658,699,-41
2017,10,ID,324,316,8
2017,10,IL,1852,1792,60
2017,10,IN,1262,1222,40
2017,10,KS,575,556,19
2017,10,KY,962,931,31
2017,10,LA,40513,37325,3188
2017,10,MA,5560,5215,345
2017,10,MD,5342,4327,1015
2017,10,ME,786,745,41
2017,10,MI,928,852,76
2017,10,MN,546,497,49
2017,10,MO,1025,1034,-9
2017,10,MS,4434,3967,467
2017,10,MT,221,225,-4
2017,10,NC,12656,9128,3528
2017,10,ND,623,658,-35
2017,10,NE,333,334,-1
2017,10,NH,465,429,36
2017,10,NJ,16406,15731,675
2017,10,NM,604,601,3
2017,10,NV,694,677,17
2017,10,NY,15159,14286,873
2017,10,OH,1905,1850,55
2017,10,OK,904,830,74
2017,10,OR,1889,1791,98
2017,10,PA,4396,4353,43
2017,10,PR,135,151,-16
2017,10,RI,990,882,108
2017,10,SC,18231,14214,4017
2017,10,SD,168,203,-35
2017,10,TN,2185,1764,421
2017,10,TX,85711,44230,41481
2017,10,UT,295,254,41
2017,10,VA,12225,9056,3169
2017,10,VI,41,42,-1
2017,10,VT,227,236,-9
2017,10,WA,2499,2467,32
2017,10,WI,624,606,18
2017,10,WV,677,700,-23
2017,10,WY,93,94,-1
2017,11,AK,145,153,-8
2017,11,AL,3025,2925,100
2017,11,AR,692,705,-13
2017,11,AZ,1462,1506,-44
2017,11,CA,21458,22028,-570
2017,11,CO,1029,1018,11
2017,11,CT,2279,2296,-17
2017,11,DC,151,147,4
2017,11,DE,1338,1291,47
2017,11,FL,93907,90787,3120
2017,11,GA,5535,5358,177
2017,11,HI,3889,3759,130
2017,11,IA,507,535,-28
2017,11,ID,272,275,-3
2017,11,IL,1536,1552,-16
2017,11,IN,1030,1037,-7
2017,11,KS,455,476,-21
2017,11,KY,888,917,-29
2017,11,LA,27300,26883,417
2017,11,MA,3662,3673,-11
2017,11,MD,3749,3788,-39
2017,11,ME,516,502,14
2017,11,MI,720,696,24
2017,11,MN,394,371,23
2017,11,MO,924,926,-2
2017,11,MS,3635,3633,2
2017,11,MT,173,182,-9
2017,11,NC,8268,8253,15
2017,11,ND,402,433,-31
2017,11,NE,257,258,-1
2017,11,NH,445,433,12
2017,11,NJ,12447,12470,-23
2017,11,NM,456,472,-16
2017,11,NV,582,594,-12
2017,11,NY,10824,10955,-131
2017,11,OH,1405,1452,-47
2017,11,OK,698,693,5
2017,11,OR,2018,2002,16
2017,11,PA,3069,3211,-142
2017,11,PR,122,147,-25
2017,11,RI,686,705,-19
2017,11,SC,12073,12134,-61
2017,11,SD,141,160,-19
2017,11,TN,1731,1717,14
2017,11,TX,44858,33383,11475
2017,11,UT,235,252,-17
2017,11,VA,7303,7367,-64
2017,11,VI,33,38,-5
2017,11,VT,231,235,-4
2017,11,WA,2941,2989,-48
2017,11,WI,470,462,8
2017,11,WV,600,620,-20
2017,11,WY,95,93,2
2017,12,AK,92,95,-3
2017,12,AL,2929,2929,0
2017,12,AR,561,568,-7
2017,12,AZ,1374,1467,-93
2017,12,CA,21533,23407,-1874
2017,12,CO,1125,1154,-29
2017,12,CT,1948,1996,-48
2017,12,DC,162,115,47
2017,12,DE,1278,1265,13
2017,12,FL,95280,95392,-112
2017,12,GA,4573,4506,67
2017,12,GU,4,3,1
2017,12,HI,4341,4317,24
2017,12,IA,477,533,-56
2017,12,ID,270,266,4
2017,12,IL,1393,1432,-39
2017,12,IN,831,890,-59
2017,12,KS,411,454,-43
2017,12,KY,905,928,-23
2017,12,LA,26179,26178,1
2017,12,MA,3713,3760,-47
2017,12,MD,3655,3713,-58
2017,12,ME,505,496,9
2017,12,MI,708,923,-215
2017,12,MN,362,382,-20
2017,12,MO,820,841,-21
2017,12,MS,3403,3496,-93
2017,12,MT,161,164,-3
2017,12,NC,6693,6784,-91
2017,12,ND,416,450,-34
2017,12,NE,258,288,-30
2017,12,NH,348,333,15
2017,12,NJ,10108,10776,-668
2017,12,NM,448,475,-27
2017,12,NV,508,524,-16
2017,12,NY,11835,11981,-146
2017,12,OH,1432,1440,-8
2017,12,OK,585,616,-31
2017,12,OR,1786,1853,-67
2017,12,PA,2820,2981,-161
2017,12,PR,229,183,46
2017,12,RI,670,682,-12
2017,12,SC,11392,11428,-36
2017,12,SD,136,158,-22
2017,12,TN,1424,1450,-26
2017,12,TX,35090,29172,5918
2017,12,UT,219,215,4
2017,12,VA,5332,5465,-133
2017,12,VI,61,81,-20
2017,12,VT,145,155,-10
2017,12,WA,2524,2635,-111
2017,12,WI,407,439,-32
2017,12,WV,512,546,-34
2017,12,WY,89,95,-6
2018,1,AK,100,102,-2
2018,1,AL,2129,2164,-35
2018,1,AR,553,580,-27
2018,1,AZ,1278,1367,-89
2018,1,CA,16695,17939,-1244
2018,1,CO,904,926,-22
2018,1,CT,1684,1694,-10
2018,1,DC,119,119,0
2018,1,DE,1301,1322,-21
2018,1,FL,89847,89779,68
2018,1,GA,5771,5806,-35
2018,1,HI,3469,3510,-41
2018,1,IA,417,447,-30
2018,1,ID,209,221,-12
2018,1,IL,1536,1587,-51
2018,1,IN,816,866,-50
2018,1,KS,427,464,-37
2018,1,KY,653,715,-62
2018,1,LA,21277,21109,168
2018,1,MA,2358,2454,-96
2018,1,MD,3161,3244,-83
2018,1,ME,396,399,-3
2018,1,MI,651,675,-24
2018,1,MN,299,333,-34
2018,1,MO,789,826,-37
2018,1,MS,2924,3018,-94
2018,1,MT,161,178,-17
2018,1,NC,6337,6386,-49
2018,1,ND,686,794,-108
2018,1,NE,267,295,-28
2018,1,NH,268,280,-12
2018,1,NJ,8425,8651,-226
2018,1,NM,387,425,-38
2018,1,NV,551,578,-27
2018,1,NY,9939,10213,-274
2018,1,OH,1134,1214,-80
2018,1,OK,525,532,-7
2018,1,OR,1677,1785,-108
2018,1,PA,2563,3085,-522
2018,1,PR,206,121,85
2018,1,RI,661,689,-28
2018,1,SC,9234,9155,79
2018,1,SD,92,118,-26
2018,1,TN,1086,1098,-12
2018,1,TX,29312,24476,4836
2018,1,UT,160,166,-6
2018,1,VA,4202,4274,-72
2018,1,VI,33,26,7
2018,1,VT,129,142,-13
2018,1,WA,2097,2231,-134
2018,1,WI,587,607,-20
2018,1,WV,478,510,-32
2018,1,WY,53,56,-3
2018,2,AK,104,107,-3
2018,2,AL,2887,2935,-48
2018,2,AR,631,663,-32
2018,2,AZ,1296,1338,-42
2018,2,CA,15689,16787,-1098
2018,2,CO,1064,877,187
2018,2,CT,1157,1245,-88
2018,2,DC,120,124,-4
2018,2,DE,916,905,11
2018,2,FL,84042,84331,-289
2018,2,GA,4081,4132,-51
2018,2,HI,5099,5161,-62
2018,2,IA,524,563,-39
2018,2,ID,406,698,-292
2018,2,IL,1764,1821,-57
2018,2,IN,942,1001,-59
2018,2,KS,425,447,-22
2018,2,KY,811,837,-26
2018,2,LA,43210,43082,128
2018,2,MA,2648,2628,20
2018,2,MD,2440,2475,-35
2018,2,ME,383,370,13
2018,2,MI,753,774,-21
2018,2,MN,487,536,-49
2018,2,MO,786,814,-28
2018,2,MS,3586,3671,-85
2018,2,MT,306,302,4
2018,2,NC,6256,6208,48
2018,2,ND,812,991,-179
2018,2,NE,333,340,-7
2018,2,NH,264,273,-9
2018,2,NJ,8623,8517,106
2018,2,NM,391,404,-13
2018,2,NV,631,725,-94
2018,2,NY,9415,9994,-579
2018,2,OH,1469,1488,-19
2018,2,OK,546,567,-21
2018,2,OR,1531,1651,-120
2018,2,PA,3133,3449,-316
2018,2,PR,226,113,113
2018,2,RI,670,678,-8
2018,2,SC,8861,8699,162
2018,2,SD,118,168,-50
2018,2,TN,1308,1263,45
2018,2,TX,31055,26668,4387
2018,2,UT,298,323,-25
2018,2,VA,4432,4473,-41
2018,2,VI,49,22,27
2018,2,VT,171,174,-3
2018,2,WA,1938,1915,23
2018,2,WI,453,475,-22
2018,2,WV,589,649,-60
2018,2,WY,86,85,1
2018,3,AK,112,112,0
2018,3,AL,2657,2712,-55
2018,3,AR,776,723,53
2018,3,AZ,1300,1318,-18
2018,3,CA,14274,17498,-3224
2018,3,CO,1195,1255,-60
2018,3,CT,1528,1653,-125
2018,3,DC,115,116,-1
2018,3,DE,1171,1160,11
2018,3,FL,105259,105911,-652
2018,3,GA,5161,5229,-68
2018,3,GU,3,3,0
2018,3,HI,3573,3532,41
2018,3,IA,948,998,-50
2018,3,ID,612,963,-351
2018,3,IL,2160,2179,-19
2018,3,IN,1248,1254,-6
2018,3,KS,602,622,-20
2018,3,KY,1021,1026,-5
2018,3,LA,32010,31261,749
2018,3,MA,3285,3217,68
2018,3,MD,3636,3648,-12
2018,3,ME,418,413,5
2018,3,MI,1032,1014,18
2018,3,MN,1068,1170,-102
2018,3,MO,1261,1272,-11
2018,3,MS,4667,4749,-82
2018,3,MT,631,611,20
2018,3,NC,8093,7883,210
2018,3,ND,1814,2083,-269
2018,3,NE,395,425,-30
2018,3,NH,400,407,-7
2018,3,NJ,9446,9420,26
2018,3,NM,505,522,-17
2018,3,NV,639,830,-191
2018,3,NY,10951,11214,-263
2018,3,OH,1609,1613,-4
2018,3,OK,699,713,-14
2018,3,OR,1379,1437,-58
2018,3,PA,3411,3871,-460
2018,3,PR,653,128,525
2018,3,RI,582,607,-25
2018,3,SC,12219,12154,65
2018,3,SD,276,303,-27
2018,3,TN,1965,1880,85
2018,3,TX,39009,31709,7300
2018,3,UT,287,338,-51
2018,3,VA,6093,6223,-130
2018,3,VI,125,64,61
2018,3,VT,218,203,15
2018,3,WA,1996,2128,-132
2018,3,WI,675,705,-30
2018,3,WV,657,684,-27
2018,3,WY,135,223,-88
2018,4,AK,144,155,-11
2018,4,AL,3970,3995,-25
2018,4,AR,710,757,-47
2018,4,AZ,1295,1247,48
2018,4,CA,10492,11255,-763
2018,4,CO,1429,1520,-91
2018,4,CT,1472,1547,-75
2018,4,DC,103,110,-7
2018,4,DE,1256,1240,16
2018,4,FL,123018,122959,59
2018,4,GA,4974,4952,22
2018,4,GU,1,1,0
2018,4,HI,4274,4546,-272
2018,4,IA,840,912,-72
2018,4,ID,507,988,-481
2018,4,IL,2080,2195,-115
2018,4,IN,1164,1204,-40
2018,4,KS,638,694,-56
2018,4,KY,970,999,-29
2018,4,LA,37981,37196,785
2018,4,MA,2474,2593,-119
2018,4,MD,3124,3150,-26
2018,4,ME,474,497,-23
2018,4,MI,940,930,10
2018,4,MN,959,1005,-46
2018,4,MO,1366,1374,-8
2018,4,MS,4836,4934,-98
2018,4,MT,646,439,207
2018,4,NC,8121,8042,79
2018,4,ND,1171,1279,-108
2018,4,NE,431,461,-30
2018,4,NH,342,356,-14
2018,4,NJ,9880,9657,223
2018,4,NM,475,480,-5
2018,4,NV,498,715,-217
2018,4,NY,10019,10182,-163
2018,4,OH,1674,1689,-15
2018,4,OK,751,786,-35
2018,4,OR,1501,1544,-43
2018,4,PA,2979,3119,-140
2018,4,PR,634,150,484
2018,4,RI,576,601,-25
2018,4,SC,11786,11854,-68
2018,4,SD,250,265,-15
2018,4,TN,1636,1934,-298
2018,4,TX,44079,36184,7895
2018,4,UT,262,307,-45
2018,4,VA,5394,5418,-24
2018,4,VI,117,85,32
2018,4,VT,194,195,-1
2018,4,WA,1712,1849,-137
2018,4,WI,760,783,-23
2018,4,WV,671,713,-42
2018,4,WY,195,300,-105
2018,5,AK,145,144,1
2018,5,AL,3502,3558,-56
2018,5,AR,672,762,-90
2018,5,AS,10,0,10
2018,5,AZ,1403,1322,81
2018,5,CA,9074,9330,-256
2018,5,CO,1723,1825,-102
2018,5,CT,1546,1622,-76
2018,5,DC,101,101,0
2018,5,DE,1573,1576,-3
2018,5,FL,131011,127087,3924
2018,5,GA,5920,5806,114
2018,5,GU,1,2,-1
2018,5,HI,4300,4240,60
2018,5,IA,701,733,-32
2018,5,ID,697,1154,-457
2018,5,IL,2006,2103,-97
2018,5,IN,1039,1082,-43
2018,5,KS,564,612,-48
2018,5,KY,962,1002,-40
2018,5,LA,42199,41365,834
2018,5,MA,2577,2670,-93
2018,5,MD,2922,3032,-110
2018,5,ME,384,388,-4
2018,5,MI,835,835,0
2018,5,MN,503,517,-14
2018,5,MO,1038,1093,-55
2018,5,MS,5489,5551,-62
2018,5,MT,574,397,177
2018,5,NC,9441,9325,116
2018,5,ND,382,417,-35
2018,5,NE,398,423,-25
2018,5,NH,315,335,-20
2018,5,NJ,10784,10662,122
2018,5,NM,471,492,-21
2018,5,NV,528,743,-215
2018,5,NY,11738,12225,-487
2018,5,OH,1377,1407,-30
2018,5,OK,804,852,-48
2018,5,OR,1217,1430,-213
2018,5,PA,3181,3378,-197
2018,5,PR,696,155,541
2018,5,RI,610,629,-19
2018,5,SC,13889,13725,164
2018,5,SD,217,229,-12
2018,5,TN,1623,1708,-85
2018,5,TX,63908,50570,13338
2018,5,UN,1,2,-1
2018,5,UT,339,353,-14
2018,5,VA,6190,6144,46
2018,5,VI,89,44,45
2018,5,VT,159,163,-4
2018,5,WA,1727,1789,-62
2018,5,WI,615,639,-24
2018,5,WV,554,576,-22
2018,5,WY,155,186,-31
2018,6,AK,122,120,2
2018,6,AL,3897,3913,-16
2018,6,AR,875,955,-80
2018,6,AS,18,2,16
2018,6,AZ,1413,1525,-112
2018,6,CA,8611,8764,-153
2018,6,CO,1659,1713,-54
2018,6,CT,1619,1691,-72
2018,6,DC,359,364,-5
2018,6,DE,1580,1591,-11
2018,6,FL,151097,143232,7865
2018,6,GA,7154,6822,332
2018,6,HI,3970,3900,70
2018,6,IA,679,693,-14
2018,6,ID,597,723,-126
2018,6,IL,1939,2024,-85
2018,6,IN,1064,1130,-66
2018,6,KS,605,666,-61
2018,6,KY,956,1012,-56
2018,6,LA,50055,48682,1373
2018,6,MA,3058,3168,-110
2018,6,MD,3749,3673,76
2018,6,ME,363,395,-32
2018,6,MI,842,859,-17
2018,6,MN,436,472,-36
2018,6,MO,1104,1154,-50
2018,6,MS,6248,6305,-57
2018,6,MT,444,421,23
2018,6,NC,11290,11034,256
2018,6,ND,527,570,-43
2018,6,NE,469,488,-19
2018,6,NH,345,350,-5
2018,6,NJ,12247,12483,-236
2018,6,NM,464,481,-17
2018,6,NV,442,550,-108
2018,6,NY,11626,12064,-438
2018,6,OH,1550,1644,-94
2018,6,OK,901,979,-78
2018,6,OR,1300,1345,-45
2018,6,PA,2810,2967,-157
2018,6,PR,385,166,219
2018,6,RI,699,731,-32
2018,6,SC,17138,16569,569
2018,6,SD,259,276,-17
2018,6,TN,2407,2525,-118
2018,6,TX,88988,70067,18921
2018,6,UT,212,214,-2
2018,6,VA,8591,8622,-31
2018,6,VI,171,138,33
2018,6,VT,143,146,-3
2018,6,WA,1474,1555,-81
2018,6,WI,571,582,-11
2018,6,WV,543,567,-24
2018,6,WY,126,140,-14
2018,7,AK,124,125,-1
2018,7,AL,4160,4207,-47
2018,7,AR,733,803,-70
2018,7,AS,5,1,4
2018,7,AZ,1754,1763,-9
2018,7,CA,9134,9225,-91
2018,7,CO,1398,1360,38
2018,7,CT,2013,2089,-76
2018,7,DC,237,217,20
2018,7,DE,1734,1722,12
2018,7,FL,152936,147542,5394
2018,7,GA,8261,8169,92
2018,7,HI,2744,2411,333
2018,7,IA,926,953,-27
2018,7,ID,230,245,-15
2018,7,IL,2626,2054,572
2018,7,IN,1369,1434,-65
2018,7,KS,644,654,-10
2018,7,KY,957,1005,-48
2018,7,LA,52165,51946,219
2018,7,MA,3067,3198,-131
2018,7,MD,5050,4943,107
2018,7,ME,482,485,-3
2018,7,MI,911,899,12
2018,7,MN,513,543,-30
2018,7,MO,1067,1135,-68
2018,7,MS,5729,5821,-92
2018,7,MT,283,295,-12
2018,7,NC,11558,11376,182
2018,7,ND,398,412,-14
2018,7,NE,471,486,-15
2018,7,NH,397,409,-12
2018,7,NJ,13006,13245,-239
2018,7,NM,572,596,-24
2018,7,NV,452,475,-23
2018,7,NY,11869,12182,-313
2018,7,OH,1746,1814,-68
2018,7,OK,895,957,-62
2018,7,OR,1138,1285,-147
2018,7,PA,3023,3127,-104
2018,7,PR,347,193,154
2018,7,RI,848,892,-44
2018,7,SC,18000,17614,386
2018,7,SD,192,211,-19
2018,7,TN,1781,1814,-33
2018,7,TX,110359,92107,18252
2018,7,UT,210,215,-5
2018,7,VA,9938,9762,176
2018,7,VI,45,34,11
2018,7,VT,171,185,-14
2018,7,WA,1469,1570,-101
2018,7,WI,674,673,1
2018,7,WV,609,630,-21
2018,7,WY,100,116,-16
2018,8,AK,125,134,-9
2018,8,AL,3653,3636,17
2018,8,AR,777,839,-62
2018,8,AS,1,1,0
2018,8,AZ,1983,2059,-76
2018,8,CA,9326,9352,-26
2018,8,CO,1639,1471,168
2018,8,CT,2317,2399,-82
2018,8,DC,214,212,2
2018,8,DE,1838,1791,47
2018,8,FL,126518,124970,1548
2018,8,GA,12175,12204,-29
2018,8,HI,7465,7278,187
2018,8,IA,750,684,66
2018,8,ID,229,253,-24
2018,8,IL,1941,2056,-115
2018,8,IN,1195,1266,-71
2018,8,KS,531,556,-25
2018,8,KY,989,1021,-32
2018,8,LA,42957,42365,592
2018,8,MA,3891,3987,-96
2018,8,MD,4068,3964,104
2018,8,ME,513,495,18
2018,8,MI,863,845,18
2018,8,MN,463,492,-29
2018,8,MO,983,1261,-278
2018,8,MS,4966,5076,-110
2018,8,MT,217,228,-11
2018,8,NC,16645,16204,441
2018,8,ND,458,507,-49
2018,8,NE,350,350,0
2018,8,NH,330,325,5
2018,8,NJ,13420,13702,-282
2018,8,NM,759,734,25
2018,8,NV,595,631,-36
2018,8,NY,12601,12904,-303
2018,8,OH,1698,1815,-117
2018,8,OK,784,833,-49
2018,8,OR,1239,1261,-22
2018,8,PA,3622,3690,-68
2018,8,PR,382,182,200
2018,8,RI,1315,1365,-50
2018,8,SC,17418,16938,480
2018,8,SD,229,231,-2
2018,8,TN,1881,1956,-75
2018,8,TX,73634,64628,9006
2018,8,UT,241,231,10
2018,8,VA,9440,9292,148
2018,8,VI,71,74,-3
2018,8,VT,166,172,-6
2018,8,WA,1549,1617,-68
2018,8,WI,660,710,-50
2018,8,WV,693,729,-36
2018,8,WY,109,114,-5
2018,9,AK,156,164,-8
2018,9,AL,4120,4241,-121
2018,9,AR,776,832,-56
2018,9,AZ,2055,2132,-77
2018,9,CA,10905,11036,-131
2018,9,CO,1478,1366,112
2018,9,CT,2409,2478,-69
2018,9,DC,187,190,-3
2018,9,DE,1980,1962,18
2018,9,FL,121217,123766,-2549
2018,9,GA,7727,7905,-178
2018,9,GU,1,1,0
2018,9,HI,6190,6074,116
2018,9,IA,791,769,22
2018,9,ID,244,269,-25
2018,9,IL,1689,1748,-59
2018,9,IN,1073,1108,-35
2018,9,KS,558,602,-44
2018,9,KY,971,1014,-43
2018,9,LA,52312,54556,-2244
2018,9,MA,4160,4264,-104
2018,9,MD,4320,4312,8
2018,9,ME,506,525,-19
2018,9,MI,922,928,-6
2018,9,MN,447,472,-25
2018,9,MO,988,1032,-44
2018,9,MS,4612,4820,-208
2018,9,MT,209,230,-21
2018,9,NC,11878,11527,351
2018,9,ND,715,761,-46
2018,9,NE,345,356,-11
2018,9,NH,507,513,-6
2018,9,NJ,13472,13532,-60
2018,9,NM,631,626,5
2018,9,NV,536,569,-33
2018,9,NY,14530,14733,-203
2018,9,OH,1716,1812,-96
2018,9,OK,787,803,-16
2018,9,OR,1516,1607,-91
2018,9,PA,3689,3622,67
2018,9,PR,352,261,91
2018,9,RI,1128,1196,-68
2018,9,SC,17004,16613,391
2018,9,SD,181,191,-10
2018,9,TN,1828,1885,-57
2018,9,TX,66937,65190,1747
2018,9,UT,261,255,6
2018,9,VA,9669,9586,83
2018,9,VI,63,63,0
2018,9,VT,191,195,-4
2018,9,WA,1803,1850,-47
2018,9,WI,783,670,113
2018,9,WV,674,712,-38
2018,9,WY,82,84,-2
2018,10,AK,147,154,-7
2018,10,AL,4033,4232,-199
2018,10,AR,781,806,-25
2018,10,AZ,2182,2249,-67
2018,10,CA,16183,17004,-821
2018,10,CO,1521,1577,-56
2018,10,CT,2382,2466,-84
2018,10,DC,269,230,39
2018,10,DE,2349,2270,79
2018,10,FL,133500,139756,-6256
2018,10,GA,8904,9288,-384
2018,10,HI,5854,5031,823
2018,10,IA,666,663,3
2018,10,ID,303,322,-19
2018,10,IL,1863,1877,-14
2018,10,IN,1197,1262,-65
2018,10,KS,584,559,25
2018,10,KY,918,952,-34
2018,10,LA,40039,40825,-786
2018,10,MA,5331,5438,-107
2018,10,MD,5620,5341,279
2018,10,ME,782,776,6
2018,10,MI,949,909,40
2018,10,MN,549,564,-15
2018,10,MO,995,1018,-23
2018,10,MS,4347,4482,-135
2018,10,MT,213,230,-17
2018,10,NC,14837,12827,2010
2018,10,ND,585,624,-39
2018,10,NE,331,339,-8
2018,10,NH,397,410,-13
2018,10,NJ,12837,12748,89
2018,10,NM,601,605,-4
2018,10,NV,589,646,-57
2018,10,NY,14915,15131,-216
2018,10,OH,1864,1933,-69
2018,10,OK,887,906,-19
2018,10,OR,1690,1854,-164
2018,10,PA,4505,4309,196
2018,10,PR,208,162,46
2018,10,RI,989,1025,-36
2018,10,SC,18947,17574,1373
2018,10,SD,157,164,-7
2018,10,TN,2162,2327,-165
2018,10,TX,81547,84117,-2570
2018,10,UT,481,300,181
2018,10,VA,13787,12015,1772
2018,10,VI,46,44,2
2018,10,VT,221,226,-5
2018,10,WA,2368,2501,-133
2018,10,WI,766,610,156
2018,10,WV,653,656,-3
2018,10,WY,93,92,1
2018,11,AK,144,135,9
2018,11,AL,3071,3024,47
2018,11,AR,601,642,-41
2018,11,AZ,1513,1446,67
2018,11,CA,20374,21377,-1003
2018,11,CO,1162,1056,106
2018,11,CT,2089,2086,3
2018,11,DC,163,150,13
2018,11,DE,1443,1366,77
2018,11,FL,93320,93801,-481
2018,11,GA,5447,5506,-59
2018,11,HI,5052,4847,205
2018,11,IA,522,484,38
2018,11,ID,258,263,-5
2018,11,IL,1419,1507,-88
2018,11,IN,969,1012,-43
2018,11,KS,464,455,9
2018,11,KY,838,867,-29
2018,11,LA,26718,27197,-479
2018,11,MA,3741,3770,-29
2018,11,MD,3717,3634,83
2018,11,ME,522,510,12
2018,11,MI,790,786,4
2018,11,MN,455,385,70
2018,11,MO,868,921,-53
2018,11,MS,3642,3579,63
2018,11,MT,171,171,0
2018,11,NC,10549,8647,1902
2018,11,ND,372,388,-16
2018,11,NE,257,262,-5
2018,11,NH,446,454,-8
2018,11,NJ,11942,11939,3
2018,11,NM,455,455,0
2018,11,NV,555,582,-27
2018,11,NY,10681,10799,-118
2018,11,OH,1359,1415,-56
2018,11,OK,690,700,-10
2018,11,OR,1900,2001,-101
2018,11,PA,3025,3093,-68
2018,11,PR,195,139,56
2018,11,RI,664,687,-23
2018,11,SC,12893,11994,899
2018,11,SD,121,140,-19
2018,11,TN,1598,1647,-49
2018,11,TX,44552,44480,72
2018,11,UT,385,247,138
2018,11,VA,7196,7036,160
2018,11,VI,30,30,0
2018,11,VT,216,223,-7
2018,11,WA,2673,2847,-174
2018,11,WI,554,522,32
2018,11,WV,567,601,-34
2018,11,WY,101,102,-1
2018,12,AK,97,93,4
2018,12,AL,2717,2723,-6
2018,12,AR,549,542,7
2018,12,AZ,1362,1355,7
2018,12,CA,20972,21152,-180
2018,12,CO,1001,1030,-29
2018,12,CT,1864,1881,-17
2018,12,DC,161,157,4
2018,12,DE,1269,1240,29
2018,12,FL,97967,99246,-1279
2018,12,GA,4380,4600,-220
2018,12,GU,4,4,0
2018,12,HI,4686,4335,351
2018,12,IA,457,472,-15
2018,12,ID,241,254,-13
2018,12,IL,1441,1516,-75
2018,12,IN,772,812,-40
2018,12,KS,385,418,-33
2018,12,KY,742,804,-62
2018,12,LA,25322,25511,-189
2018,12,MA,3477,3505,-28
2018,12,MD,3516,3502,14
2018,12,ME,481,491,-10
2018,12,MI,735,711,24
2018,12,MN,332,354,-22
2018,12,MO,789,797,-8
2018,12,MS,3187,3210,-23
2018,12,MT,152,163,-11
2018,12,NC,8425,7672,753
2018,12,ND,367,404,-37
2018,12,NE,230,240,-10
2018,12,NH,347,327,20
2018,12,NJ,9604,9704,-100
2018,12,NM,408,429,-21
2018,12,NV,469,496,-27
2018,12,NY,11404,11625,-221
2018,12,OH,1348,1411,-63
2018,12,OK,540,579,-39
2018,12,OR,1722,1848,-126
2018,12,PA,2751,2805,-54
2018,12,PR,188,243,-55
2018,12,RI,629,650,-21
2018,12,SC,12747,12445,302
2018,12,SD,128,135,-7
2018,12,TN,1356,1400,-44
2018,12,TX,34148,34081,67
2018,12,UT,214,212,2
2018,12,VA,5165,5099,66
2018,12,VI,63,61,2
2018,12,VT,137,142,-5
2018,12,WA,2360,2511,-151
2018,12,WI,674,497,177
2018,12,WV,449,485,-36
2018,12,WY,75,81,-6
2019,1,AK,102,96,6
2019,1,AL,2237,2266,-29
2019,1,AR,478,519,-41
2019,1,AZ,1197,1222,-25
2019,1,CA,16386,16540,-154
2019,1,CO,833,862,-29
2019,1,CT,1485,1627,-142
2019,1,DC,109,111,-2
2019,1,DE,1287,1267,20
2019,1,FL,89128,90903,-1775
2019,1,GA,3951,4109,-158
2019,1,HI,2991,2923,68
2019,1,IA,392,415,-23
2019,1,ID,216,219,-3
2019,1,IL,1232,1521,-289
2019,1,IN,776,802,-26
2019,1,KS,402,417,-15
2019,1,KY,617,640,-23
2019,1,LA,21049,21267,-218
2019,1,MA,2300,2337,-37
2019,1,MD,3153,3179,-26
2019,1,ME,383,389,-6
2019,1,MI,626,647,-21
2019,1,MN,275,293,-18
2019,1,MO,691,726,-35
2019,1,MS,2901,2937,-36
2019,1,MT,147,159,-12
2019,1,NC,6943,6542,401
2019,1,ND,595,642,-47
2019,1,NE,246,269,-23
2019,1,NH,271,274,-3
2019,1,NJ,8071,8318,-247
2019,1,NM,378,385,-7
2019,1,NV,503,540,-37
2019,1,NY,9443,9673,-230
2019,1,OH,1036,1099,-63
2019,1,OK,495,517,-22
2019,1,OR,1554,1634,-80
2019,1,PA,2423,2573,-150
2019,1,PR,118,214,-96
2019,1,RI,628,647,-19
2019,1,SC,9530,9435,95
2019,1,SD,84,88,-4
2019,1,TN,1212,1225,-13
2019,1,TX,27758,27964,-206
2019,1,UT,154,157,-3
2019,1,VA,4041,4054,-13
2019,1,VI,25,30,-5
2019,1,VT,122,125,-3
2019,1,WA,1993,2061,-68
2019,1,WI,616,585,31
2019,1,WV,430,456,-26
2019,1,WY,47,51,-4
2019,2,AK,93,93,0
2019,2,AL,3195,3115,80
2019,2,AR,576,607,-31
2019,2,AZ,1256,1290,-34
2019,2,CA,15277,15468,-191
2019,2,CO,1117,1128,-11
2019,2,CT,1096,1123,-27
2019,2,DC,116,118,-2
2019,2,DE,916,901,15
2019,2,FL,83230,84416,-1186
2019,2,GA,3851,4023,-172
2019,2,HI,4980,5097,-117
2019,2,IA,555,549,6
2019,2,ID,380,400,-20
2019,2,IL,1717,1787,-70
2019,2,IN,899,924,-25
2019,2,KS,392,421,-29
2019,2,KY,695,726,-31
2019,2,LA,24440,24281,159
2019,2,MA,2638,2651,-13
2019,2,MD,2417,2484,-67
2019,2,ME,389,370,19
2019,2,MI,725,725,0
2019,2,MN,451,461,-10
2019,2,MO,772,794,-22
2019,2,MS,3515,3564,-49
2019,2,MT,273,300,-27
2019,2,NC,7168,6718,450
2019,2,ND,745,794,-49
2019,2,NE,319,326,-7
2019,2,NH,267,249,18
2019,2,NJ,8356,8534,-178
2019,2,NM,361,394,-33
2019,2,NV,576,616,-40
2019,2,NY,9163,9381,-218
2019,2,OH,1371,1441,-70
2019,2,OK,510,513,-3
2019,2,OR,1416,1475,-59
2019,2,PA,2895,3075,-180
2019,2,PR,148,228,-80
2019,2,RI,654,662,-8
2019,2,SC,9336,9125,211
2019,2,SD,108,116,-8
2019,2,TN,1247,1345,-98
2019,2,TX,30170,30005,165
2019,2,UT,296,306,-10
2019,2,VA,4399,4415,-16
2019,2,VI,29,52,-23
2019,2,VT,168,168,0
2019,2,WA,1800,1923,-123
2019,2,WI,443,435,8
2019,2,WV,545,577,-32
2019,2,WY,79,79,0
2019,3,AK,107,116,-9
2019,3,AL,2614,2629,-15
2019,3,AR,739,756,-17
2019,3,AZ,1358,1270,88
2019,3,CA,15092,14452,640
2019,3,CO,1181,1205,-24
2019,3,CT,1425,1506,-81
2019,3,DC,106,113,-7
2019,3,DE,1149,1161,-12
2019,3,FL,103053,104657,-1604
2019,3,GA,4822,5064,-242
2019,3,HI,2889,2814,75
2019,3,IA,1093,940,153
2019,3,ID,720,607,113
2019,3,IL,2105,2143,-38
2019,3,IN,1185,1220,-35
2019,3,KS,576,595,-19
2019,3,KY,982,1013,-31
2019,3,LA,31334,31466,-132
2019,3,MA,3125,3207,-82
2019,3,MD,3525,3594,-69
2019,3,ME,445,434,11
2019,3,MI,973,1011,-38
2019,3,MN,1665,1054,611
2019,3,MO,1311,1234,77
2019,3,MP,1,0,1
2019,3,MS,4323,4374,-51
2019,3,MT,556,628,-72
2019,3,NC,8694,8331,363
2019,3,ND,1981,1783,198
2019,3,NE,415,408,7
2019,3,NH,419,429,-10
2019,3,NJ,9251,9529,-278
2019,3,NM,478,500,-22
2019,3,NV,613,629,-16
2019,3,NY,11226,11429,-203
2019,3,OH,1516,1580,-64
2019,3,OK,610,667,-57
2019,3,OR,1323,1348,-25
2019,3,PA,3209,3381,-172
2019,3,PR,297,645,-348
2019,3,RI,536,580,-44
2019,3,SC,12436,12195,241
2019,3,SD,375,276,99
2019,3,TN,2083,1953,130
2019,3,TX,39382,39373,9
2019,3,UT,289,290,-1
2019,3,VA,5882,5983,-101
2019,3,VI,69,121,-52
2019,3,VT,219,231,-12
2019,3,WA,1927,1947,-20
2019,3,WI,870,702,168
2019,3,WV,635,659,-24
2019,3,WY,151,133,18
2019,4,AK,127,137,-10
2019,4,AL,6243,6282,-39
2019,4,AR,686,716,-30
2019,4,AZ,1343,1327,16
2019,4,CA,11124,10644,480
2019,4,CO,1639,1409,230
2019,4,CT,1419,1470,-51
2019,4,DC,105,103,2
2019,4,DE,1277,1259,18
2019,4,FL,119703,121624,-1921
2019,4,GA,4792,4968,-176
2019,4,HI,3596,3353,243
2019,4,IA,1595,882,713
2019,4,ID,681,435,246
2019,4,IL,2229,2074,155
2019,4,IN,1113,1161,-48
2019,4,KS,761,618,143
2019,4,KY,912,976,-64
2019,4,LA,37563,37612,-49
2019,4,MA,2341,2438,-97
2019,4,MD,2937,2953,-16
2019,4,ME,556,496,60
2019,4,MI,935,911,24
2019,4,MN,3661,982,2679
2019,4,MO,1699,1365,334
2019,4,MS,4852,4845,7
2019,4,MT,716,658,58
2019,4,NC,8802,8365,437
2019,4,ND,2313,1181,1132
2019,4,NE,704,445,259
2019,4,NH,328,335,-7
2019,4,NJ,9911,10149,-238
2019,4,NM,472,471,1
2019,4,NV,504,491,13
2019,4,NY,9981,10235,-254
2019,4,OH,1576,1688,-112
2019,4,OK,726,734,-8
2019,4,OR,1479,1511,-32
2019,4,PA,2867,2969,-102
2019,4,PR,188,619,-431
2019,4,RI,523,559,-36
2019,4,SC,12228,11791,437
2019,4,SD,604,254,350
2019,4,TN,1758,1655,103
2019,4,TX,44579,44164,415
2019,4,UT,380,264,116
2019,4,VA,5450,5429,21
2019,4,VI,87,113,-26
2019,4,VT,181,186,-5
2019,4,WA,1613,1668,-55
2019,4,WI,1454,793,661
2019,4,WV,650,680,-30
2019,4,WY,251,193,58
2019,5,AK,137,140,-3
2019,5,AL,4093,4084,9
2019,5,AR,666,679,-13
2019,5,AZ,1412,1414,-2
2019,5,CA,9638,9213,425
2019,5,CO,1833,1741,92
2019,5,CT,1473,1521,-48
2019,5,DC,114,102,12
2019,5,DE,1539,1531,8
2019,5,FL,130230,131736,-1506
2019,5,GA,6002,5921,81
2019,5,HI,4216,4095,121
2019,5,IA,884,733,151
2019,5,ID,713,687,26
2019,5,IL,2222,2133,89
2019,5,IN,977,1028,-51
2019,5,KS,675,581,94
2019,5,KY,990,1031,-41
2019,5,LA,42240,41770,470
2019,5,MA,2659,2604,55
2019,5,MD,2761,2825,-64
2019,5,ME,370,377,-7
2019,5,MI,897,845,52
2019,5,MN,516,519,-3
2019,5,MO,1153,1073,80
2019,5,MS,5677,5656,21
2019,5,MT,410,559,-149
2019,5,NC,10136,9476,660
2019,5,ND,382,396,-14
2019,5,NE,539,422,117
2019,5,NH,325,320,5
2019,5,NJ,10406,10621,-215
2019,5,NM,466,454,12
2019,5,NV,536,537,-1
2019,5,NY,11539,11753,-214
2019,5,OH,1288,1377,-89
2019,5,OK,863,851,12
2019,5,OR,1205,1194,11
2019,5,PA,3034,3170,-136
2019,5,PR,262,673,-411
2019,5,RI,637,666,-29
2019,5,SC,15589,15019,570
2019,5,SD,243,213,30
2019,5,TN,1675,1677,-2
2019,5,TX,65096,64012,1084
2019,5,UT,420,365,55
2019,5,VA,6333,6271,62
2019,5,VI,57,79,-22
2019,5,VT,148,148,0
2019,5,WA,1641,1732,-91
2019,5,WI,701,641,60
2019,5,WV,526,546,-20
2019,5,WY,162,160,2
2019,6,AK,122,131,-9
2019,6,AL,3908,3887,21
2019,6,AR,928,896,32
2019,6,AZ,1406,1461,-55
2019,6,CA,8850,8625,225
2019,6,CO,1783,1662,121
2019,6,CT,1600,1643,-43
2019,6,DC,359,364,-5
2019,6,DE,1582,1567,15
2019,6,FL,147389,148386,-997
2019,6,GA,6815,7127,-312
2019,6,HI,5585,5446,139
2019,6,IA,764,698,66
2019,6,ID,343,340,3
2019,6,IL,2079,1958,121
2019,6,IN,1041,1065,-24
2019,6,KS,1106,632,474
2019,6,KY,940,956,-16
2019,6,LA,51680,50200,1480
2019,6,MA,3086,3170,-84
2019,6,MD,3859,3969,-110
2019,6,ME,326,353,-27
2019,6,MI,1036,855,181
2019,6,MN,431,457,-26
2019,6,MO,1241,1168,73
2019,6,MS,6154,6164,-10
2019,6,MT,388,438,-50
2019,6,NC,12087,11173,914
2019,6,ND,486,527,-41
2019,6,NE,544,455,89
2019,6,NH,363,367,-4
2019,6,NJ,11652,11672,-20
2019,6,NM,453,447,6
2019,6,NV,427,450,-23
2019,6,NY,11592,11688,-96
2019,6,OH,1526,1536,-10
2019,6,OK,1312,914,398
2019,6,OR,1286,1233,53
2019,6,PA,2685,2787,-102
2019,6,PR,311,354,-43
2019,6,RI,677,713,-36
2019,6,SC,17609,17089,520
2019,6,SD,266,272,-6
2019,6,TN,2367,2388,-21
2019,6,TX,98293,88121,10172
2019,6,UT,229,218,11
2019,6,VA,8143,8144,-1
2019,6,VI,142,161,-19
2019,6,VT,148,145,3
2019,6,WA,1517,1460,57
2019,6,WI,605,590,15
2019,6,WV,533,556,-23
2019,6,WY,116,125,-9
2019,7,AK,128,129,-1
2019,7,AL,4124,4122,2
2019,7,AR,794,741,53
2019,7,AZ,1752,1790,-38
2019,7,CA,9285,9230,55
2019,7,CO,1409,1412,-3
2019,7,CT,1937,1995,-58
2019,7,DC,181,249,-68
2019,7,DE,1732,1719,13
2019,7,FL,149333,149855,-522
2019,7,GA,7857,8070,-213
2019,7,HI,3246,2878,368
2019,7,IA,930,938,-8
2019,7,ID,255,249,6
2019,7,IL,2944,2654,290
2019,7,IN,1310,1354,-44
2019,7,KS,685,639,46
2019,7,KY,920,951,-31
2019,7,LA,54597,51966,2631
2019,7,MA,3095,3179,-84
2019,7,MD,4857,4921,-64
2019,7,ME,468,482,-14
2019,7,MI,1059,923,136
2019,7,MN,498,535,-37
2019,7,MO,1164,1093,71
2019,7,MS,5748,5754,-6
2019,7,MT,269,298,-29
2019,7,NC,13159,11824,1335
2019,7,ND,391,426,-35
2019,7,NE,518,501,17
2019,7,NH,400,405,-5
2019,7,NJ,12290,12479,-189
2019,7,NM,564,574,-10
2019,7,NV,452,476,-24
2019,7,NY,11820,12002,-182
2019,7,OH,1726,1736,-10
2019,7,OK,1055,907,148
2019,7,OR,1106,1154,-48
2019,7,PA,2960,3033,-73
2019,7,PR,291,321,-30
2019,7,RI,832,849,-17
2019,7,SC,18031,17403,628
2019,7,SD,186,197,-11
2019,7,TN,1939,1805,134
2019,7,TX,112149,108918,3231
2019,7,UT,211,214,-3
2019,7,VA,9957,9812,145
2019,7,VI,31,41,-10
2019,7,VT,169,169,0
2019,7,WA,1508,1501,7
2019,7,WI,731,699,32
2019,7,WV,593,620,-27
2019,7,WY,105,102,3
2019,8,AK,140,142,-2
2019,8,AL,3574,3543,31
2019,8,AR,795,752,43
2019,8,AZ,2398,1968,430
2019,8,CA,9563,9451,112
2019,8,CO,1438,1616,-178
2019,8,CT,2252,2318,-66
2019,8,DC,247,211,36
2019,8,DE,1824,1805,19
2019,8,FL,129113,127906,1207
2019,8,GA,7887,7919,-32
2019,8,HI,7667,7638,29
2019,8,IA,886,908,-22
2019,8,ID,250,247,3
2019,8,IL,2222,2232,-10
2019,8,IN,1127,1187,-60
2019,8,KS,526,537,-11
2019,8,KY,963,1001,-38
2019,8,LA,47790,43045,4745
2019,8,MA,3797,3891,-94
2019,8,MD,3982,3963,19
2019,8,ME,447,518,-71
2019,8,MI,942,893,49
2019,8,MN,495,497,-2
2019,8,MO,1046,972,74
2019,8,MS,5045,5049,-4
2019,8,MT,207,220,-13
2019,8,NC,13093,12054,1039
2019,8,ND,432,478,-46
2019,8,NE,449,410,39
2019,8,NH,322,343,-21
2019,8,NJ,13408,13297,111
2019,8,NM,701,750,-49
2019,8,NV,565,600,-35
2019,8,NY,12401,12476,-75
2019,8,OH,1740,1727,13
2019,8,OK,871,835,36
2019,8,OR,1285,1307,-22
2019,8,PA,3618,3644,-26
2019,8,PR,214,341,-127
2019,8,RI,1288,1315,-27
2019,8,SC,18359,17619,740
2019,8,SD,228,230,-2
2019,8,TN,1986,1918,68
2019,8,TX,80508,76760,3748
2019,8,UT,233,239,-6
2019,8,VA,9870,9430,440
2019,8,VI,62,59,3
2019,8,VT,167,164,3
2019,8,WA,1567,1571,-4
2019,8,WI,659,656,3
2019,8,WV,637,688,-51
2019,8,WY,101,111,-10
2019,9,AK,153,153,0
2019,9,AL,4226,4357,-131
2019,9,AR,767,789,-22
2019,9,AZ,1953,2027,-74
2019,9,CA,10743,10979,-236
2019,9,CO,1335,1459,-124
2019,9,CT,2213,2270,-57
2019,9,DC,173,181,-8
2019,9,DE,1841,1867,-26
2019,9,FL,123907,123680,227
2019,9,GA,7294,7433,-139
2019,9,GU,1,2,-1
2019,9,HI,7628,6059,1569
2019,9,IA,797,805,-8
2019,9,ID,250,236,14
2019,9,IL,1633,1667,-34
2019,9,IN,1021,1086,-65
2019,9,KS,559,562,-3
2019,9,KY,924,978,-54
2019,9,LA,50185,51543,-1358
2019,9,MA,4093,4207,-114
2019,9,MD,4167,4311,-144
2019,9,ME,477,503,-26
2019,9,MI,931,927,4
2019,9,MN,428,448,-20
2019,9,MO,1019,1029,-10
2019,9,MS,4619,4743,-124
2019,9,MT,213,207,6
2019,9,NC,12278,11488,790
2019,9,ND,672,720,-48
2019,9,NE,380,353,27
2019,9,NH,502,492,10
2019,9,NJ,12781,13177,-396
2019,9,NM,588,619,-31
2019,9,NV,520,541,-21
2019,9,NY,14234,14583,-349
2019,9,OH,1601,1706,-105
2019,9,OK,789,800,-11
2019,9,OR,1430,1465,-35
2019,9,PA,3558,3675,-117
2019,9,PR,241,284,-43
2019,9,RI,1059,1087,-28
2019,9,SC,16933,16441,492
2019,9,SD,194,194,0
2019,9,TN,1760,1822,-62
2019,9,TX,66514,66843,-329
2019,9,UT,229,253,-24
2019,9,VA,9367,9445,-78
2019,9,VI,52,58,-6
2019,9,VT,182,190,-8
2019,9,WA,1749,1804,-55
2019,9,WI,774,782,-8
2019,9,WV,620,666,-46
2019,9,WY,75,82,-7
2019,10,AK,141,152,-11
2019,10,AL,3764,3985,-221
2019,10,AR,710,769,-59
2019,10,AZ,1959,2156,-197
2019,10,CA,15597,16207,-610
2019,10,CO,1427,1465,-38
2019,10,CT,2356,2377,-21
2019,10,DC,217,254,-37
2019,10,DE,2344,2427,-83
2019,10,FL,130337,133480,-3143
2019,10,GA,8166,8858,-692
2019,10,HI,6196,5960,236
2019,10,IA,665,675,-10
2019,10,ID,309,303,6
2019,10,IL,1893,1845,48
2019,10,IN,1128,1216,-88
2019,10,KS,531,586,-55
2019,10,KY,852,916,-64
2019,10,LA,38715,39660,-945
2019,10,MA,5120,5321,-201
2019,10,MD,5127,5472,-345
2019,10,ME,743,761,-18
2019,10,MI,954,953,1
2019,10,MN,527,558,-31
2019,10,MO,1005,1018,-13
2019,10,MS,4012,4218,-206
2019,10,MT,198,208,-10
2019,10,NC,13323,14406,-1083
2019,10,ND,552,587,-35
2019,10,NE,386,337,49
2019,10,NH,411,423,-12
2019,10,NJ,12705,13132,-427
2019,10,NM,550,585,-35
2019,10,NV,555,600,-45
2019,10,NY,14488,15070,-582
2019,10,OH,1661,1792,-131
2019,10,OK,872,883,-11
2019,10,OR,1697,1750,-53
2019,10,PA,4212,4499,-287
2019,10,PR,192,182,10
2019,10,RI,909,948,-39
2019,10,SC,17948,18898,-950
2019,10,SD,164,158,6
2019,10,TN,1887,2006,-119
2019,10,TX,81458,81318,140
2019,10,UT,381,477,-96
2019,10,VA,12199,13377,-1178
2019,10,VI,43,45,-2
2019,10,VT,216,220,-4
2019,10,WA,2265,2278,-13
2019,10,WI,723,767,-44
2019,10,WV,610,657,-47
2019,10,WY,84,85,-1
2019,11,AK,176,176,0
2019,11,AL,3118,3125,-7
2019,11,AR,559,598,-39
2019,11,AZ,1424,1507,-83
2019,11,CA,18973,20040,-1067
2019,11,CO,1104,1128,-24
2019,11,CT,1819,2112,-293
2019,11,DC,153,162,-9
2019,11,DE,1408,1437,-29
2019,11,FL,93398,95995,-2597
2019,11,GA,5066,5428,-362
2019,11,GU,1,0,1
2019,11,HI,3606,3631,-25
2019,11,IA,555,527,28
2019,11,ID,292,266,26
2019,11,IL,1446,1433,13
2019,11,IN,956,996,-40
2019,11,KS,442,478,-36
2019,11,KY,820,849,-29
2019,11,LA,27009,27207,-198
2019,11,MA,3548,3630,-82
2019,11,MD,3637,3751,-114
2019,11,ME,513,516,-3
2019,11,MI,844,735,109
2019,11,MN,541,500,41
2019,11,MO,918,930,-12
2019,11,MS,3616,3712,-96
2019,11,MT,173,177,-4
2019,11,NC,9850,10305,-455
2019,11,ND,466,380,86
2019,11,NE,321,273,48
2019,11,NH,462,467,-5
2019,11,NJ,12165,12322,-157
2019,11,NM,445,460,-15
2019,11,NV,503,544,-41
2019,11,NY,10425,10705,-280
2019,11,OH,1322,1364,-42
2019,11,OK,734,697,37
2019,11,OR,1915,1923,-8
2019,11,PA,2890,3032,-142
2019,11,PR,130,179,-49
2019,11,RI,638,688,-50
2019,11,SC,12676,13149,-473
2019,11,SD,154,137,17
2019,11,TN,1626,1632,-6
2019,11,TX,46783,45943,840
2019,11,UT,282,367,-85
2019,11,VA,6581,7231,-650
2019,11,VI,31,27,4
2019,11,VT,214,219,-5
2019,11,WA,2608,2664,-56
2019,11,WI,563,518,45
2019,11,WV,524,562,-38
2019,11,WY,93,96,-3
2019,12,AK,98,103,-5
2019,12,AL,2670,2742,-72
2019,12,AR,526,551,-25
2019,12,AZ,1350,1385,-35
2019,12,CA,19828,21088,-1260
2019,12,CO,937,1021,-84
2019,12,CT,1898,1890,8
2019,12,DC,111,157,-46
2019,12,DE,1277,1280,-3
2019,12,FL,92165,93828,-1663
2019,12,GA,4066,4300,-234
2019,12,GU,3,4,-1
2019,12,HI,3518,3561,-43
2019,12,IA,450,466,-16
2019,12,ID,280,250,30
2019,12,IL,1274,1299,-25
2019,12,IN,722,779,-57
2019,12,KS,371,395,-24
2019,12,KY,692,730,-38
2019,12,LA,24046,24156,-110
2019,12,MA,3143,3523,-380
2019,12,MD,3497,3537,-40
2019,12,ME,464,490,-26
2019,12,MI,804,717,87
2019,12,MN,478,353,125
2019,12,MO,780,821,-41
2019,12,MS,3178,3276,-98
2019,12,MT,137,149,-12
2019,12,NC,7587,7783,-196
2019,12,ND,428,380,48
2019,12,NE,270,251,19
2019,12,NH,371,391,-20
2019,12,NJ,9610,9894,-284
2019,12,NM,401,421,-20
2019,12,NV,457,479,-22
2019,12,NY,11152,11468,-316
2019,12,OH,1308,1353,-45
2019,12,OK,585,565,20
2019,12,OR,1599,1656,-57
2019,12,PA,2666,2773,-107
2019,12,PR,132,176,-44
2019,12,RI,621,663,-42
2019,12,SC,11194,11356,-162
2019,12,SD,126,129,-3
2019,12,TN,1375,1381,-6
2019,12,TX,37172,36279,893
2019,12,UT,233,217,16
2019,12,VA,5129,5196,-67
2019,12,VI,59,63,-4
2019,12,VT,141,139,2
2019,12,WA,2233,2317,-84
2019,12,WI,629,609,20
2019,12,WV,460,473,-13
2019,12,WY,84,80,4
2020,1,AK,110,113,-3
2020,1,AL,1992,2066,-74
2020,1,AR,483,490,-7
2020,1,AZ,1239,1232,7
2020,1,CA,15715,16557,-842
2020,1,CO,836,888,-52
2020,1,CT,1567,1627,-60
2020,1,DC,118,116,2
2020,1,DE,1389,1395,-6
2020,1,FL,93954,95437,-1483
2020,1,GA,5488,5590,-102
2020,1,HI,2342,2344,-2
2020,1,IA,425,404,21
2020,1,ID,222,211,11
2020,1,IL,1262,1211,51
2020,1,IN,746,788,-42
2020,1,KS,409,423,-14
2020,1,KY,622,634,-12
2020,1,LA,21212,21420,-208
2020,1,MA,2334,2412,-78
2020,1,MD,3037,3091,-54
2020,1,ME,387,406,-19
2020,1,MI,784,648,136
2020,1,MN,324,305,19
2020,1,MO,681,694,-13
2020,1,MS,2935,2988,-53
2020,1,MT,145,143,2
2020,1,NC,7116,7221,-105
2020,1,ND,635,610,25
2020,1,NE,293,272,21
2020,1,NH,275,282,-7
2020,1,NJ,8496,8760,-264
2020,1,NM,377,391,-14
2020,1,NV,458,506,-48
2020,1,NY,9731,9722,9
2020,1,OH,1060,1100,-40
2020,1,OK,464,493,-29
2020,1,OR,1690,1542,148
2020,1,PA,2356,2460,-104
2020,1,PR,95,109,-14
2020,1,RI,624,642,-18
2020,1,SC,9604,9734,-130
2020,1,SD,125,94,31
2020,1,TN,1117,1116,1
2020,1,TX,30274,29635,639
2020,1,UT,163,167,-4
2020,1,VA,4374,4425,-51
2020,1,VI,21,24,-3
2020,1,VT,138,133,5
2020,1,WA,1992,1970,22
2020,1,WI,628,622,6
2020,1,WV,405,440,-35
2020,1,WY,49,53,-4
2020,2,AK,91,97,-6
2020,2,AL,2972,3010,-38
2020,2,AR,579,589,-10
2020,2,AZ,1208,1275,-67
2020,2,CA,14480,15316,-836
2020,2,CO,1045,1057,-12
2020,2,CT,1088,1130,-42
2020,2,DC,161,114,47
2020,2,DE,932,937,-5
2020,2,FL,87639,88574,-935
2020,2,GA,3759,3866,-107
2020,2,HI,4893,4879,14
2020,2,IA,563,551,12
2020,2,ID,379,394,-15
2020,2,IL,1675,1679,-4
2020,2,IN,852,894,-42
2020,2,KS,392,426,-34
2020,2,KY,678,703,-25
2020,2,LA,24839,24812,27
2020,2,MA,2742,2800,-58
2020,2,MD,2387,2419,-32
2020,2,ME,370,391,-21
2020,2,MI,883,744,139
2020,2,MN,723,532,191
2020,2,MO,758,768,-10
2020,2,MS,3634,3564,70
2020,2,MT,233,260,-27
2020,2,NC,7233,7183,50
2020,2,ND,1650,779,871
2020,2,NE,407,341,66
2020,2,NH,270,273,-3
2020,2,NJ,8415,8627,-212
2020,2,NM,401,385,16
2020,2,NV,512,581,-69
2020,2,NY,9743,9831,-88
2020,2,OH,1297,1361,-64
2020,2,OK,523,539,-16
2020,2,OR,1610,1651,-41
2020,2,PA,2765,2881,-116
2020,2,PR,136,139,-3
2020,2,RI,649,671,-22
2020,2,SC,9232,9217,15
2020,2,SD,185,119,66
2020,2,TN,1278,1262,16
2020,2,TX,33075,31415,1660
2020,2,UT,299,299,0
2020,2,VA,4399,4499,-100
2020,2,VI,20,22,-2
2020,2,VT,166,170,-4
2020,2,WA,1825,1792,33
2020,2,WI,528,469,59
2020,2,WV,524,552,-28
2020,2,WY,82,86,-4
2020,3,AK,108,112,-4
2020,3,AL,2620,2653,-33
2020,3,AR,727,745,-18
2020,3,AZ,1322,1368,-46
2020,3,CA,13860,15248,-1388
2020,3,CO,1238,1287,-49
2020,3,CT,1461,1524,-63
2020,3,DC,105,107,-2
2020,3,DE,1202,1157,45
2020,3,FL,107472,107946,-474
2020,3,GA,4843,4914,-71
2020,3,HI,2673,2671,2
2020,3,IA,1013,1069,-56
2020,3,ID,558,700,-142
2020,3,IL,2047,2110,-63
2020,3,IN,1146,1199,-53
2020,3,KS,564,587,-23
2020,3,KY,943,974,-31
2020,3,LA,31691,31963,-272
2020,3,MA,3092,3169,-77
2020,3,MD,3489,3508,-19
2020,3,ME,405,439,-34
2020,3,MI,1089,965,124
2020,3,MN,1964,1632,332
2020,3,MO,1318,1316,2
2020,3,MP,1,1,0
2020,3,MS,4517,4450,67
2020,3,MT,467,559,-92
2020,3,NC,8910,8827,83
2020,3,ND,4690,2000,2690
2020,3,NE,505,415,90
2020,3,NH,368,383,-15
2020,3,NJ,9080,9310,-230
2020,3,NM,471,494,-23
2020,3,NV,573,609,-36
2020,3,NY,10743,10860,-117
2020,3,OH,1444,1512,-68
2020,3,OK,621,614,7
2020,3,OR,1306,1305,1
2020,3,PA,3099,3255,-156
2020,3,PR,170,298,-128
2020,3,RI,523,537,-14
2020,3,SC,13347,12665,682
2020,3,SD,442,370,72
2020,3,TN,2117,2125,-8
2020,3,TX,41939,40057,1882
2020,3,UT,281,288,-7
2020,3,VA,6004,6081,-77
2020,3,VI,64,64,0
2020,3,VT,205,214,-9
2020,3,WA,2011,1979,32
2020,3,WI,1108,858,250
2020,3,WV,606,621,-15
2020,3,WY,131,144,-13
2020,4,AK,128,135,-7
2020,4,AL,4260,4337,-77
2020,4,AR,673,714,-41
2020,4,AZ,1282,1315,-33
2020,4,CA,10833,11227,-394
2020,4,CO,1515,1711,-196
2020,4,CT,1452,1484,-32
2020,4,DC,105,109,-4
2020,4,DE,1300,1299,1
2020,4,FL,121303,122114,-811
2020,4,GA,4860,4888,-28
2020,4,HI,3898,3730,168
2020,4,IA,1255,1539,-284
2020,4,ID,459,672,-213
2020,4,IL,2218,2206,12
2020,4,IN,1052,1114,-62
2020,4,KS,674,759,-85
2020,4,KY,854,883,-29
2020,4,LA,37532,37886,-354
2020,4,MA,2272,2328,-56
2020,4,MD,2930,2978,-48
2020,4,ME,499,545,-46
2020,4,MI,998,923,75
2020,4,MN,1957,3581,-1624
2020,4,MO,1538,1677,-139
2020,4,MS,4748,4783,-35
2020,4,MT,479,698,-219
2020,4,NC,9022,8881,141
2020,4,ND,1776,2291,-515
2020,4,NE,582,696,-114
2020,4,NH,316,327,-11
2020,4,NJ,9640,9905,-265
2020,4,NM,448,476,-28
2020,4,NV,482,511,-29
2020,4,NY,10094,10026,68
2020,4,OH,1572,1532,40
2020,4,OK,728,725,3
2020,4,OR,1438,1488,-50
2020,4,PA,2738,2865,-127
2020,4,PR,155,178,-23
2020,4,RI,670,688,-18
2020,4,SC,12566,12380,186
2020,4,SD,508,605,-97
2020,4,TN,1856,1889,-33
2020,4,TX,46697,45029,1668
2020,4,UT,301,376,-75
2020,4,VA,5494,5605,-111
2020,4,VI,81,84,-3
2020,4,VT,184,179,5
2020,4,WA,1584,1627,-43
2020,4,WI,1090,1402,-312
2020,4,WV,625,637,-12
2020,4,WY,197,250,-53
2020,5,AK,156,142,14
2020,5,AL,3950,3882,68
2020,5,AR,621,660,-39
2020,5,AZ,1378,1434,-56
2020,5,CA,9570,9860,-290
2020,5,CO,1672,1794,-122
2020,5,CT,1466,1499,-33
2020,5,DC,356,357,-1
2020,5,DE,1548,1551,-3
2020,5,FL,131862,131882,-20
2020,5,GA,6158,6158,0
2020,5,HI,3898,3916,-18
2020,5,IA,828,863,-35
2020,5,ID,674,706,-32
2020,5,IL,1969,2093,-124
2020,5,IN,928,991,-63
2020,5,KS,613,679,-66
2020,5,KY,881,907,-26
2020,5,LA,43036,42607,429
2020,5,MA,2711,2759,-48
2020,5,MD,2773,2818,-45
2020,5,ME,358,373,-15
2020,5,MI,983,946,37
2020,5,MN,496,511,-15
2020,5,MO,1090,1143,-53
2020,5,MS,5537,5548,-11
2020,5,MT,389,431,-42
2020,5,NC,10689,10403,286
2020,5,ND,405,425,-20
2020,5,NE,487,506,-19
2020,5,NH,329,326,3
2020,5,NJ,10479,10547,-68
2020,5,NM,451,479,-28
2020,5,NV,526,534,-8
2020,5,NY,12020,12271,-251
2020,5,OH,1286,1297,-11
2020,5,OK,815,858,-43
2020,5,OR,1186,1302,-116
2020,5,PA,2933,3044,-111
2020,5,PR,197,256,-59
2020,5,RI,574,586,-12
2020,5,SC,15297,14767,530
2020,5,SD,235,260,-25
2020,5,TN,1635,1677,-42
2020,5,TX,71378,65911,5467
2020,5,UT,272,405,-133
2020,5,VA,6425,6498,-73
2020,5,VI,51,56,-5
2020,5,VT,138,145,-7
2020,5,WA,1552,1587,-35
2020,5,WI,700,698,2
2020,5,WV,520,531,-11
2020,5,WY,143,155,-12
2020,6,AK,114,118,-4
2020,6,AL,4296,4372,-76
2020,6,AR,817,923,-106
2020,6,AZ,1392,1466,-74
2020,6,CA,9292,9577,-285
2020,6,CO,1558,1752,-194
2020,6,CT,1574,1643,-69
2020,6,DC,360,363,-3
2020,6,DE,1638,1633,5
2020,6,FL,153746,153861,-115
2020,6,GA,6869,6831,38
2020,6,HI,4177,4064,113
2020,6,IA,691,768,-77
2020,6,ID,433,431,2
2020,6,IL,2131,2108,23
2020,6,IN,984,1041,-57
2020,6,KS,769,1081,-312
2020,6,KY,903,941,-38
2020,6,LA,53075,51807,1268
2020,6,MA,3001,3112,-111
2020,6,MD,4001,3793,208
2020,6,ME,358,360,-2
2020,6,MI,1287,1139,148
2020,6,MN,412,457,-45
2020,6,MO,1058,1175,-117
2020,6,MS,6236,6197,39
2020,6,MT,416,416,0
2020,6,NC,17819,17068,751
2020,6,ND,491,522,-31
2020,6,NE,463,502,-39
2020,6,NH,336,327,9
2020,6,NJ,11699,11886,-187
2020,6,NM,413,451,-38
2020,6,NV,414,442,-28
2020,6,NY,11219,11596,-377
2020,6,OH,1523,1537,-14
2020,6,OK,1051,1291,-240
2020,6,OR,1255,1333,-78
2020,6,PA,2590,2682,-92
2020,6,PR,189,311,-122
2020,6,RI,676,686,-10
2020,6,SC,17661,17299,362
2020,6,SD,257,270,-13
2020,6,TN,2253,2395,-142
2020,6,TX,106306,98806,7500
2020,6,UT,256,234,22
2020,6,VA,8299,8386,-87
2020,6,VI,124,138,-14
2020,6,VT,145,152,-7
2020,6,WA,1675,1716,-41
2020,6,WI,621,621,0
2020,6,WV,517,540,-23
2020,6,WY,114,114,0
2020,7,AK,121,123,-2
2020,7,AL,4167,4179,-12
2020,7,AR,780,818,-38
2020,7,AZ,1923,1749,174
2020,7,CA,9561,9905,-344
2020,7,CO,1301,1464,-163
2020,7,CT,2003,2043,-40
2020,7,DC,161,164,-3
2020,7,DE,1809,1811,-2
2020,7,FL,155980,153331,2649
2020,7,GA,7872,7937,-65
2020,7,HI,3629,3497,132
2020,7,IA,909,958,-49
2020,7,ID,332,276,56
2020,7,IL,2251,2948,-697
2020,7,IN,1186,1298,-112
2020,7,KS,675,702,-27
2020,7,KY,877,938,-61
2020,7,LA,58149,56420,1729
2020,7,MA,3292,3205,87
2020,7,MD,4895,5001,-106
2020,7,ME,501,493,8
2020,7,MI,1318,1172,146
2020,7,MN,493,529,-36
2020,7,MO,1105,1197,-92
2020,7,MS,6132,5998,134
2020,7,MT,266,280,-14
2020,7,NC,14193,13791,402
2020,7,ND,372,440,-68
2020,7,NE,494,506,-12
2020,7,NH,365,406,-41
2020,7,NJ,12444,12817,-373
2020,7,NM,550,582,-32
2020,7,NV,405,425,-20
2020,7,NY,11491,11970,-479
2020,7,OH,1672,1749,-77
2020,7,OK,994,1064,-70
2020,7,OR,1104,1164,-60
2020,7,PA,2906,3023,-117
2020,7,PR,211,291,-80
2020,7,RI,795,839,-44
2020,7,SC,18942,18597,345
2020,7,SD,194,199,-5
2020,7,TN,1938,2003,-65
2020,7,TX,123012,112371,10641
2020,7,UT,228,222,6
2020,7,VA,9834,9988,-154
2020,7,VI,32,30,2
2020,7,VT,169,179,-10
2020,7,WA,1512,1549,-37
2020,7,WI,727,757,-30
2020,7,WV,564,593,-29
2020,7,WY,105,106,-1
2020,8,AK,129,130,-1
2020,8,AL,3672,3675,-3
2020,8,AR,791,825,-34
2020,8,AZ,2459,2391,68
2020,8,CA,9641,9917,-276
2020,8,CO,1349,1449,-100
2020,8,CT,2257,2302,-45
2020,8,DC,244,260,-16
2020,8,DE,1876,1896,-20
2020,8,FL,130734,130195,539
2020,8,GA,7696,7823,-127
2020,8,HI,7373,7353,20
2020,8,IA,724,729,-5
2020,8,ID,349,265,84
2020,8,IL,2104,2045,59
2020,8,IN,1098,1151,-53
2020,8,KS,503,525,-22
2020,8,KY,954,972,-18
2020,8,LA,48762,48491,271
2020,8,MA,3880,4023,-143
2020,8,MD,4009,4113,-104
2020,8,ME,509,470,39
2020,8,MI,1045,997,48
2020,8,MN,462,497,-35
2020,8,MO,1016,1040,-24
2020,8,MS,5371,5359,12
2020,8,MT,218,221,-3
2020,8,NC,14209,13824,385
2020,8,ND,418,459,-41
2020,8,NE,386,418,-32
2020,8,NH,333,333,0
2020,8,NJ,12880,13057,-177
2020,8,NM,675,694,-19
2020,8,NV,546,577,-31
2020,8,NY,12146,12641,-495
2020,8,OH,1669,1741,-72
2020,8,OK,794,855,-61
2020,8,OR,1201,1289,-88
2020,8,PA,3576,3695,-119
2020,8,PR,217,216,1
2020,8,RI,1245,1299,-54
2020,8,SC,18956,18785,171
2020,8,SD,227,247,-20
2020,8,TN,1971,2059,-88
2020,8,TX,81949,76923,5026
2020,8,UT,264,233,31
2020,8,VA,9780,9904,-124
2020,8,VI,62,63,-1
2020,8,VT,173,169,4
2020,8,WA,1887,1833,54
2020,8,WI,638,674,-36
2020,8,WV,612,650,-38
2020,8,WY,114,112,2
2020,9,AK,158,162,-4
2020,9,AL,4017,4003,14
2020,9,AR,742,759,-17
2020,9,AZ,1931,2046,-115
2020,9,CA,10973,11080,-107
2020,9,CO,1438,1458,-20
2020,9,CT,2225,2303,-78
2020,9,DC,192,177,15
2020,9,DE,1914,1901,13
2020,9,FL,123735,124608,-873
2020,9,GA,7237,7444,-207
2020,9,HI,7933,7951,-18
2020,9,IA,793,828,-35
2020,9,ID,296,268,28
2020,9,IL,1650,1685,-35
2020,9,IN,1003,1050,-47
2020,9,KS,536,554,-18
2020,9,KY,941,958,-17
2020,9,LA,51504,50692,812
2020,9,MA,4161,4308,-147
2020,9,MD,4676,4640,36
2020,9,ME,508,496,12
2020,9,MI,1089,1011,78
2020,9,MN,434,466,-32
2020,9,MO,993,1030,-37
2020,9,MS,4763,4715,48
2020,9,MT,227,224,3
2020,9,NC,12778,12861,-83
2020,9,ND,678,730,-52
2020,9,NE,377,390,-13
2020,9,NH,506,524,-18
2020,9,NJ,12837,13136,-299
2020,9,NM,589,621,-32
2020,9,NV,499,528,-29
2020,9,NY,14062,14351,-289
2020,9,OH,1542,1643,-101
2020,9,OK,753,801,-48
2020,9,OR,1398,1474,-76
2020,9,PA,3632,3570,62
2020,9,PR,270,247,23
2020,9,RI,1210,1277,-67
2020,9,SC,17622,17726,-104
2020,9,SD,166,186,-20
2020,9,TN,1808,1830,-22
2020,9,TX,72451,67313,5138
2020,9,UT,262,243,19
2020,9,VA,9836,9817,19
2020,9,VI,58,54,4
2020,9,VT,186,210,-24
2020,9,WA,1918,1831,87
2020,9,WI,766,799,-33
2020,9,WV,596,625,-29
2020,9,WY,69,88,-19
2020,10,AK,151,165,-14
2020,10,AL,3829,3751,78
2020,10,AR,686,722,-36
2020,10,AZ,1928,2039,-111
2020,10,CA,15590,16043,-453
2020,10,CO,1406,1494,-88
2020,10,CT,2444,2575,-131
2020,10,DC,263,235,28
2020,10,DE,2219,2265,-46
2020,10,FL,129647,132718,-3071
2020,10,GA,7737,8091,-354
2020,10,HI,5480,5517,-37
2020,10,IA,671,672,-1
2020,10,ID,409,397,12
2020,10,IL,1849,1960,-111
2020,10,IN,1070,1140,-70
2020,10,KS,513,566,-53
2020,10,KY,835,864,-29
2020,10,LA,39759,39607,152
2020,10,MA,5329,5457,-128
2020,10,MD,5149,5257,-108
2020,10,ME,769,785,-16
2020,10,MI,1061,1022,39
2020,10,MN,512,553,-41
2020,10,MO,971,1013,-42
2020,10,MS,4092,4072,20
2020,10,MT,220,229,-9
2020,10,NC,13079,13720,-641
2020,10,ND,542,596,-54
2020,10,NE,345,378,-33
2020,10,NH,416,416,0
2020,10,NJ,12426,12870,-444
2020,10,NM,549,579,-30
2020,10,NV,537,572,-35
2020,10,NY,13995,14559,-564
2020,10,OH,1596,1695,-99
2020,10,OK,828,882,-54
2020,10,OR,1902,1653,249
2020,10,PA,4210,4284,-74
2020,10,PR,142,203,-61
2020,10,RI,893,926,-33
2020,10,SC,17543,18240,-697
2020,10,SD,155,178,-23
2020,10,TN,1982,1986,-4
2020,10,TX,80502,84031,-3529
2020,10,UT,336,381,-45
2020,10,VA,11772,12497,-725
2020,10,VI,40,41,-1
2020,10,VT,220,226,-6
2020,10,WA,2683,2426,257
2020,10,WI,687,719,-32
2020,10,WV,590,614,-24
2020,10,WY,88,88,0
2020,11,AK,157,162,-5
2020,11,AL,3261,3298,-37
2020,11,AR,505,537,-32
2020,11,AZ,1342,1425,-83
2020,11,CA,18054,19053,-999
2020,11,CO,1305,1290,15
2020,11,CT,1775,1806,-31
2020,11,DC,163,152,11
2020,11,DE,1486,1504,-18
2020,11,FL,92481,93602,-1121
2020,11,GA,4928,5104,-176
2020,11,GU,1,1,0
2020,11,HI,3959,3794,165
2020,11,IA,573,632,-59
2020,11,ID,303,296,7
2020,11,IL,1378,1447,-69
2020,11,IN,919,964,-45
2020,11,KS,401,422,-21
2020,11,KY,734,807,-73
2020,11,LA,27016,27055,-39
2020,11,MA,3441,3605,-164
2020,11,MD,3815,3822,-7
2020,11,ME,506,538,-32
2020,11,MI,919,906,13
2020,11,MN,467,517,-50
2020,11,MO,848,898,-50
2020,11,MS,3621,3635,-14
2020,11,MT,170,176,-6
2020,11,NC,9906,10425,-519
2020,11,ND,406,503,-97
2020,11,NE,292,303,-11
2020,11,NH,471,466,5
2020,11,NJ,12691,12781,-90
2020,11,NM,432,453,-21
2020,11,NV,454,502,-48
2020,11,NY,10109,10498,-389
2020,11,OH,1236,1306,-70
2020,11,OK,683,731,-48
2020,11,OR,1887,1888,-1
2020,11,PA,2801,2878,-77
2020,11,PR,143,125,18
2020,11,RI,647,617,30
2020,11,SC,12528,12881,-353
2020,11,SD,139,156,-17
2020,11,TN,1550,1613,-63
2020,11,TX,44652,46394,-1742
2020,11,UT,265,293,-28
2020,11,VA,6322,6554,-232
2020,11,VI,26,29,-3
2020,11,VT,209,214,-5
2020,11,WA,2662,2626,36
2020,11,WI,533,557,-24
2020,11,WV,510,534,-24
2020,11,WY,88,94,-6
2020,12,AK,91,91,0
2020,12,AL,2979,3028,-49
2020,12,AR,509,529,-20
2020,12,AZ,1339,1384,-45
2020,12,CA,18795,19744,-949
2020,12,CO,928,956,-28
2020,12,CT,1848,1911,-63
2020,12,DC,117,116,1
2020,12,DE,1225,1263,-38
2020,12,FL,94199,95515,-1316
2020,12,GA,4071,4143,-72
2020,12,GU,2,3,-1
2020,12,HI,3961,3947,14
2020,12,IA,474,466,8
2020,12,ID,279,274,5
2020,12,IL,1451,1494,-43
2020,12,IN,673,712,-39
2020,12,KS,337,362,-25
2020,12,KY,717,720,-3
2020,12,LA,24431,24697,-266
2020,12,MA,3145,3291,-146
2020,12,MD,3473,3554,-81
2020,12,ME,514,528,-14
2020,12,MI,867,897,-30
2020,12,MN,456,484,-28
2020,12,MO,752,767,-15
2020,12,MS,3230,3282,-52
2020,12,MT,146,143,3
2020,12,NC,7537,7739,-202
2020,12,ND,372,444,-72
2020,12,NE,254,269,-15
2020,12,NH,333,334,-1
2020,12,NJ,9814,10145,-331
2020,12,NM,374,392,-18
2020,12,NV,433,461,-28
2020,12,NY,11050,11283,-233
2020,12,OH,1211,1293,-82
2020,12,OK,532,596,-64
2020,12,OR,1600,1596,4
2020,12,PA,2623,2692,-69
2020,12,PR,144,130,14
2020,12,RI,595,603,-8
2020,12,SC,11286,11453,-167
2020,12,SD,119,131,-12
2020,12,TN,1358,1375,-17
2020,12,TX,38122,39601,-1479
2020,12,UT,300,242,58
2020,12,VA,5045,5146,-101
2020,12,VI,57,58,-1
2020,12,VT,154,143,11
2020,12,WA,2331,2249,82
2020,12,WI,608,627,-19
2020,12,WV,446,480,-34
2020,12,WY,77,86,-9
2021,1,AK,120,106,14
2021,1,AL,1943,1989,-46
2021,1,AR,476,497,-21
2021,1,AZ,1108,1224,-116
2021,1,CA,16050,16418,-368
2021,1,CO,776,799,-23
2021,1,CT,1428,1461,-33
2021,1,DC,113,110,3
2021,1,DE,1557,1546,11
2021,1,FL,89847,91139,-1292
2021,1,GA,3645,3809,-164
2021,1,HI,2605,2544,61
2021,1,IA,413,452,-39
2021,1,ID,229,243,-14
2021,1,IL,1206,1280,-74
2021,1,IN,700,756,-56
2021,1,KS,364,387,-23
2021,1,KY,601,632,-31
2021,1,LA,23350,23678,-328
2021,1,MA,2209,2281,-72
2021,1,MD,3026,3073,-47
2021,1,ME,374,381,-7
2021,1,MI,823,842,-19
2021,1,MN,283,318,-35
2021,1,MO,642,675,-33
2021,1,MS,2825,2900,-75
2021,1,MT,143,153,-10
2021,1,NC,6880,7086,-206
2021,1,ND,549,640,-91
2021,1,NE,270,280,-10
2021,1,NH,349,342,7
2021,1,NJ,8211,8369,-158
2021,1,NM,358,387,-29
2021,1,NV,426,462,-36
2021,1,NY,9767,9850,-83
2021,1,OH,969,1048,-79
2021,1,OK,426,454,-28
2021,1,OR,1803,1807,-4
2021,1,PA,2502,2515,-13
2021,1,PR,88,97,-9
2021,1,RI,599,634,-35
2021,1,SC,18808,18874,-66
2021,1,SD,105,130,-25
2021,1,TN,1070,1105,-35
2021,1,TX,30797,31604,-807
2021,1,UT,144,158,-14
2021,1,VA,4001,4111,-110
2021,1,VI,20,23,-3
2021,1,VT,132,133,-1
2021,1,WA,1988,1997,-9
2021,1,WI,568,600,-32
2021,1,WV,365,400,-35
2021,1,WY,51,45,6
2021,2,AK,96,93,3
2021,2,AL,3288,3305,-17
2021,2,AR,541,567,-26
2021,2,AZ,1164,1231,-67
2021,2,CA,14538,15202,-664
2021,2,CO,987,1014,-27
2021,2,CT,1081,1109,-28
2021,2,DC,171,156,15
2021,2,DE,1105,1091,14
2021,2,FL,85206,86232,-1026
2021,2,GA,3659,3842,-183
2021,2,HI,4418,4580,-162
2021,2,IA,489,528,-39
2021,2,ID,395,395,0
2021,2,IL,1571,1654,-83
2021,2,IN,821,855,-34
2021,2,KS,353,365,-12
2021,2,KY,799,794,5
2021,2,LA,25696,25954,-258
2021,2,MA,2581,2652,-71
2021,2,MD,2325,2382,-57
2021,2,ME,361,363,-2
2021,2,MI,867,875,-8
2021,2,MN,434,640,-206
2021,2,MO,692,721,-29
2021,2,MS,3615,3723,-108
2021,2,MT,239,247,-8
2021,2,NC,7122,7353,-231
2021,2,ND,747,1572,-825
2021,2,NE,340,384,-44
2021,2,NH,302,283,19
2021,2,NJ,8500,8668,-168
2021,2,NM,376,397,-21
2021,2,NV,450,502,-52
2021,2,NY,9961,10282,-321
2021,2,OH,1215,1290,-75
2021,2,OK,471,515,-44
2021,2,OR,1314,1351,-37
2021,2,PA,2686,2762,-76
2021,2,PR,104,127,-23
2021,2,RI,649,665,-16
2021,2,SC,9491,9627,-136
2021,2,SD,131,190,-59
2021,2,TN,1386,1422,-36
2021,2,TX,32736,33365,-629
2021,2,UT,272,286,-14
2021,2,VA,4228,4373,-145
2021,2,VI,18,19,-1
2021,2,VT,158,165,-7
2021,2,WA,1870,1857,13
2021,2,WI,429,491,-62
2021,2,WV,489,510,-21
2021,2,WY,76,79,-3
2021,3,AK,101,104,-3
2021,3,AL,2545,2645,-100
2021,3,AR,688,720,-32
2021,3,AZ,1197,1351,-154
2021,3,CA,13073,13808,-735
2021,3,CO,1125,1153,-28
2021,3,CT,1355,1437,-82
2021,3,DC,104,104,0
2021,3,DE,1241,1254,-13
2021,3,FL,108304,110815,-2511
2021,3,GA,4772,4969,-197
2021,3,HI,2162,2738,-576
2021,3,IA,943,1012,-69
2021,3,ID,546,567,-21
2021,3,IL,1912,2030,-118
2021,3,IN,1082,1142,-60
2021,3,KS,523,555,-32
2021,3,KY,976,1001,-25
2021,3,LA,32902,33377,-475
2021,3,MA,3023,3119,-96
2021,3,MD,3661,3735,-74
2021,3,ME,387,407,-20
2021,3,MI,1127,1107,20
2021,3,MN,1123,1970,-847
2021,3,MO,1279,1306,-27
2021,3,MP,1,1,0
2021,3,MS,4451,4580,-129
2021,3,MT,423,459,-36
2021,3,NC,8911,9238,-327
2021,3,ND,1699,4587,-2888
2021,3,NE,452,498,-46
2021,3,NH,441,402,39
2021,3,NJ,9076,9321,-245
2021,3,NM,438,466,-28
2021,3,NV,530,561,-31
2021,3,NY,11176,11161,15
2021,3,OH,1360,1424,-64
2021,3,OK,603,621,-18
2021,3,OR,1491,1522,-31
2021,3,PA,2994,3099,-105
2021,3,PR,135,155,-20
2021,3,RI,532,563,-31
2021,3,SC,24024,24402,-378
2021,3,SD,270,431,-161
2021,3,TN,2013,2099,-86
2021,3,TX,41683,42546,-863
2021,3,UT,311,337,-26
2021,3,VA,5796,6033,-237
2021,3,VI,58,64,-6
2021,3,VT,201,206,-5
2021,3,WA,1915,2025,-110
2021,3,WI,969,1102,-133
2021,3,WV,596,622,-26
2021,3,WY,138,130,8
2021,4,AK,119,117,2
2021,4,AL,3898,3935,-37
2021,4,AR,613,645,-32
2021,4,AZ,1227,1261,-34
2021,4,CA,10729,11118,-389
2021,4,CO,1330,1415,-85
2021,4,CT,1387,1431,-44
2021,4,DC,104,103,1
2021,4,DE,1335,1346,-11
2021,4,FL,118886,121398,-2512
2021,4,GA,4813,4892,-79
2021,4,HI,4050,4016,34
2021,4,IA,1139,1268,-129
2021,4,ID,413,452,-39
2021,4,IL,2073,2127,-54
2021,4,IN,975,1015,-40
2021,4,KS,639,661,-22
2021,4,KY,971,860,111
2021,4,LA,37399,37499,-100
2021,4,MA,2311,2399,-88
2021,4,MD,2962,3045,-83
2021,4,ME,474,524,-50
2021,4,MI,977,985,-8
2021,4,MN,1398,1922,-524
2021,4,MO,1418,1489,-71
2021,4,MS,4746,4787,-41
2021,4,MT,432,480,-48
2021,4,NC,8866,9128,-262
2021,4,ND,1036,1757,-721
2021,4,NE,527,565,-38
2021,4,NH,378,334,44
2021,4,NJ,10037,10226,-189
2021,4,NM,471,493,-22
2021,4,NV,431,474,-43
2021,4,NY,9742,9952,-210
2021,4,OH,1457,1574,-117
2021,4,OK,713,719,-6
2021,4,OR,1425,1444,-19
2021,4,PA,2623,2724,-101
2021,4,PR,156,162,-6
2021,4,RI,614,632,-18
2021,4,SC,13149,13736,-587
2021,4,SD,333,491,-158
2021,4,TN,1786,1731,55
2021,4,TX,48163,47966,197
2021,4,UT,276,305,-29
2021,4,VA,5698,5695,3
2021,4,VI,74,79,-5
2021,4,VT,178,185,-7
2021,4,WA,1641,1660,-19
2021,4,WI,922,1049,-127
2021,4,WV,580,600,-20
2021,4,WY,187,187,0
2021,5,AK,142,149,-7
2021,5,AL,3928,4025,-97
2021,5,AR,596,617,-21
2021,5,AZ,1297,1359,-62
2021,5,CA,9081,9442,-361
2021,5,CO,1533,1635,-102
2021,5,CT,1374,1448,-74
2021,5,DC,108,117,-9
2021,5,DE,1663,1673,-10
2021,5,FL,127071,129288,-2217
2021,5,GA,5446,5965,-519
2021,5,GU,1,1,0
2021,5,HI,3814,3807,7
2021,5,IA,775,839,-64
2021,5,ID,657,670,-13
2021,5,IL,1831,1963,-132
2021,5,IN,842,915,-73
2021,5,KS,566,607,-41
2021,5,KY,936,895,41
2021,5,LA,42648,42634,14
2021,5,MA,2580,2680,-100
2021,5,MD,2771,2835,-64
2021,5,ME,339,347,-8
2021,5,MI,829,921,-92
2021,5,MN,453,504,-51
2021,5,MO,1008,1086,-78
2021,5,MS,5431,5511,-80
2021,5,MT,361,379,-18
2021,5,NC,9950,10331,-381
2021,5,ND,331,374,-43
2021,5,NE,446,471,-25
2021,5,NH,330,351,-21
2021,5,NJ,10186,10501,-315
2021,5,NM,425,458,-33
2021,5,NV,505,529,-24
2021,5,NY,11062,11447,-385
2021,5,OH,1314,1280,34
2021,5,OK,723,807,-84
2021,5,OR,1064,1106,-42
2021,5,PA,2808,2944,-136
2021,5,PR,172,191,-19
2021,5,RI,519,558,-39
2021,5,SC,14827,15309,-482
2021,5,SD,199,230,-31
2021,5,TN,1687,1608,79
2021,5,TX,67502,69821,-2319
2021,5,UT,260,278,-18
2021,5,VA,5965,6293,-328
2021,5,VI,49,52,-3
2021,5,VT,132,139,-7
2021,5,WA,1473,1544,-71
2021,5,WI,619,678,-59
2021,5,WV,482,511,-29
2021,5,WY,127,141,-14
2021,6,AK,111,110,1
2021,6,AL,3636,3790,-154
2021,6,AR,758,785,-27
2021,6,AZ,1322,1375,-53
2021,6,CA,9065,9186,-121
2021,6,CO,1482,1576,-94
2021,6,CT,1522,1559,-37
2021,6,DC,354,365,-11
2021,6,DE,1719,1731,-12
2021,6,FL,146900,150199,-3299
2021,6,GA,6673,6816,-143
2021,6,HI,3846,4197,-351
2021,6,IA,661,707,-46
2021,6,ID,348,387,-39
2021,6,IL,2368,2102,266
2021,6,IN,886,986,-100
2021,6,KS,675,754,-79
2021,6,KY,979,913,66
2021,6,LA,56155,52647,3508
2021,6,MA,2793,2944,-151
2021,6,MD,3921,4070,-149
2021,6,ME,303,339,-36
2021,6,MI,933,1148,-215
2021,6,MN,361,411,-50
2021,6,MO,1001,1059,-58
2021,6,MS,6108,6230,-122
2021,6,MT,377,395,-18
2021,6,NC,12116,12828,-712
2021,6,ND,447,485,-38
2021,6,NE,434,460,-26
2021,6,NH,329,338,-9
2021,6,NJ,11436,11763,-327
2021,6,NM,392,412,-20
2021,6,NV,371,396,-25
2021,6,NY,11161,11519,-358
2021,6,OH,1362,1484,-122
2021,6,OK,927,1023,-96
2021,6,OR,1181,1224,-43
2021,6,PA,2458,2621,-163
2021,6,PR,188,187,1
2021,6,RI,791,840,-49
2021,6,SC,16932,17545,-613
2021,6,SD,205,231,-26
2021,6,TN,2241,2262,-21
2021,6,TX,105408,104363,1045
2021,6,UT,244,258,-14
2021,6,VA,8218,8594,-376
2021,6,VI,122,127,-5
2021,6,VT,146,153,-7
2021,6,WA,1420,1520,-100
2021,6,WI,566,618,-52
2021,6,WV,450,495,-45
2021,6,WY,111,115,-4
2021,7,AK,110,121,-11
2021,7,AL,4166,4160,6
2021,7,AR,739,757,-18
2021,7,AZ,1808,1933,-125
2021,7,CA,9198,9368,-170
2021,7,CO,1195,1299,-104
2021,7,CT,1852,1923,-71
2021,7,DC,152,165,-13
2021,7,DE,1819,1806,13
2021,7,FL,148963,151551,-2588
2021,7,GA,7972,7902,70
2021,7,HI,4313,3307,1006
2021,7,IA,857,902,-45
2021,7,ID,284,312,-28
2021,7,IL,2306,2406,-100
2021,7,IN,1115,1161,-46
2021,7,KS,600,634,-34
2021,7,KY,859,887,-28
2021,7,LA,59332,56263,3069
2021,7,MA,3077,3270,-193
2021,7,MD,4714,4778,-64
2021,7,ME,482,498,-16
2021,7,MI,1208,1233,-25
2021,7,MN,418,467,-49
2021,7,MO,1056,1104,-48
2021,7,MS,6082,5981,101
2021,7,MT,261,275,-14
2021,7,NC,13552,13747,-195
2021,7,ND,338,370,-32
2021,7,NE,449,491,-42
2021,7,NH,359,374,-15
2021,7,NJ,11884,12154,-270
2021,7,NM,506,522,-16
2021,7,NV,411,417,-6
2021,7,NY,11122,11261,-139
2021,7,OH,1494,1623,-129
2021,7,OK,937,971,-34
2021,7,OR,1020,1061,-41
2021,7,PA,2709,2855,-146
2021,7,PR,241,207,34
2021,7,RI,741,769,-28
2021,7,SC,17805,18519,-714
2021,7,SD,169,179,-10
2021,7,TN,1867,1884,-17
2021,7,TX,118788,121198,-2410
2021,7,UT,396,215,181
2021,7,VA,9348,9701,-353
2021,7,VI,32,30,2
2021,7,VT,172,169,3
2021,7,WA,1461,1554,-93
2021,7,WI,648,726,-78
2021,7,WV,525,550,-25
2021,7,WY,97,103,-6
2021,8,AK,121,125,-4
2021,8,AL,3602,3633,-31
2021,8,AR,710,748,-38
2021,8,AZ,2234,2520,-286
2021,8,CA,9209,9443,-234
2021,8,CO,1298,1346,-48
2021,8,CT,2331,2345,-14
2021,8,DC,220,228,-8
2021,8,DE,1848,1833,15
2021,8,FL,134322,136772,-2450
2021,8,GA,7388,7564,-176
2021,8,HI,7280,7426,-146
2021,8,IA,680,713,-33
2021,8,ID,328,344,-16
2021,8,IL,1967,2045,-78
2021,8,IN,1046,1089,-43
2021,8,KS,474,500,-26
2021,8,KY,902,941,-39
2021,8,LA,48383,47747,636
2021,8,MA,3740,3762,-22
2021,8,MD,4093,3873,220
2021,8,ME,490,500,-10
2021,8,MI,1118,1003,115
2021,8,MN,392,452,-60
2021,8,MO,989,1055,-66
2021,8,MS,5013,5014,-1
2021,8,MT,215,219,-4
2021,8,NC,13078,13457,-379
2021,8,ND,376,415,-39
2021,8,NE,363,379,-16
2021,8,NH,318,320,-2
2021,8,NJ,12421,12671,-250
2021,8,NM,676,663,13
2021,8,NV,518,539,-21
2021,8,NY,12082,12102,-20
2021,8,OH,1555,1639,-84
2021,8,OK,768,803,-35
2021,8,OR,1207,1209,-2
2021,8,PA,3466,3481,-15
2021,8,PR,194,212,-18
2021,8,RI,1167,1189,-22
2021,8,SC,17680,18503,-823
2021,8,SD,201,211,-10
2021,8,TN,1885,1880,5
2021,8,TX,78981,80961,-1980
2021,8,UT,250,250,0
2021,8,VA,9221,9540,-319
2021,8,VI,51,61,-10
2021,8,VT,174,170,4
2021,8,WA,1544,1629,-85
2021,8,WI,591,640,-49
2021,8,WV,589,594,-5
2021,8,WY,92,98,-6
2021,9,AK,142,143,-1
2021,9,AL,4213,4176,37
2021,9,AR,708,745,-37
2021,9,AZ,1927,1866,61
2021,9,CA,10522,10816,-294
2021,9,CO,1333,1350,-17
2021,9,CT,2232,2189,43
2021,9,DC,188,186,2
2021,9,DE,1970,1956,14
2021,9,FL,117731,120641,-2910
2021,9,GA,6791,7031,-240
2021,9,HI,8497,8526,-29
2021,9,IA,729,786,-57
2021,9,ID,283,293,-10
2021,9,IL,1562,1601,-39
2021,9,IN,910,980,-70
2021,9,KS,484,528,-44
2021,9,KY,915,902,13
2021,9,LA,50518,50308,210
2021,9,MA,4069,3981,88
2021,9,MD,4151,4241,-90
2021,9,ME,508,513,-5
2021,9,MI,1120,1049,71
2021,9,MN,477,506,-29
2021,9,MO,915,976,-61
2021,9,MS,4630,4633,-3
2021,9,MT,205,216,-11
2021,9,NC,12203,12269,-66
2021,9,ND,598,643,-45
2021,9,NE,384,371,13
2021,9,NH,470,489,-19
2021,9,NJ,12934,13007,-73
2021,9,NM,586,576,10
2021,9,NV,457,476,-19
2021,9,NY,13950,13870,80
2021,9,OH,1484,1489,-5
2021,9,OK,692,721,-29
2021,9,OR,1362,1389,-27
2021,9,PA,3665,3645,20
2021,9,PR,218,256,-38
2021,9,RI,1002,1005,-3
2021,9,SC,16110,16676,-566
2021,9,SD,147,154,-7
2021,9,TN,2081,1847,234
2021,9,TX,70072,71105,-1033
2021,9,UT,325,253,72
2021,9,VA,9207,9511,-304
2021,9,VI,55,56,-1
2021,9,VT,182,168,14
2021,9,WA,1864,1893,-29
2021,9,WI,715,734,-19
2021,9,WV,589,590,-1
2021,9,WY,73,68,5
2021,10,AK,122,140,-18
2021,10,AL,3695,4048,-353
2021,10,AR,591,677,-86
2021,10,AZ,1565,1836,-271
2021,10,CA,13621,15252,-1631
2021,10,CO,1206,1350,-144
2021,10,CT,2287,2450,-163
2021,10,DC,209,246,-37
2021,10,DE,2089,2228,-139
2021,10,FL,115942,128488,-12546
2021,10,GA,6798,7583,-785
2021,10,HI,8359,8449,-90
2021,10,IA,592,676,-84
2021,10,ID,271,315,-44
2021,10,IL,1539,1766,-227
2021,10,IN,943,1067,-124
2021,10,KS,426,500,-74
2021,10,KY,731,837,-106
2021,10,LA,36068,39495,-3427
2021,10,MA,4742,5093,-351
2021,10,MD,4623,5041,-418
2021,10,ME,683,730,-47
2021,10,MI,840,1022,-182
2021,10,MN,427,499,-72
2021,10,MO,832,955,-123
2021,10,MS,3779,4170,-391
2021,10,MT,188,209,-21
2021,10,NC,11142,12513,-1371
2021,10,ND,466,528,-62
2021,10,NE,295,330,-35
2021,10,NH,374,431,-57
2021,10,NJ,11735,12406,-671
2021,10,NM,467,530,-63
2021,10,NV,460,513,-53
2021,10,NY,13100,13996,-896
2021,10,OH,1399,1578,-179
2021,10,OK,713,813,-100
2021,10,OR,1692,1861,-169
2021,10,PA,3770,4139,-369
2021,10,PR,97,131,-34
2021,10,RI,808,886,-78
2021,10,SC,14986,16993,-2007
2021,10,SD,137,154,-17
2021,10,TN,1856,2074,-218
2021,10,TX,67215,76398,-9183
2021,10,UT,269,330,-61
2021,10,VA,10027,11408,-1381
2021,10,VI,35,40,-5
2021,10,VT,190,211,-21
2021,10,WA,2231,2658,-427
2021,10,WI,600,684,-84
2021,10,WV,538,589,-51
2021,10,WY,79,92,-13
2021,11,AK,100,144,-44
2021,11,AL,2773,3048,-275
2021,11,AR,438,520,-82
2021,11,AZ,1123,1356,-233
2021,11,CA,16007,17855,-1848
2021,11,CO,976,1091,-115
2021,11,CT,1561,1762,-201
2021,11,DC,133,158,-25
2021,11,DE,1383,1402,-19
2021,11,FL,82883,91829,-8946
2021,11,GA,4295,4835,-540
2021,11,HI,4664,4752,-88
2021,11,IA,435,496,-61
2021,11,ID,249,293,-44
2021,11,IL,1142,1342,-200
2021,11,IN,770,888,-118
2021,11,KS,381,425,-44
2021,11,KY,658,742,-84
2021,11,LA,24872,27432,-2560
2021,11,MA,3091,3408,-317
2021,11,MD,3764,4119,-355
2021,11,ME,442,482,-40
2021,11,MI,691,869,-178
2021,11,MN,374,463,-89
2021,11,MO,740,850,-110
2021,11,MS,3354,3638,-284
2021,11,MT,152,168,-16
2021,11,NC,8256,9349,-1093
2021,11,ND,322,375,-53
2021,11,NE,264,295,-31
2021,11,NH,411,445,-34
2021,11,NJ,11021,11795,-774
2021,11,NM,399,435,-36
2021,11,NV,389,446,-57
2021,11,NY,9719,10511,-792
2021,11,OH,1072,1228,-156
2021,11,OK,586,676,-90
2021,11,OR,1688,1867,-179
2021,11,PA,2487,2772,-285
2021,11,PR,111,146,-35
2021,11,RI,581,636,-55
2021,11,SC,10934,12450,-1516
2021,11,SD,108,136,-28
2021,11,TN,1452,1575,-123
2021,11,TX,38668,44596,-5928
2021,11,UT,218,255,-37
2021,11,VA,5687,6318,-631
2021,11,VI,23,25,-2
2021,11,VT,180,208,-28
2021,11,WA,2321,2606,-285
2021,11,WI,445,525,-80
2021,11,WV,454,496,-42
2021,11,WY,76,87,-11
2021,12,AK,73,93,-20
2021,12,AL,2148,2631,-483
2021,12,AR,406,499,-93
2021,12,AZ,971,1281,-310
2021,12,CA,15013,18465,-3452
2021,12,CO,662,905,-243
2021,12,CT,1596,1837,-241
2021,12,DC,87,108,-21
2021,12,DE,1059,1217,-158
2021,12,FL,73335,92544,-19209
2021,12,GA,3310,3962,-652
2021,12,GU,2,2,0
2021,12,HI,4172,4622,-450
2021,12,IA,367,471,-104
2021,12,ID,218,261,-43
2021,12,IL,953,1178,-225
2021,12,IN,511,653,-142
2021,12,KS,275,342,-67
2021,12,KY,535,704,-169
2021,12,LA,20254,24331,-4077
2021,12,MA,2461,2956,-495
2021,12,MD,2741,3501,-760
2021,12,ME,376,433,-57
2021,12,MI,617,782,-165
2021,12,MN,287,428,-141
2021,12,MO,578,725,-147
2021,12,MS,2772,3238,-466
2021,12,MT,137,153,-16
2021,12,NC,6018,7281,-1263
2021,12,ND,315,368,-53
2021,12,NE,210,255,-45
2021,12,NH,259,321,-62
2021,12,NJ,8103,9538,-1435
2021,12,NM,296,357,-61
2021,12,NV,349,432,-83
2021,12,NY,9654,11165,-1511
2021,12,OH,984,1185,-201
2021,12,OK,420,507,-87
2021,12,OR,1307,1557,-250
2021,12,PA,2164,2544,-380
2021,12,PR,110,145,-35
2021,12,RI,463,590,-127
2021,12,SC,9806,12010,-2204
2021,12,SD,80,104,-24
2021,12,TN,1123,1365,-242
2021,12,TX,27622,35296,-7674
2021,12,UT,173,296,-123
2021,12,VA,4143,4862,-719
2021,12,VI,18,57,-39
2021,12,VT,117,152,-35
2021,12,WA,1868,2224,-356
2021,12,WI,591,697,-106
2021,12,WV,369,448,-79
2021,12,WY,58,74,-16
2022,1,AK,87,119,-32
2022,1,AL,1633,2155,-522
2022,1,AR,304,421,-117
2022,1,AZ,742,1090,-348
2022,1,CA,10504,14869,-4365
2022,1,CO,574,760,-186
2022,1,CT,1012,1430,-418
2022,1,DC,69,112,-43
2022,1,DE,1117,1386,-269
2022,1,FL,66339,89466,-23127
2022,1,GA,2631,3639,-1008
2022,1,HI,2121,2533,-412
2022,1,IA,290,380,-90
2022,1,ID,155,217,-62
2022,1,IL,1394,1688,-294
2022,1,IN,479,661,-182
2022,1,KS,231,346,-115
2022,1,KY,434,585,-151
2022,1,LA,16261,21494,-5233
2022,1,MA,1674,2188,-514
2022,1,MD,2419,2978,-559
2022,1,ME,273,357,-84
2022,1,MI,506,749,-243
2022,1,MN,191,276,-85
2022,1,MO,442,636,-194
2022,1,MS,2132,2824,-692
2022,1,MT,94,135,-41
2022,1,NC,5100,6701,-1601
2022,1,ND,336,532,-196
2022,1,NE,183,275,-92
2022,1,NH,209,262,-53
2022,1,NJ,6500,8128,-1628
2022,1,NM,243,347,-104
2022,1,NV,274,420,-146
2022,1,NY,7096,9519,-2423
2022,1,OH,723,948,-225
2022,1,OK,298,425,-127
2022,1,OR,1092,1631,-539
2022,1,PA,1705,2302,-597
2022,1,PR,62,90,-28
2022,1,RI,293,593,-300
2022,1,SC,6729,9538,-2809
2022,1,SD,67,102,-35
2022,1,TN,781,1072,-291
2022,1,TX,20594,28739,-8145
2022,1,UT,96,137,-41
2022,1,VA,2869,3773,-904
2022,1,VI,14,17,-3
2022,1,VT,95,126,-31
2022,1,WA,1327,1942,-615
2022,1,WI,434,573,-139
2022,1,WV,282,362,-80
2022,1,WY,37,52,-15
2022,2,AK,83,89,-6
2022,2,AL,2393,2976,-583
2022,2,AR,442,541,-99
2022,2,AZ,842,1096,-254
2022,2,CA,11159,13572,-2413
2022,2,CO,634,1002,-368
2022,2,CT,846,1012,-166
2022,2,DC,146,174,-28
2022,2,DE,822,943,-121
2022,2,FL,74473,85972,-11499
2022,2,GA,2921,3527,-606
2022,2,HI,4884,4977,-93
2022,2,IA,395,487,-92
2022,2,ID,301,358,-57
2022,2,IL,1351,1572,-221
2022,2,IN,640,798,-158
2022,2,KS,287,340,-53
2022,2,KY,545,653,-108
2022,2,LA,21584,24836,-3252
2022,2,MA,1862,2534,-672
2022,2,MD,1668,2251,-583
2022,2,ME,292,342,-50
2022,2,MI,663,855,-192
2022,2,MN,324,401,-77
2022,2,MO,548,685,-137
2022,2,MS,3122,3570,-448
2022,2,MT,184,227,-43
2022,2,NC,5671,6746,-1075
2022,2,ND,571,709,-138
2022,2,NE,271,337,-66
2022,2,NH,283,320,-37
2022,2,NJ,7151,8230,-1079
2022,2,NM,288,376,-88
2022,2,NV,363,447,-84
2022,2,NY,7496,8702,-1206
2022,2,OH,877,1199,-322
2022,2,OK,374,476,-102
2022,2,OR,1042,1279,-237
2022,2,PA,2474,2883,-409
2022,2,PR,95,110,-15
2022,2,RI,445,603,-158
2022,2,SC,8066,9610,-1544
2022,2,SD,90,115,-25
2022,2,TN,1006,1223,-217
2022,2,TX,26341,32349,-6008
2022,2,UT,137,269,-132
2022,2,VA,3493,4136,-643
2022,2,VI,17,18,-1
2022,2,VT,128,147,-19
2022,2,WA,1465,1769,-304
2022,2,WI,322,416,-94
2022,2,WV,398,484,-86
2022,2,WY,56,74,-18
2022,3,AK,85,91,-6
2022,3,AL,2269,2512,-243
2022,3,AR,574,678,-104
2022,3,AZ,948,1196,-248
2022,3,CA,10894,12514,-1620
2022,3,CO,934,1073,-139
2022,3,CT,1185,1338,-153
2022,3,DC,76,98,-22
2022,3,DE,1165,1253,-88
2022,3,FL,91288,103401,-12113
2022,3,GA,3997,4526,-529
2022,3,HI,2440,2565,-125
2022,3,IA,751,921,-170
2022,3,ID,471,521,-50
2022,3,IL,2005,2256,-251
2022,3,IN,932,1061,-129
2022,3,KS,454,510,-56
2022,3,KY,790,906,-116
2022,3,LA,28157,31124,-2967
2022,3,MA,2787,3074,-287
2022,3,MD,2574,3349,-775
2022,3,ME,356,378,-22
2022,3,MI,908,1065,-157
2022,3,MN,938,1085,-147
2022,3,MO,1072,1231,-159
2022,3,MP,1,1,0
2022,3,MS,3899,4329,-430
2022,3,MT,348,413,-65
2022,3,NC,7766,8603,-837
2022,3,ND,1445,1653,-208
2022,3,NE,378,446,-68
2022,3,NH,387,419,-32
2022,3,NJ,8664,9157,-493
2022,3,NM,359,413,-54
2022,3,NV,408,511,-103
2022,3,NY,9484,10607,-1123
2022,3,OH,1146,1337,-191
2022,3,OK,499,583,-84
2022,3,OR,1144,1274,-130
2022,3,PA,2562,2880,-318
2022,3,PR,101,138,-37
2022,3,RI,465,496,-31
2022,3,SC,11636,13094,-1458
2022,3,SD,218,258,-40
2022,3,TN,1711,1956,-245
2022,3,TX,34435,40729,-6294
2022,3,UT,204,247,-43
2022,3,VA,4811,5636,-825
2022,3,VI,56,58,-2
2022,3,VT,178,198,-20
2022,3,WA,1614,1854,-240
2022,3,WI,805,943,-138
2022,3,WV,522,580,-58
2022,3,WY,106,131,-25
2022,4,AK,83,111,-28
2022,4,AL,2846,3887,-1041
2022,4,AR,376,582,-206
2022,4,AZ,641,1060,-419
2022,4,CA,6358,9890,-3532
2022,4,CO,839,1254,-415
2022,4,CT,866,1292,-426
2022,4,DC,57,90,-33
2022,4,DE,900,1221,-321
2022,4,FL,64956,112001,-47045
2022,4,GA,2977,4445,-1468
2022,4,HI,2973,3939,-966
2022,4,IA,715,1050,-335
2022,4,ID,255,385,-130
2022,4,IL,1944,2545,-601
2022,4,IN,662,933,-271
2022,4,KS,383,596,-213
2022,4,KY,624,935,-311
2022,4,LA,23383,36010,-12627
2022,4,MA,1399,2159,-760
2022,4,MD,1900,2711,-811
2022,4,ME,287,425,-138
2022,4,MI,619,932,-313
2022,4,MN,1003,1357,-354
2022,4,MO,830,1349,-519
2022,4,MS,2954,4535,-1581
2022,4,MT,286,405,-119
2022,4,NC,5810,8134,-2324
2022,4,ND,695,990,-295
2022,4,NE,335,501,-166
2022,4,NH,282,378,-96
2022,4,NJ,6052,8669,-2617
2022,4,NM,286,408,-122
2022,4,NV,263,398,-135
2022,4,NY,6376,9340,-2964
2022,4,OH,928,1387,-459
2022,4,OK,431,657,-226
2022,4,OR,689,1351,-662
2022,4,PA,1653,2490,-837
2022,4,PR,69,149,-80
2022,4,RI,362,485,-123
2022,4,SC,7806,11625,-3819
2022,4,SD,208,319,-111
2022,4,TN,1273,1862,-589
2022,4,TX,26468,45167,-18699
2022,4,UT,184,258,-74
2022,4,VA,3421,4892,-1471
2022,4,VI,53,74,-21
2022,4,VT,97,167,-70
2022,4,WA,989,1473,-484
2022,4,WI,628,897,-269
2022,4,WV,362,566,-204
2022,4,WY,122,178,-56
2022,5,AK,39,131,-92
2022,5,AL,654,3212,-2558
2022,5,AR,129,552,-423
2022,5,AZ,279,1135,-856
2022,5,CA,1620,8410,-6790
2022,5,CO,304,1435,-1131
2022,5,CT,310,1264,-954
2022,5,DC,27,96,-69
2022,5,DE,373,1403,-1030
2022,5,FL,21010,117055,-96045
2022,5,GA,1073,5031,-3958
2022,5,HI,939,3242,-2303
2022,5,IA,158,709,-551
2022,5,ID,120,638,-518
2022,5,IL,457,1692,-1235
2022,5,IN,196,774,-578
2022,5,KS,108,518,-410
2022,5,KY,181,849,-668
2022,5,LA,8196,40297,-32101
2022,5,MA,635,2348,-1713
2022,5,MD,635,2477,-1842
2022,5,ME,100,304,-204
2022,5,MI,204,759,-555
2022,5,MN,120,419,-299
2022,5,MO,209,917,-708
2022,5,MS,1105,5076,-3971
2022,5,MT,90,332,-242
2022,5,NC,2250,8887,-6637
2022,5,ND,77,304,-227
2022,5,NE,107,418,-311
2022,5,NH,67,281,-214
2022,5,NJ,2133,9098,-6965
2022,5,NM,80,382,-302
2022,5,NV,84,471,-387
2022,5,NY,2442,10360,-7918
2022,5,OH,244,1234,-990
2022,5,OK,148,670,-522
2022,5,OR,234,971,-737
2022,5,PA,568,2635,-2067
2022,5,PR,14,166,-152
2022,5,RI,126,482,-356
2022,5,SC,2654,13321,-10667
2022,5,SD,57,183,-126
2022,5,TN,402,1563,-1161
2022,5,TX,11726,64198,-52472
2022,5,UT,71,223,-152
2022,5,VA,1355,5405,-4050
2022,5,VI,10,48,-38
2022,5,VT,28,121,-93
2022,5,WA,295,1340,-1045
2022,5,WI,161,577,-416
2022,5,WV,73,455,-382
2022,5,WY,37,121,-84
2022,6,AL,26,3361,-3335
2022,6,AR,13,706,-693
2022,6,AZ,9,1166,-1157
2022,6,CA,51,8157,-8106
2022,6,CO,6,1372,-1366
2022,6,CT,25,1386,-1361
2022,6,DC,3,337,-334
2022,6,DE,24,1481,-1457
2022,6,FL,809,134735,-133926
2022,6,GA,56,6170,-6114
2022,6,HI,6,3471,-3465
2022,6,IA,6,612,-606
2022,6,ID,4,245,-241
2022,6,IL,19,2260,-2241
2022,6,IN,9,810,-801
2022,6,KS,8,633,-625
2022,6,KY,8,903,-895
2022,6,LA,314,53264,-52950
2022,6,MA,35,2553,-2518
2022,6,MD,45,3474,-3429
2022,6,ME,2,262,-260
2022,6,MI,21,848,-827
2022,6,MN,2,327,-325
2022,6,MO,14,922,-908
2022,6,MS,58,5696,-5638
2022,6,MT,2,348,-346
2022,6,NC,139,10886,-10747
2022,6,ND,2,404,-402
2022,6,NE,1,397,-396
2022,6,NH,7,289,-282
2022,6,NJ,100,10254,-10154
2022,6,NM,1,361,-360
2022,6,NV,2,344,-342
2022,6,NY,134,10311,-10177
2022,6,OH,14,1273,-1259
2022,6,OK,4,869,-865
2022,6,OR,9,1092,-1083
2022,6,PA,28,2297,-2269
2022,6,RI,9,561,-552
2022,6,SC,154,15343,-15189
2022,6,SD,2,195,-193
2022,6,TN,29,2076,-2047
2022,6,TX,627,101115,-100488
2022,6,VA,79,7082,-7003
2022,6,VI,1,122,-121
2022,6,VT,2,130,-128
2022,6,WA,13,1281,-1268
2022,6,WI,5,526,-521
2022,6,WV,8,428,-420
2022,6,WY,2,105,-103
2022,7,CO,1,1089,-1088
2022,7,FL,10,138521,-138511
2022,7,GA,1,7371,-7370
2022,7,LA,4,56524,-56520
2022,7,NC,1,12167,-12166
2022,7,TX,8,114500,-114492
2022,7,VA,1,8654,-8653
2022,8,FL,3,115806,-115803
2022,8,LA,1,45837,-45836
2022,8,MD,1,3851,-3850
2022,8,MS,1,4614,-4613
2022,8,TX,5,75700,-75695
2022,8,VA,1,8636,-8635
2022,9,FL,2,108754,-108752
2022,9,HI,1,7340,-7339
2022,9,LA,1,48357,-48356
2022,9,NC,2,11086,-11084
2022,9,NM,1,540,-539
2022,9,TX,1,67493,-67492
2022,9,VA,3,8637,-8634
2022,10,FL,1,105687,-105686
2022,10,LA,1,33655,-33654
2022,11,FL,1,75307,-75306
2022,11,GA,1,4025,-4024
2022,11,LA,1,23024,-23023
2022,11,NM,1,359,-358
2022,11,SC,1,9517,-9516
2022,12,FL,1,66320,-66319
2023,1,MS,1,1876,-1875
2023,3,NC,1,7004,-7003